bill_id,roll_call_id,date,chamber,description,yea,nay,nv,absent,total
1885907,1533902,2025-04-01,Senate,"Senate Judiciary",10,1,0,0,11
1885907,1554194,2025-04-22,Senate,"Senate Appropriations",17,0,0,1,18
1885934,1526608,2025-03-25,Senate,"Senate Judiciary",10,0,0,1,11
1885934,1534148,2025-04-01,Senate,"Senate Health Policy",9,1,0,0,10
1885934,1540251,2025-04-08,Senate,"Senate Rules",23,1,0,1,25
1885934,1548667,2025-04-15,Senate,"Senate: Third Reading RCS#9",34,0,2,2,38
1885934,1560087,2025-04-29,House,"House: Third Reading RCS#329",116,0,3,0,119
1885961,1520924,2025-03-19,Senate,"Senate Judiciary",10,1,0,0,11
1885961,1534054,2025-04-01,Senate,"Senate Health Policy",9,1,0,0,10
1885961,1540993,2025-04-08,Senate,"Senate Rules",23,1,0,1,25
1885961,1548971,2025-04-15,Senate,"Senate: Third Reading RCS#10",35,0,1,2,38
1885961,1560281,2025-04-29,House,"House: Third Reading RCS#332",114,0,5,0,119
1885988,1520786,2025-03-19,Senate,"Senate Judiciary",11,0,0,0,11
1885988,1544961,2025-04-10,Senate,"Senate Appropriations Committee on Criminal and Civil Justice",8,0,0,1,9
1885988,1552096,2025-04-17,Senate,"Senate Appropriations",16,0,0,2,18
1885988,1559929,2025-04-29,Senate,"Senate: Third Reading RCS#24",38,0,0,0,38
1885988,1562608,2025-04-30,House,"House: Third Reading RCS#385",112,0,7,0,119
1886040,1520826,2025-03-19,Senate,"Senate Judiciary",11,0,0,0,11
1886040,1531454,2025-03-31,Senate,"Senate Education Pre-K - 12",8,1,0,0,9
1886040,1539937,2025-04-08,Senate,"Senate Rules",23,1,0,1,25
1886040,1549024,2025-04-15,Senate,"Senate: Third Reading RCS#11",35,0,1,2,38
1886040,1560436,2025-04-29,House,"House: Third Reading RCS#328",116,0,3,0,119
1886094,1520825,2025-03-19,Senate,"Senate Judiciary",10,1,0,0,11
1886094,1543579,2025-04-10,Senate,"Senate Appropriations Committee on Agriculture, Environment, and General Government",11,0,0,1,12
1886094,1552045,2025-04-17,Senate,"Senate Appropriations",16,0,0,2,18
1886094,1559987,2025-04-29,Senate,"Senate: Third Reading RCS#25",37,0,1,0,38
1886094,1562620,2025-04-30,House,"House: Third Reading RCS#384",112,0,7,0,119
1886121,1526565,2025-03-25,Senate,"Senate Judiciary",10,0,0,1,11
1886121,1531495,2025-03-31,Senate,"Senate Community Affairs",8,0,0,0,8
1886148,1526421,2025-03-25,Senate,"Senate Judiciary",10,1,0,0,11
1886148,1531433,2025-03-31,Senate,"Senate Community Affairs",8,0,0,0,8
1886175,1526855,2025-03-25,Senate,"Senate Judiciary",10,0,0,1,11
1886175,1531356,2025-03-31,Senate,"Senate Community Affairs",8,0,0,0,8
1886200,1520813,2025-03-19,Senate,"Senate Judiciary",10,1,0,0,11
1886200,1526379,2025-03-25,Senate,"Senate Community Affairs",8,0,0,0,8
1886200,1532174,2025-04-01,Senate,"Senate Rules",23,1,0,1,25
1886200,1541635,2025-04-09,Senate,"Senate: Third Reading RCS#24",36,1,0,1,38
1886200,1560559,2025-04-29,House,"House: Third Reading RCS#331",113,0,6,0,119
1886227,1520862,2025-03-19,Senate,"Senate Judiciary",10,1,0,0,11
1886227,1526591,2025-03-25,Senate,"Senate Community Affairs",8,0,0,0,8
1886227,1532268,2025-04-01,Senate,"Senate Rules",23,1,0,1,25
1886227,1541622,2025-04-09,Senate,"Senate: Third Reading RCS#23",37,0,0,1,38
1886227,1560373,2025-04-29,House,"House: Third Reading RCS#330",115,0,4,0,119
1886332,1526509,2025-03-25,Senate,"Senate Judiciary",10,1,0,0,11
1892647,1506167,2025-03-04,Senate,"Senate Transportation",9,0,0,0,9
1892647,1532604,2025-04-01,Senate,"Senate Criminal Justice",9,0,0,0,9
1892647,1540209,2025-04-08,Senate,"Senate Rules",24,0,0,1,25
1892656,1486029,2025-02-11,Senate,"Senate Environment and Natural Resources",9,0,0,0,9
1892656,1505756,2025-03-05,Senate,"Senate Appropriations Committee on Agriculture, Environment, and General Government",11,0,0,2,13
1892656,1515772,2025-03-12,Senate,"Senate Rules",24,0,0,1,25
1892656,1521305,2025-03-19,Senate,"Senate: Third Reading RCS#6",39,0,0,0,39
1892666,1486453,2025-02-11,Senate,"Senate Judiciary",10,0,0,1,11
1892666,1527645,2025-03-26,Senate,"Senate Appropriations Committee on Criminal and Civil Justice",9,0,0,0,9
1892690,1486153,2025-02-11,Senate,"Senate Environment and Natural Resources",6,3,0,0,9
1892690,1519821,2025-03-18,Senate,"Senate Appropriations Committee on Agriculture, Environment, and General Government",10,2,0,1,13
1892690,1527707,2025-03-26,Senate,"Senate Rules",20,4,0,1,25
1892690,1535606,2025-04-03,Senate,"Senate: Third Reading RCS#8",28,9,0,1,38
1892690,1562557,2025-04-30,House,"House: Third Reading RCS#388",82,28,9,0,119
1892861,1486167,2025-02-11,Senate,"Senate Environment and Natural Resources",9,0,0,0,9
1893073,1503437,2025-03-03,Senate,"Senate Community Affairs",6,0,0,2,8
1893073,1527353,2025-03-25,Senate,"Senate Health Policy",10,0,0,0,10
1893073,1532044,2025-04-01,Senate,"Senate Rules",23,0,0,2,25
1893073,1559033,2025-04-28,Senate,"Senate: Third Reading RCS#17",36,0,0,2,38
1893073,1562133,2025-04-30,House,"House: Third Reading RCS#350",113,0,6,0,119
1893312,1491746,2025-02-18,Senate,"Senate Ethics and Elections",7,0,0,2,9
1893312,1526823,2025-03-25,Senate,"Senate Judiciary",11,0,0,0,11
1894640,1486065,2025-02-11,Senate,"Senate Environment and Natural Resources",9,0,0,0,9
1894640,1548327,2025-04-15,Senate,"Senate Appropriations Committee on Agriculture, Environment, and General Government",12,0,0,0,12
1894640,1555057,2025-04-22,Senate,"Senate Fiscal Policy",18,0,0,1,19
1894688,1505339,2025-03-04,Senate,"Senate Criminal Justice",9,0,0,0,9
1894688,1520067,2025-03-18,Senate,"Senate Appropriations Committee on Agriculture, Environment, and General Government",12,0,0,1,13
1894688,1527324,2025-03-26,Senate,"Senate Rules",24,0,0,1,25
1894885,1486757,2025-02-11,House,"House Health Professions & Programs Subcommittee",14,1,0,3,18
1894885,1548522,2025-04-15,House,"House Health & Human Services Committee",17,5,0,4,26
1894885,1555241,2025-04-23,House,"House: Third Reading RCS#174",78,32,9,0,119
1894906,1508432,2025-03-06,House,"House Criminal Justice Subcommittee",18,0,0,0,18
1894915,1494906,2025-02-18,Senate,"Senate Transportation",7,1,0,1,9
1894915,1505832,2025-03-05,Senate,"Senate Appropriations Committee on Transportation, Tourism, and Economic Development",10,3,0,2,15
1894915,1520949,2025-03-19,Senate,"Senate Rules",22,3,0,0,25
1894915,1528521,2025-03-27,Senate,"Senate: Third Reading RCS#2",32,5,1,1,39
1894920,1506211,2025-03-05,House,"House Economic Infrastructure Subcommittee",18,0,0,0,18
1894920,1516370,2025-03-12,House,"House Intergovernmental Affairs Subcommittee",16,0,0,2,18
1894920,1519541,2025-03-17,House,"House Commerce Committee",23,0,0,3,26
1894920,1527512,2025-03-26,House,"House: Third Reading RCS#22",112,0,7,0,119
1894920,1555144,2025-04-23,Senate,"Senate: Third Reading RCS#13",36,2,0,0,38
1894920,1562433,2025-04-30,House,"House: Third Reading RCS#364",111,0,8,0,119
1894929,1486514,2025-02-11,House,"House Health Professions & Programs Subcommittee",15,0,0,3,18
1894929,1521295,2025-03-19,House,"House Health Care Budget Subcommittee",14,0,0,1,15
1894929,1531397,2025-03-31,House,"House Health & Human Services Committee",24,0,0,3,27
1894929,1542526,2025-04-09,House,"House: Third Reading RCS#81",111,0,8,0,119
1894965,1486767,2025-02-11,House,"House Health Professions & Programs Subcommittee",15,0,0,3,18
1894965,1513729,2025-03-11,House,"House Government Operations Subcommittee",17,0,0,1,18
1894965,1531168,2025-03-31,House,"House Health & Human Services Committee",24,0,0,3,27
1894965,1542224,2025-04-09,House,"House: Third Reading RCS#82",111,0,8,0,119
1894990,1534493,2025-04-02,House,"House Education Administration Subcommittee",18,0,0,0,18
1895697,1508420,2025-03-06,House,"House Criminal Justice Subcommittee",18,0,0,0,18
1895701,1503384,2025-03-03,Senate,"Senate Commerce and Tourism",8,0,0,1,9
1895701,1519942,2025-03-18,Senate,"Senate Appropriations Committee on Agriculture, Environment, and General Government",12,0,0,1,13
1895763,1534943,2025-04-02,House,"House Education Administration Subcommittee",18,0,0,0,18
1895792,1517298,2025-03-13,House,"House Civil Justice & Claims Subcommittee",18,0,0,1,19
1895792,1534328,2025-04-01,House,"House Housing, Agriculture & Tourism Subcommittee",12,0,0,6,18
1896448,1504769,2025-03-04,House,"House Human Services Subcommittee",18,0,0,0,18
1896448,1527347,2025-03-26,House,"House Health Care Budget Subcommittee",12,0,0,3,15
1896448,1538309,2025-04-07,House,"House Health & Human Services Committee",24,0,0,2,26
1896450,1526859,2025-03-25,Senate,"Senate Judiciary",10,1,0,0,11
1896450,1531442,2025-03-31,Senate,"Senate Community Affairs",8,0,0,0,8
1896450,1549913,2025-04-16,Senate,"Senate Rules",23,0,0,2,25
1896852,1486433,2025-02-11,Senate,"Senate Governmental Oversight and Accountability",5,2,0,1,8
1896852,1526161,2025-03-25,Senate,"Senate Community Affairs",5,3,0,0,8
1897165,1491761,2025-02-18,Senate,"Senate Education Pre-K - 12",8,0,0,0,8
1897165,1512948,2025-03-11,Senate,"Senate Appropriations Committee on Pre-K - 12 Education",9,0,0,1,10
1897165,1522434,2025-03-20,Senate,"Senate Fiscal Policy",19,0,0,0,19
1897165,1528603,2025-03-27,Senate,"Senate: Third Reading RCS#3",36,0,2,1,39
1897172,1508512,2025-03-06,House,"House Criminal Justice Subcommittee",17,0,0,1,18
1897172,1519542,2025-03-18,House,"House Justice Budget Subcommittee",13,1,0,1,15
1897172,1534950,2025-04-02,House,"House Judiciary Committee",20,1,0,1,22
1897172,1555495,2025-04-23,House,"House: Third Reading RCS#186",89,22,8,0,119
1897172,1562364,2025-04-30,Senate,"Senate: Third Reading RCS#44",36,1,0,1,38
1897268,1506209,2025-03-04,Senate,"Senate Children, Families, and Elder Affairs",7,0,0,0,7
1897268,1515739,2025-03-12,Senate,"Senate Judiciary",11,0,0,0,11
1897268,1521940,2025-03-19,Senate,"Senate Rules",25,0,0,0,25
1897268,1528734,2025-03-27,Senate,"Senate: Third Reading RCS#4",37,0,1,1,39
1897268,1559754,2025-04-29,House,"House: Third Reading RCS#300",115,0,4,0,119
1897317,1494937,2025-02-19,House,"House Criminal Justice Subcommittee",17,0,0,1,18
1897317,1522863,2025-03-20,House,"House Budget Committee",26,0,0,4,30
1897317,1527766,2025-03-26,House,"House Judiciary Committee",22,0,0,0,22
1897545,1491867,2025-02-18,Senate,"Senate Community Affairs",7,0,0,1,8
1897545,1515821,2025-03-12,Senate,"Senate Rules",25,0,0,0,25
1897545,1521361,2025-03-19,Senate,"Senate: Third Reading RCS#8",36,3,0,0,39
1897545,1560457,2025-04-29,House,"House: Third Reading RCS#325",89,20,10,0,119
1898257,1487362,2025-02-11,Senate,"Senate Criminal Justice",8,0,0,1,9
1898257,1506239,2025-03-05,Senate,"Senate Appropriations Committee on Criminal and Civil Justice",8,0,0,1,9
1898257,1522676,2025-03-20,Senate,"Senate Fiscal Policy",19,0,0,0,19
1898257,1528707,2025-03-27,Senate,"Senate: Third Reading RCS#5",38,0,0,1,39
1898257,1560525,2025-04-29,House,"House: Third Reading RCS#327",116,0,3,0,119
1898276,1492123,2025-02-18,Senate,"Senate Health Policy",10,0,0,0,10
1898276,1503914,2025-03-03,Senate,"Senate Commerce and Tourism",8,0,0,1,9
1898276,1515848,2025-03-12,Senate,"Senate Rules",25,0,0,0,25
1898276,1521370,2025-03-19,Senate,"Senate: Third Reading RCS#9",39,0,0,0,39
1898294,1507661,2025-03-06,House,"House Intergovernmental Affairs Subcommittee",13,2,0,3,18
1898294,1517339,2025-03-13,House,"House State Affairs Committee",16,7,0,3,26
1898338,1526143,2025-03-25,Senate,"Senate Banking and Insurance",9,0,0,1,10
1898363,1534504,2025-03-31,Senate,"Senate Banking and Insurance",10,0,0,0,10
1898363,1553702,2025-04-22,Senate,"Senate Appropriations",18,0,0,0,18
1901151,1490018,2025-02-12,House,"House Criminal Justice Subcommittee",17,0,0,1,18
1901151,1516976,2025-03-13,House,"House Judiciary Committee",20,0,0,3,23
1901158,1504833,2025-03-04,House,"House Education Administration Subcommittee",18,0,0,0,18
1901158,1517384,2025-03-13,House,"House Education & Employment Committee",20,0,0,2,22
1901158,1525959,2025-03-04,House,"House Education Administration Subcommittee",18,0,0,0,18
1901158,1527724,2025-03-26,House,"House: Third Reading RCS#23",113,0,6,0,119
1901158,1555111,2025-04-23,Senate,"Senate: Third Reading RCS#5",38,0,0,0,38
1901186,1487333,2025-02-11,Senate,"Senate Criminal Justice",8,0,0,1,9
1901186,1507005,2025-03-05,Senate,"Senate Appropriations Committee on Criminal and Civil Justice",6,2,0,1,9
1901186,1522823,2025-03-20,Senate,"Senate Fiscal Policy",18,1,0,0,19
1901209,1506280,2025-03-05,House,"House Civil Justice & Claims Subcommittee",18,0,0,0,18
1901209,1553810,2025-04-22,House,"House Budget Committee",28,0,0,2,30
1901381,1506743,2025-03-05,House,"House Civil Justice & Claims Subcommittee",18,0,0,0,18
1901381,1517757,2025-03-13,House,"House Insurance & Banking Subcommittee",17,0,0,1,18
1901381,1527910,2025-03-26,House,"House Judiciary Committee",20,0,0,2,22
1901497,1519021,2025-03-17,Senate,"Senate Education Pre-K - 12",5,3,0,1,9
1901497,1531512,2025-03-31,Senate,"Senate Community Affairs",7,1,0,0,8
1901497,1550516,2025-04-16,Senate,"Senate Rules",18,5,0,2,25
1901497,1556466,2025-04-24,Senate,"Senate: Third Reading RCS#10",30,7,0,1,38
1902126,1495363,2025-02-20,House,"House Health Care Facilities & Systems Subcommittee",17,0,0,2,19
1902581,1483036,2025-02-05,House,"House Industries & Professional Activities Subcommittee",12,4,0,2,18
1902581,1512905,2025-02-05,House,"House Industries & Professional Activities Subcommittee",12,4,0,2,18
1902581,1519512,2025-03-17,House,"House Commerce Committee",15,7,0,4,26
1903465,1486164,2025-02-11,Senate,"Senate Criminal Justice",8,0,0,1,9
1903465,1503418,2025-03-03,Senate,"Senate Agriculture",6,0,0,0,6
1903465,1516093,2025-03-12,Senate,"Senate Rules",25,0,0,0,25
1903465,1521036,2025-03-19,Senate,"Senate: Third Reading RCS#10",39,0,0,0,39
1903465,1560019,2025-04-29,House,"House: Third Reading RCS#326",109,0,10,0,119
1904298,1492014,2025-02-18,Senate,"Senate Health Policy",10,0,0,0,10
1904298,1527805,2025-03-26,Senate,"Senate Appropriations Committee on Health and Human Services",10,0,0,0,10
1904305,1535735,2025-04-03,House,"House Health Professions & Programs Subcommittee",15,0,0,3,18
1904632,1488176,2025-02-12,House,"House Criminal Justice Subcommittee",16,1,0,1,18
1904632,1517099,2025-03-13,House,"House Judiciary Committee",19,1,0,3,23
1904632,1556965,2025-04-24,House,"House: Third Reading RCS#208",101,9,9,0,119
1904632,1558791,2025-04-28,Senate,"Senate: Third Reading RCS#6",36,0,0,2,38
1907537,1504966,2025-03-04,House,"House Education Administration Subcommittee",13,5,0,0,18
1907537,1525797,2025-03-04,House,"House Education Administration Subcommittee",13,5,0,0,18
1907537,1539530,2025-04-08,House,"House Education & Employment Committee",11,4,0,7,22
1908822,1505794,2025-03-05,Senate,"Senate Appropriations Committee on Agriculture, Environment, and General Government",11,0,0,2,13
1908822,1522632,2025-03-20,Senate,"Senate Appropriations",18,0,0,1,19
1908822,1528713,2025-03-27,Senate,"Senate: Third Reading RCS#6",38,0,0,1,39
1908822,1559731,2025-04-29,House,"House: Third Reading RCS#289",116,0,3,0,119
1909031,1516272,2025-03-12,House,"House Careers & Workforce Subcommittee",15,0,0,3,18
1909031,1516884,2025-03-12,House,"House Careers & Workforce Subcommittee",15,0,0,3,18
1909031,1519606,2025-03-18,House,"House Human Services Subcommittee",17,0,0,1,18
1909031,1526301,2025-03-25,House,"House PreK-12 Budget Subcommittee",15,0,0,0,15
1909031,1539504,2025-04-08,House,"House Education & Employment Committee",16,0,0,6,22
1909346,1535600,2025-04-03,House,"House Civil Justice & Claims Subcommittee",10,4,0,5,19
1909442,1535787,2025-04-03,House,"House Civil Justice & Claims Subcommittee",14,0,0,5,19
1909442,1539583,2025-04-08,House,"House Judiciary Committee",17,0,0,5,22
1909442,1556992,2025-04-24,House,"House: Third Reading RCS#235",116,0,3,0,119
1909442,1564489,2025-05-02,Senate,"Senate: Third Reading RCS#2",35,0,2,1,38
1909517,1492631,2025-02-18,Senate,"Senate Regulated Industries",8,0,0,1,9
1909517,1505898,2025-03-05,Senate,"Senate Appropriations Committee on Agriculture, Environment, and General Government",11,0,0,2,13
1909517,1516106,2025-03-12,Senate,"Senate Rules",24,0,0,1,25
1909517,1520986,2025-03-19,Senate,"Senate: Third Reading RCS#16",39,0,0,0,39
1911850,1494829,2025-02-18,Senate,"Senate Community Affairs",7,0,0,1,8
1911850,1515828,2025-03-11,Senate,"Senate Appropriations Committee on Transportation, Tourism, and Economic Development",15,0,0,0,15
1911850,1532216,2025-04-01,Senate,"Senate Rules",25,0,0,0,25
1911850,1541553,2025-04-09,Senate,"Senate: Third Reading RCS#20",37,0,0,1,38
1911850,1561846,2025-04-30,House,"House: Third Reading RCS#347",97,10,12,0,119
1914829,1520794,2025-03-19,Senate,"Senate Regulated Industries",8,0,0,1,9
1914829,1544251,2025-04-10,Senate,"Senate Appropriations Committee on Agriculture, Environment, and General Government",11,0,0,1,12
1914829,1550377,2025-04-16,Senate,"Senate Rules",23,0,0,2,25
1914829,1555116,2025-04-23,Senate,"Senate: Third Reading RCS#32",38,0,0,0,38
1914959,1486293,2025-02-11,Senate,"Senate Environment and Natural Resources",9,0,0,0,9
1914959,1548656,2025-04-15,Senate,"Senate Appropriations Committee on Agriculture, Environment, and General Government",12,0,0,0,12
1914959,1554976,2025-04-22,Senate,"Senate Fiscal Policy",18,0,0,1,19
1915029,1507723,2025-03-06,House,"House Industries & Professional Activities Subcommittee",15,0,0,3,18
1915029,1521547,2025-03-19,House,"House Criminal Justice Subcommittee",17,0,0,1,18
1915029,1531090,2025-03-31,House,"House Commerce Committee",19,0,0,7,26
1915267,1532724,2025-04-01,Senate,"Senate Governmental Oversight and Accountability",7,0,0,0,7
1915309,1543758,2025-04-10,House,"House Health Care Facilities & Systems Subcommittee",15,0,0,3,18
1915309,1549597,2025-04-16,House,"House Budget Committee",29,0,0,1,30
1915309,1553401,2025-04-22,House,"House Health & Human Services Committee",24,0,0,3,27
1915575,1515830,2025-03-12,Senate,"Senate Regulated Industries",7,1,0,1,9
1915575,1531415,2025-03-31,Senate,"Senate Community Affairs",6,2,0,0,8
1915575,1550467,2025-04-16,Senate,"Senate Rules",22,1,0,2,25
1915759,1504148,2025-03-03,Senate,"Senate Community Affairs",6,0,0,2,8
1915804,1495303,2025-02-19,House,"House Civil Justice & Claims Subcommittee",18,0,0,0,18
1915804,1534914,2025-04-02,House,"House Judiciary Committee",18,0,0,4,22
1915847,1491900,2025-02-18,Senate,"Senate Agriculture",5,0,0,1,6
1916134,1527840,2025-03-26,House,"House Intergovernmental Affairs Subcommittee",15,0,0,4,19
1916134,1539526,2025-04-08,House,"House State Affairs Committee",22,0,0,4,26
1916134,1557219,2025-04-24,House,"House: Third Reading RCS#217",94,11,14,0,119
1916134,1562007,2025-04-30,Senate,"Senate: Third Reading RCS#7",36,0,1,1,38
1916603,1504882,2025-03-04,House,"House Natural Resources & Disasters Subcommittee",17,1,0,0,18
1917016,1488845,2025-02-11,Senate,"Senate Criminal Justice",7,1,0,1,9
1917016,1506010,2025-03-05,Senate,"Senate Appropriations Committee on Criminal and Civil Justice",8,0,0,1,9
1917016,1522372,2025-03-20,Senate,"Senate Fiscal Policy",18,1,0,0,19
1917016,1528542,2025-03-27,Senate,"Senate: Third Reading RCS#7",17,21,0,1,39
1917016,1535656,2025-04-03,Senate,"Senate: Third Reading RCS#15",37,0,0,1,38
1917016,1559932,2025-04-29,House,"House: Third Reading RCS#322",116,0,3,0,119
1917097,1507186,2025-03-05,House,"House Insurance & Banking Subcommittee",17,0,0,1,18
1917097,1523115,2025-03-20,House,"House Civil Justice & Claims Subcommittee",18,0,0,0,18
1917097,1549844,2025-04-15,House,"House Commerce Committee",24,0,0,2,26
1917185,1503239,2025-03-03,Senate,"Senate Commerce and Tourism",8,0,0,1,9
1917185,1533132,2025-03-31,Senate,"Senate Banking and Insurance",10,0,0,0,10
1917185,1539805,2025-04-08,Senate,"Senate Rules",24,0,0,1,25
1917185,1549810,2025-04-16,Senate,"Senate: Third Reading RCS#4",36,0,1,1,38
1917185,1560221,2025-04-29,House,"House: Third Reading RCS#297",116,0,3,0,119
1918102,1517402,2025-03-13,House,"House Civil Justice & Claims Subcommittee",16,0,0,3,19
1918230,1533005,2025-04-01,Senate,"Senate Criminal Justice",9,0,0,0,9
1918230,1545080,2025-04-10,Senate,"Senate Appropriations Committee on Criminal and Civil Justice",8,0,0,1,9
1918297,1506190,2025-03-05,House,"House Civil Justice & Claims Subcommittee",18,0,0,0,18
1918297,1517037,2025-03-13,House,"House Judiciary Committee",20,0,0,3,23
1918297,1527841,2025-03-26,House,"House: Third Reading RCS#25",113,0,6,0,119
1918297,1549619,2025-04-16,Senate,"Senate: Third Reading RCS#5",36,0,1,1,38
1918360,1482245,2025-02-04,House,"House Student Academic Success Subcommittee",15,0,0,3,18
1918360,1517191,2025-03-13,House,"House Education & Employment Committee",19,0,0,3,22
1918478,1515106,2025-03-11,Senate,"Senate Education Pre-K - 12",9,0,0,0,9
1918478,1520800,2025-03-19,Senate,"Senate Judiciary",9,2,0,0,11
1918478,1532205,2025-04-01,Senate,"Senate Rules",25,0,0,0,25
1918478,1541653,2025-04-09,Senate,"Senate: Third Reading RCS#30",35,2,0,1,38
1918478,1555472,2025-04-23,House,"House: Third Reading RCS#163",92,19,8,0,119
1918478,1561888,2025-04-30,Senate,"Senate: Third Reading RCS#9",36,1,0,1,38
1918478,1564738,2025-05-02,House,"House: Third Reading RCS#419",88,10,21,0,119
1918834,1494090,2025-02-18,Senate,"Senate Judiciary",9,0,0,1,10
1918834,1516074,2025-03-11,Senate,"Senate Community Affairs",7,0,0,1,8
1918834,1521037,2025-03-19,Senate,"Senate Rules",25,0,0,0,25
1918834,1528570,2025-03-27,Senate,"Senate: Third Reading RCS#8",36,0,2,1,39
1918834,1560314,2025-04-29,House,"House: Third Reading RCS#302",114,0,5,0,119
1918894,1516874,2025-03-13,House,"House Ways & Means Committee",19,0,0,0,19
1918894,1532086,2025-04-01,House,"House Intergovernmental Affairs Subcommittee",16,0,0,2,18
1918894,1539471,2025-04-08,House,"House State Affairs Committee",24,0,0,2,26
1918894,1549649,2025-04-16,House,"House: Third Reading RCS#108",115,0,4,0,119
1918948,1516876,2025-03-13,House,"House Ways & Means Committee",19,0,0,0,19
1918948,1532093,2025-04-01,House,"House Intergovernmental Affairs Subcommittee",16,0,0,2,18
1918948,1539867,2025-04-08,House,"House State Affairs Committee",23,0,0,3,26
1918948,1549937,2025-04-16,House,"House: Third Reading RCS#109",116,0,3,0,119
1919535,1529267,2025-03-27,House,"House Education Administration Subcommittee",17,0,0,1,18
1919599,1492220,2025-02-18,Senate,"Senate Health Policy",9,0,0,1,10
1919665,1516802,2025-03-12,Senate,"Senate Transportation",9,0,0,0,9
1919798,1508419,2025-03-06,House,"House Criminal Justice Subcommittee",17,0,0,1,18
1919798,1522427,2025-03-20,House,"House Judiciary Committee",16,3,0,4,23
1919924,1492031,2025-02-18,Senate,"Senate Governmental Oversight and Accountability",7,0,0,1,8
1919924,1527898,2025-03-25,Senate,"Senate Community Affairs",8,0,0,0,8
1919924,1532062,2025-04-01,Senate,"Senate Rules",24,1,0,0,25
1919924,1542016,2025-04-09,Senate,"Senate: Third Reading RCS#31",34,2,1,1,38
1919924,1560143,2025-04-29,House,"House: Third Reading RCS#334",113,2,4,0,119
1920331,1527811,2025-03-26,House,"House Criminal Justice Subcommittee",18,0,0,0,18
1920331,1551428,2025-04-17,House,"House Judiciary Committee",20,0,0,2,22
1920331,1557308,2025-04-24,House,"House: Third Reading RCS#210",112,0,7,0,119
1920331,1560058,2025-04-29,Senate,"Senate: Third Reading RCS#10",37,0,1,0,38
1920421,1529154,2025-03-27,House,"House Education Administration Subcommittee",17,0,0,1,18
1920421,1539551,2025-04-08,House,"House Education & Employment Committee",15,0,0,7,22
1920600,1521632,2025-03-19,House,"House Economic Infrastructure Subcommittee",17,0,0,1,18
1920600,1549815,2025-04-15,House,"House Commerce Committee",25,0,0,1,26
1920769,1492235,2025-02-18,Senate,"Senate Education Postsecondary",6,0,0,1,7
1920769,1521667,2025-03-18,Senate,"Senate Appropriations Committee on Higher Education",8,0,0,0,8
1920769,1534320,2025-04-02,Senate,"Senate Appropriations",18,0,0,0,18
1921139,1504141,2025-03-03,Senate,"Senate Ethics and Elections",8,0,0,1,9
1921139,1515670,2025-03-12,Senate,"Senate Judiciary",11,0,0,0,11
1921139,1520990,2025-03-19,Senate,"Senate Rules",25,0,0,0,25
1921139,1528552,2025-03-27,Senate,"Senate: Third Reading RCS#11",38,0,0,1,39
1921284,1504904,2025-03-04,Senate,"Senate Criminal Justice",8,0,0,1,9
1921284,1532666,2025-04-01,Senate,"Senate Children, Families, and Elder Affairs",6,0,0,1,7
1922014,1492568,2025-02-18,Senate,"Senate Transportation",8,0,0,1,9
1922014,1505660,2025-03-05,Senate,"Senate Appropriations Committee on Transportation, Tourism, and Economic Development",13,0,0,2,15
1922014,1522720,2025-03-20,Senate,"Senate Fiscal Policy",19,0,0,0,19
1922014,1528527,2025-03-27,Senate,"Senate: Third Reading RCS#9",38,0,0,1,39
1922014,1528841,2025-03-27,Senate,"Senate: Third Reading RCS#10",37,0,1,1,39
1922154,1488139,2025-02-12,House,"House Criminal Justice Subcommittee",17,0,0,1,18
1922154,1507444,2025-03-06,House,"House Industries & Professional Activities Subcommittee",15,0,0,3,18
1922154,1517077,2025-03-13,House,"House Judiciary Committee",21,0,0,2,23
1922514,1534220,2025-04-01,House,"House Housing, Agriculture & Tourism Subcommittee",13,0,0,5,18
1922514,1542116,2025-04-09,House,"House Intergovernmental Affairs Subcommittee",17,0,0,1,18
1922514,1549705,2025-04-15,House,"House Commerce Committee",24,0,0,2,26
1922514,1555245,2025-04-23,House,"House: Third Reading RCS#182",115,0,4,0,119
1922852,1528939,2025-03-27,House,"House Civil Justice & Claims Subcommittee",13,0,0,5,18
1922852,1539481,2025-04-08,House,"House Judiciary Committee",16,0,0,6,22
1922852,1557317,2025-04-24,House,"House: Third Reading RCS#236",116,0,3,0,119
1923039,1503173,2025-03-03,Senate,"Senate Banking and Insurance",10,0,0,0,10
1923039,1509096,2025-03-10,Senate,"Senate Commerce and Tourism",8,0,0,1,9
1923039,1521116,2025-03-19,Senate,"Senate Rules",25,0,0,0,25
1923039,1535634,2025-04-03,Senate,"Senate: Third Reading RCS#12",36,0,1,1,38
1923039,1559798,2025-04-29,House,"House: Third Reading RCS#303",115,0,4,0,119
1923445,1508454,2025-03-06,House,"House Criminal Justice Subcommittee",15,0,0,3,18
1923445,1517038,2025-03-13,House,"House Judiciary Committee",19,0,0,4,23
1924116,1492000,2025-02-18,Senate,"Senate Health Policy",9,0,0,1,10
1924116,1505653,2025-03-05,Senate,"Senate Appropriations Committee on Health and Human Services",10,0,0,0,10
1924116,1516071,2025-03-12,Senate,"Senate Rules",25,0,0,0,25
1924116,1520943,2025-03-19,Senate,"Senate: Third Reading RCS#11",38,0,1,0,39
1924331,1504826,2025-03-04,House,"House Natural Resources & Disasters Subcommittee",18,0,0,0,18
1924331,1539542,2025-04-08,House,"House State Affairs Committee",22,0,0,4,26
1924331,1549711,2025-04-16,House,"House: Third Reading RCS#100",115,0,4,0,119
1924331,1562298,2025-04-30,Senate,"Senate: Third Reading RCS#45",37,0,0,1,38
1924331,1563627,2025-05-01,House,"House: Third Reading RCS#394",112,0,7,0,119
1926906,1528792,2025-03-27,House,"House Civil Justice & Claims Subcommittee",15,0,0,3,18
1926906,1554410,2025-04-22,House,"House Budget Committee",28,0,0,2,30
1926955,1523236,2025-03-20,House,"House Civil Justice & Claims Subcommittee",18,0,0,0,18
1927008,1492432,2025-02-18,Senate,"Senate Judiciary",9,1,0,0,10
1927008,1533299,2025-04-01,Senate,"Senate Governmental Oversight and Accountability",7,0,0,0,7
1927008,1539966,2025-04-08,Senate,"Senate Rules",23,1,0,1,25
1927008,1555165,2025-04-23,Senate,"Senate: Third Reading RCS#12",35,3,0,0,38
1927121,1503316,2025-03-03,Senate,"Senate Education Pre-K - 12",6,1,0,2,9
1927121,1512993,2025-03-11,Senate,"Senate Appropriations Committee on Pre-K - 12 Education",8,1,0,1,10
1927121,1522441,2025-03-20,Senate,"Senate Fiscal Policy",19,0,0,0,19
1927121,1528560,2025-03-27,Senate,"Senate: Third Reading RCS#12",38,0,0,1,39
1927121,1559727,2025-04-29,House,"House: Third Reading RCS#295",116,0,3,0,119
1927189,1492381,2025-02-18,Senate,"Senate Judiciary",9,1,0,0,10
1927189,1532737,2025-04-01,Senate,"Senate Governmental Oversight and Accountability",7,0,0,0,7
1927189,1539489,2025-04-08,Senate,"Senate Rules",23,1,0,1,25
1927189,1554973,2025-04-23,Senate,"Senate: Third Reading RCS#11",35,3,0,0,38
1927298,1509081,2025-02-18,Senate,"Senate Education Postsecondary",0,0,0,7,7
1927298,1513845,2025-03-10,Senate,"Senate Education Postsecondary",5,0,0,2,7
1927298,1526366,2025-03-25,Senate,"Senate Governmental Oversight and Accountability",6,0,0,2,8
1927298,1532733,2025-04-01,Senate,"Senate Rules",24,0,0,1,25
1927298,1541464,2025-04-09,Senate,"Senate: Third Reading RCS#21",37,0,0,1,38
1927298,1562461,2025-04-30,House,"House: Third Reading RCS#386",112,0,7,0,119
1927412,1534083,2025-04-01,Senate,"Senate Health Policy",10,0,0,0,10
1927412,1544536,2025-04-10,Senate,"Senate Appropriations Committee on Health and Human Services",8,0,0,2,10
1927412,1555253,2025-04-22,Senate,"Senate Fiscal Policy",18,0,0,1,19
1927412,1561617,2025-04-30,Senate,"Senate: Third Reading RCS#3",37,0,0,1,38
1927762,1492211,2025-02-18,Senate,"Senate Military and Veterans Affairs, Space, and Domestic Security",5,0,0,0,5
1927762,1515820,2025-03-12,Senate,"Senate Rules",25,0,0,0,25
1927876,1523354,2025-03-20,House,"House Civil Justice & Claims Subcommittee",18,0,0,0,18
1927986,1516949,2025-03-12,Senate,"Senate Children, Families, and Elder Affairs",5,0,0,2,7
1927986,1526649,2025-03-25,Senate,"Senate Judiciary",11,0,0,0,11
1927986,1532711,2025-04-01,Senate,"Senate Rules",25,0,0,0,25
1927986,1542050,2025-04-09,Senate,"Senate: Third Reading RCS#32",37,0,0,1,38
1928217,1534034,2025-04-01,House,"House Housing, Agriculture & Tourism Subcommittee",14,0,0,4,18
1928217,1541666,2025-04-09,House,"House Intergovernmental Affairs Subcommittee",17,0,0,1,18
1928217,1549910,2025-04-15,House,"House Commerce Committee",26,0,0,0,26
1928217,1555475,2025-04-23,House,"House: Third Reading RCS#169",114,0,5,0,119
1928217,1564506,2025-05-02,Senate,"Senate: Third Reading RCS#4",37,0,0,1,38
1928340,1491715,2025-02-18,Senate,"Senate Commerce and Tourism",7,0,0,2,9
1928340,1521177,2025-03-19,Senate,"Senate Judiciary",11,0,0,0,11
1928340,1527697,2025-03-26,Senate,"Senate Rules",24,0,0,1,25
1928340,1536039,2025-04-03,Senate,"Senate: Third Reading RCS#13",35,1,1,1,38
1928340,1560528,2025-04-29,House,"House: Third Reading RCS#304",115,0,4,0,119
1928691,1491887,2025-02-18,Senate,"Senate Agriculture",5,0,0,1,6
1928691,1548361,2025-04-15,Senate,"Senate Finance and Tax",5,0,0,1,6
1928691,1555049,2025-04-22,Senate,"Senate Appropriations",18,0,0,0,18
1930818,1491768,2025-02-18,Senate,"Senate Commerce and Tourism",7,0,0,2,9
1930979,1492085,2025-02-18,Senate,"Senate Judiciary",9,0,0,1,10
1930979,1506013,2025-03-05,Senate,"Senate Appropriations Committee on Criminal and Civil Justice",8,0,0,1,9
1930979,1515738,2025-03-12,Senate,"Senate Rules",25,0,0,0,25
1930979,1521360,2025-03-19,Senate,"Senate: Third Reading RCS#12",39,0,0,0,39
1930979,1559819,2025-04-29,House,"House: Third Reading RCS#282",111,0,8,0,119
1931432,1517755,2025-03-13,House,"House Civil Justice & Claims Subcommittee",15,2,0,2,19
1931432,1534500,2025-04-02,House,"House Judiciary Committee",17,2,0,3,22
1939864,1495430,2025-02-20,House,"House Health Care Facilities & Systems Subcommittee",15,2,0,2,19
1940269,1507618,2025-03-06,House,"House Government Operations Subcommittee",16,1,0,1,18
1940269,1532740,2025-04-01,House,"House Intergovernmental Affairs Subcommittee",16,0,0,2,18
1940388,1504832,2025-03-04,House,"House Health Care Facilities & Systems Subcommittee",17,0,0,1,18
1940388,1516521,2025-03-12,House,"House Intergovernmental Affairs Subcommittee",16,0,0,2,18
1940388,1531589,2025-03-31,House,"House Health & Human Services Committee",24,0,0,3,27
1940859,1514150,2025-03-11,House,"House Housing, Agriculture & Tourism Subcommittee",15,2,0,1,18
1940859,1541545,2025-04-09,House,"House Intergovernmental Affairs Subcommittee",16,1,0,1,18
1940859,1553596,2025-04-22,House,"House Commerce Committee",18,6,0,3,27
1941208,1516550,2025-03-12,House,"House Criminal Justice Subcommittee",15,0,0,4,19
1941318,1493558,2025-02-19,House,"House Criminal Justice Subcommittee",15,3,0,0,18
1941318,1496493,2025-02-19,House,"House Criminal Justice Subcommittee",15,3,0,0,18
1941914,1494717,2025-02-19,House,"House Intergovernmental Affairs Subcommittee",17,0,0,1,18
1941914,1517760,2025-03-13,House,"House State Affairs Committee",23,0,0,3,26
1941927,1491844,2025-02-18,Senate,"Senate Health Policy",9,0,0,1,10
1941927,1533122,2025-04-01,Senate,"Senate Governmental Oversight and Accountability",7,0,0,0,7
1941927,1539947,2025-04-08,Senate,"Senate Rules",23,1,0,1,25
1941927,1555143,2025-04-23,Senate,"Senate: Third Reading RCS#10",34,4,0,0,38
1941980,1513183,2025-03-11,Senate,"Senate Military and Veterans Affairs, Space, and Domestic Security",5,0,0,1,6
1942015,1514387,2025-03-11,House,"House Student Academic Success Subcommittee",16,0,0,2,18
1942015,1520231,2025-03-18,House,"House Government Operations Subcommittee",17,0,0,2,19
1942015,1524098,2025-03-18,House,"House Government Operations Subcommittee",17,0,0,2,19
1942015,1525787,2025-03-11,House,"House Student Academic Success Subcommittee",16,0,0,2,18
1942015,1527808,2025-03-26,House,"House Education & Employment Committee",18,0,0,4,22
1942029,1520917,2025-03-19,Senate,"Senate Judiciary",11,0,0,0,11
1942081,1494749,2025-02-18,Senate,"Senate Regulated Industries",8,0,0,1,9
1942081,1519637,2025-03-18,Senate,"Senate Appropriations Committee on Agriculture, Environment, and General Government",12,0,0,1,13
1942081,1534057,2025-04-02,Senate,"Senate Fiscal Policy",17,0,0,2,19
1942081,1541981,2025-04-09,Senate,"Senate: Third Reading RCS#33",37,0,0,1,38
1942081,1559996,2025-04-29,House,"House: Third Reading RCS#278",112,0,7,0,119
1942091,1514625,2025-03-11,Senate,"Senate Education Pre-K - 12",6,2,0,1,9
1942124,1516419,2025-03-12,House,"House Criminal Justice Subcommittee",17,0,0,2,19
1942124,1526207,2025-03-25,House,"House Government Operations Subcommittee",18,0,0,0,18
1942124,1537297,2025-03-25,House,"House Government Operations Subcommittee",18,0,0,0,18
1942124,1539770,2025-04-08,House,"House Judiciary Committee",19,0,0,3,22
1942124,1550262,2025-04-16,House,"House: Third Reading RCS#134",115,0,4,0,119
1942124,1555029,2025-04-23,Senate,"Senate: Third Reading RCS#14",36,0,2,0,38
1942140,1518878,2025-03-17,Senate,"Senate Education Pre-K - 12",9,0,0,0,9
1942140,1545878,2025-04-10,Senate,"Senate Appropriations Committee on Pre-K - 12 Education",7,0,0,2,9
1942140,1551114,2025-04-17,Senate,"Senate Fiscal Policy",17,0,0,2,19
1942140,1556592,2025-04-24,Senate,"Senate: Third Reading RCS#9",37,0,0,1,38
1942180,1491707,2025-02-18,Senate,"Senate Ethics and Elections",7,0,0,2,9
1942180,1504551,2025-03-04,Senate,"Senate Military and Veterans Affairs, Space, and Domestic Security",6,0,0,0,6
1942180,1515714,2025-03-12,Senate,"Senate Rules",25,0,0,0,25
1942180,1521196,2025-03-19,Senate,"Senate: Third Reading RCS#13",39,0,0,0,39
1942180,1560223,2025-04-29,House,"House: Third Reading RCS#310",114,0,5,0,119
1942198,1531877,2025-03-31,Senate,"Senate Commerce and Tourism",9,0,0,0,9
1942198,1543653,2025-04-10,Senate,"Senate Appropriations Committee on Transportation, Tourism, and Economic Development",13,0,0,2,15
1942214,1516906,2025-03-12,Senate,"Senate Transportation",9,0,0,0,9
1942235,1515774,2025-03-12,Senate,"Senate Regulated Industries",5,2,0,2,9
1942250,1515863,2025-03-12,Senate,"Senate Regulated Industries",8,0,0,1,9
1942300,1503353,2025-03-03,Senate,"Senate Education Pre-K - 12",7,0,0,2,9
1942300,1515803,2025-03-12,Senate,"Senate Rules",25,0,0,0,25
1942300,1528774,2025-03-27,Senate,"Senate: Third Reading RCS#13",38,0,0,1,39
1942300,1560358,2025-04-29,House,"House: Third Reading RCS#309",114,0,5,0,119
1942321,1503248,2025-03-03,Senate,"Senate Agriculture",6,0,0,0,6
1942335,1526830,2025-03-25,House,"House Student Academic Success Subcommittee",15,0,0,3,18
1942335,1533065,2025-04-01,House,"House PreK-12 Budget Subcommittee",13,0,0,2,15
1942335,1539853,2025-04-08,House,"House Education & Employment Committee",17,0,0,5,22
1942335,1558214,2025-04-25,House,"House: Third Reading RCS#269",106,0,13,0,119
1942386,1521314,2025-03-19,House,"House Education Administration Subcommittee",16,0,0,2,18
1942386,1527438,2025-03-26,House,"House Education & Employment Committee",18,0,0,4,22
1942526,1516197,2025-03-12,House,"House Criminal Justice Subcommittee",16,0,0,3,19
1942526,1527876,2025-03-26,House,"House Judiciary Committee",22,0,0,0,22
1942526,1542095,2025-04-09,House,"House: Third Reading RCS#75",109,0,10,0,119
1942526,1559866,2025-04-29,Senate,"Senate: Third Reading RCS#4",37,0,1,0,38
1942526,1563771,2025-05-01,House,"House: Third Reading RCS#400",112,0,7,0,119
1942658,1504825,2025-03-04,House,"House Human Services Subcommittee",17,0,0,1,18
1942658,1513414,2025-03-11,House,"House Government Operations Subcommittee",17,0,0,1,18
1942658,1525327,2025-03-24,House,"House Health & Human Services Committee",24,0,0,3,27
1942658,1536128,2025-04-03,House,"House: Third Reading RCS#46",106,0,13,0,119
1942658,1553033,2025-04-21,Senate,"Senate Rules",23,0,0,2,25
1942658,1556719,2025-04-24,Senate,"Senate: Third Reading RCS#28",36,0,1,1,38
1942733,1493381,2025-02-19,House,"House Intergovernmental Affairs Subcommittee",17,0,0,1,18
1942733,1508417,2025-03-06,House,"House Criminal Justice Subcommittee",15,0,0,3,18
1942733,1517311,2025-03-13,House,"House State Affairs Committee",24,0,0,2,26
1942733,1556988,2025-04-24,House,"House: Third Reading RCS#223",113,0,6,0,119
1942733,1562266,2025-04-30,Senate,"Senate: Third Reading RCS#10",36,0,1,1,38
1942869,1528965,2025-03-27,House,"House Civil Justice & Claims Subcommittee",15,0,0,3,18
1942869,1539531,2025-04-08,House,"House Judiciary Committee",20,0,0,2,22
1942869,1557224,2025-04-24,House,"House: Third Reading RCS#234",115,0,4,0,119
1943534,1504153,2025-03-03,Senate,"Senate Community Affairs",6,0,0,2,8
1943534,1518885,2025-03-17,Senate,"Senate Environment and Natural Resources",8,0,0,1,9
1943534,1527569,2025-03-26,Senate,"Senate Rules",24,0,0,1,25
1943534,1535610,2025-04-03,Senate,"Senate: Third Reading RCS#14",36,0,1,1,38
1943534,1561923,2025-04-30,House,"House: Third Reading RCS#346",112,0,7,0,119
1943586,1503347,2025-03-03,Senate,"Senate Environment and Natural Resources",9,0,0,0,9
1943586,1519804,2025-03-18,Senate,"Senate Appropriations Committee on Agriculture, Environment, and General Government",12,0,0,1,13
1943586,1534528,2025-04-02,Senate,"Senate Appropriations",18,0,0,0,18
1943586,1541756,2025-04-09,Senate,"Senate: Third Reading RCS#34",37,0,0,1,38
1943586,1561845,2025-04-30,House,"House: Third Reading RCS#343",112,0,7,0,119
1943614,1517316,2025-03-13,House,"House Civil Justice & Claims Subcommittee",15,0,0,4,19
1943614,1529163,2025-03-27,House,"House Insurance & Banking Subcommittee",16,0,0,2,18
1943614,1534445,2025-04-02,House,"House Judiciary Committee",21,0,0,1,22
1943724,1526426,2025-03-25,Senate,"Senate Judiciary",11,0,0,0,11
1943751,1521673,2025-03-19,House,"House Intergovernmental Affairs Subcommittee",16,0,0,2,18
1943751,1534922,2025-04-02,House,"House State Affairs Committee",24,0,0,2,26
1943776,1507424,2025-03-06,House,"House Government Operations Subcommittee",16,1,0,1,18
1943776,1507892,2025-03-06,House,"House Government Operations Subcommittee",14,0,0,4,18
1943801,1522032,2025-03-19,House,"House Intergovernmental Affairs Subcommittee",18,0,0,0,18
1943801,1527557,2025-03-26,House,"House Industries & Professional Activities Subcommittee",12,0,0,6,18
1943801,1539388,2025-04-08,House,"House State Affairs Committee",21,0,0,5,26
1943821,1520812,2025-03-19,Senate,"Senate Judiciary",11,0,0,0,11
1943836,1516183,2025-03-12,House,"House Criminal Justice Subcommittee",17,0,0,2,19
1943836,1521736,2025-03-19,House,"House Economic Infrastructure Subcommittee",17,0,0,1,18
1943836,1539705,2025-04-08,House,"House Judiciary Committee",18,0,0,4,22
1943836,1549847,2025-04-16,House,"House: Third Reading RCS#133",115,0,4,0,119
1943836,1555048,2025-04-23,Senate,"Senate: Third Reading RCS#3",38,0,0,0,38
1944992,1513916,2025-03-11,House,"House Natural Resources & Disasters Subcommittee",17,0,0,1,18
1945994,1505755,2025-03-04,Senate,"Senate Children, Families, and Elder Affairs",7,0,0,0,7
1945994,1519737,2025-03-18,Senate,"Senate Appropriations Committee on Health and Human Services",10,0,0,0,10
1945994,1551261,2025-04-17,Senate,"Senate Fiscal Policy",16,0,0,3,19
1945994,1556677,2025-04-24,Senate,"Senate: Third Reading RCS#8",37,0,0,1,38
1946009,1508422,2025-03-06,House,"House Criminal Justice Subcommittee",18,0,0,0,18
1946009,1517277,2025-03-13,House,"House State Affairs Committee",25,0,0,1,26
1946009,1522491,2025-03-20,House,"House Judiciary Committee",20,0,0,3,23
1946009,1527412,2025-03-26,House,"House: Third Reading RCS#20",112,0,7,0,119
1946009,1562499,2025-04-30,Senate,"Senate: Third Reading RCS#50",37,0,0,1,38
1946009,1563779,2025-05-01,House,"House: Third Reading RCS#397",105,5,9,0,119
1946009,1564739,2025-05-02,Senate,"Senate: Third Reading RCS#23",31,0,4,3,38
1946009,1564740,2025-05-02,House,"House: Third Reading RCS#426",93,1,25,0,119
1946032,1505022,2025-03-04,Senate,"Senate Military and Veterans Affairs, Space, and Domestic Security",6,0,0,0,6
1946032,1522350,2025-03-20,Senate,"Senate Fiscal Policy",19,0,0,0,19
1946032,1528739,2025-03-27,Senate,"Senate: Third Reading RCS#14",38,0,0,1,39
1946071,1526316,2025-03-25,House,"House Government Operations Subcommittee",18,0,0,0,18
1946071,1537243,2025-03-25,House,"House Government Operations Subcommittee",18,0,0,0,18
1946071,1538293,2025-04-07,House,"House Health & Human Services Committee",24,0,0,2,26
1946071,1551383,2025-04-17,House,"House State Affairs Committee",15,5,0,6,26
1946184,1517056,2025-03-12,House,"House Industries & Professional Activities Subcommittee",17,0,0,1,18
1946184,1526302,2025-03-24,House,"House Commerce Committee",25,0,0,1,26
1946184,1535779,2025-04-03,House,"House: Third Reading RCS#39",107,0,12,0,119
1946221,1505208,2025-03-04,House,"House Natural Resources & Disasters Subcommittee",18,0,0,0,18
1946221,1525929,2025-03-25,House,"House Agriculture & Natural Resources Budget Subcommittee",14,0,0,1,15
1946221,1539335,2025-04-08,House,"House State Affairs Committee",22,0,0,4,26
1946221,1549600,2025-04-16,House,"House: Third Reading RCS#104",116,0,3,0,119
1946221,1559946,2025-04-29,Senate,"Senate: Third Reading RCS#2",38,0,0,0,38
1946259,1533893,2025-04-01,Senate,"Senate Regulated Industries",5,2,0,1,8
1946297,1527421,2025-03-26,House,"House Industries & Professional Activities Subcommittee",12,0,0,6,18
1946372,1504959,2025-03-04,Senate,"Senate Criminal Justice",8,0,0,1,9
1946372,1513041,2025-03-11,Senate,"Senate Military and Veterans Affairs, Space, and Domestic Security",5,0,0,1,6
1946372,1521053,2025-03-19,Senate,"Senate Rules",25,0,0,0,25
1946372,1528676,2025-03-27,Senate,"Senate: Third Reading RCS#15",38,0,0,1,39
1946447,1495184,2025-02-19,House,"House Civil Justice & Claims Subcommittee",17,1,0,0,18
1946447,1522906,2025-03-20,House,"House Budget Committee",25,3,0,2,30
1946447,1539643,2025-04-08,House,"House Judiciary Committee",19,3,0,0,22
1946447,1549752,2025-04-16,House,"House: Third Reading RCS#106",103,11,5,0,119
1947432,1487991,2025-02-11,Senate,"Senate Governmental Oversight and Accountability",7,0,0,1,8
1947432,1516176,2025-03-12,Senate,"Senate Rules",25,0,0,0,25
1947432,1521184,2025-03-19,Senate,"Senate: Third Reading RCS#15",39,0,0,0,39
1947432,1560220,2025-04-29,House,"House: Third Reading RCS#311",111,0,8,0,119
1947432,1562314,2025-04-30,Senate,"Senate: Third Reading RCS#8",37,0,0,1,38
1947986,1503332,2025-03-03,Senate,"Senate Commerce and Tourism",8,0,0,1,9
1948283,1517628,2025-03-13,House,"House Insurance & Banking Subcommittee",17,0,0,1,18
1948410,1516837,2025-03-13,House,"House Ways & Means Committee",18,0,0,1,19
1948410,1532056,2025-04-01,House,"House Intergovernmental Affairs Subcommittee",16,0,0,2,18
1948479,1521307,2025-03-19,House,"House Industries & Professional Activities Subcommittee",16,0,0,2,18
1948479,1531424,2025-03-31,House,"House Commerce Committee",20,0,0,6,26
1948479,1558327,2025-04-25,House,"House: Third Reading RCS#267",107,0,12,0,119
1948551,1520864,2025-03-19,House,"House Transportation & Economic Development Budget Subcommittee",14,0,0,1,15
1948551,1526362,2025-03-25,House,"House Economic Infrastructure Subcommittee",16,0,0,2,18
1948551,1529573,2025-03-27,House,"House Budget Committee",24,0,0,6,30
1948551,1558244,2025-04-25,House,"House: Third Reading RCS#255",111,0,8,0,119
1948923,1527453,2025-03-26,House,"House Criminal Justice Subcommittee",18,0,0,0,18
1948923,1544380,2025-04-10,House,"House Government Operations Subcommittee",11,6,0,1,18
1948923,1551092,2025-04-17,House,"House Judiciary Committee",16,4,0,2,22
1948923,1557062,2025-04-24,House,"House: Third Reading RCS#241",93,16,10,0,119
1949074,1527663,2025-03-26,House,"House Intergovernmental Affairs Subcommittee",14,0,0,5,19
1949074,1540755,2025-04-08,House,"House Ways & Means Committee",16,0,0,3,19
1949074,1551142,2025-04-17,House,"House State Affairs Committee",21,0,0,5,26
1949074,1556257,2025-04-23,House,"House: Third Reading RCS#181",111,0,8,0,119
1949074,1556585,2025-04-24,Senate,"Senate: Third Reading RCS#26",36,0,1,1,38
1951409,1508229,2025-03-06,House,"House Industries & Professional Activities Subcommittee",14,1,0,3,18
1951409,1525842,2025-03-25,House,"House Agriculture & Natural Resources Budget Subcommittee",14,0,0,1,15
1951551,1526780,2025-03-25,House,"House Student Academic Success Subcommittee",16,0,0,2,18
1951666,1521622,2025-03-19,Senate,"Senate Transportation",6,3,0,0,9
1951666,1533885,2025-04-01,Senate,"Senate Regulated Industries",8,0,0,0,8
1951666,1541345,2025-04-08,Senate,"Senate Fiscal Policy",19,0,0,0,19
1951666,1555272,2025-04-23,Senate,"Senate: Third Reading RCS#9",37,0,1,0,38
1951666,1559916,2025-04-29,House,"House: Third Reading RCS#313",114,0,5,0,119
1951702,1515644,2025-03-11,Senate,"Senate Community Affairs",7,0,0,1,8
1951702,1528107,2025-03-26,Senate,"Senate Appropriations Committee on Agriculture, Environment, and General Government",12,0,0,1,13
1951702,1532211,2025-04-01,Senate,"Senate Rules",25,0,0,0,25
1951702,1541505,2025-04-09,Senate,"Senate: Third Reading RCS#36",35,0,2,1,38
1951702,1541506,2025-04-09,Senate,"Senate: Third Reading RCS#37",37,0,0,1,38
1951899,1486021,2025-02-11,Senate,"Senate Environment and Natural Resources",9,0,0,0,9
1951899,1514140,2025-03-11,Senate,"Senate Governmental Oversight and Accountability",7,0,0,1,8
1951899,1520792,2025-03-19,Senate,"Senate Rules",25,0,0,0,25
1951899,1528585,2025-03-27,Senate,"Senate: Third Reading RCS#16",38,0,0,1,39
1951899,1560258,2025-04-29,House,"House: Third Reading RCS#338",113,2,4,0,119
1952078,1512712,2025-03-11,House,"House Human Services Subcommittee",18,0,0,0,18
1952078,1525209,2025-03-24,House,"House Health & Human Services Committee",26,0,0,1,27
1952078,1535895,2025-04-03,House,"House: Third Reading RCS#47",107,0,12,0,119
1952198,1513135,2025-03-11,Senate,"Senate Governmental Oversight and Accountability",7,0,0,1,8
1952247,1526664,2025-03-25,House,"House Government Operations Subcommittee",15,1,0,2,18
1952247,1531934,2025-04-01,House,"House Criminal Justice Subcommittee",13,4,0,1,18
1952247,1537224,2025-03-25,House,"House Government Operations Subcommittee",15,1,0,2,18
1952247,1551424,2025-04-17,House,"House State Affairs Committee",22,0,0,4,26
1952247,1555400,2025-04-23,House,"House: Third Reading RCS#184",75,38,6,0,119
1952247,1556970,2025-04-24,Senate,"Senate: Third Reading RCS#30",37,0,0,1,38
1953324,1526376,2025-03-25,Senate,"Senate Criminal Justice",9,0,0,0,9
1953324,1549537,2025-04-15,Senate,"Senate Appropriations Committee on Criminal and Civil Justice",9,0,0,0,9
1953324,1555091,2025-04-22,Senate,"Senate Fiscal Policy",19,0,0,0,19
1953354,1520790,2025-03-18,House,"House Housing, Agriculture & Tourism Subcommittee",17,0,0,1,18
1953354,1528693,2025-03-27,House,"House Civil Justice & Claims Subcommittee",15,0,0,3,18
1953383,1505346,2025-03-04,Senate,"Senate Criminal Justice",9,0,0,0,9
1953383,1520724,2025-03-18,Senate,"Senate Appropriations Committee on Criminal and Civil Justice",5,0,0,4,9
1953383,1529008,2025-03-27,Senate,"Senate Fiscal Policy",18,0,0,1,19
1953383,1535579,2025-04-03,Senate,"Senate: Third Reading RCS#7",37,0,0,1,38
1953383,1560005,2025-04-29,House,"House: Third Reading RCS#318",115,0,4,0,119
1953445,1513327,2025-03-11,House,"House Natural Resources & Disasters Subcommittee",16,0,0,2,18
1953445,1522774,2025-03-20,House,"House State Affairs Committee",23,0,0,3,26
1953506,1521863,2025-03-19,House,"House Information Technology Budget & Policy Subcommittee",17,0,0,1,18
1953506,1531443,2025-03-31,House,"House Economic Infrastructure Subcommittee",16,0,0,2,18
1953506,1549866,2025-04-15,House,"House Commerce Committee",25,0,0,1,26
1953605,1508413,2025-03-06,House,"House Criminal Justice Subcommittee",18,0,0,0,18
1953605,1517031,2025-03-13,House,"House Judiciary Committee",21,0,0,2,23
1953605,1542678,2025-04-09,House,"House: Third Reading RCS#78",111,0,8,0,119
1953605,1559292,2025-04-28,Senate,"Senate: Third Reading RCS#7",33,3,0,2,38
1953674,1523312,2025-03-20,House,"House Civil Justice & Claims Subcommittee",15,0,0,3,18
1953712,1507168,2025-03-05,House,"House Insurance & Banking Subcommittee",17,0,0,1,18
1953712,1538714,2025-04-07,House,"House Commerce Committee",24,0,0,2,26
1953712,1550250,2025-04-16,House,"House: Third Reading RCS#112",114,0,5,0,119
1953712,1557227,2025-04-24,Senate,"Senate: Third Reading RCS#43",37,0,0,1,38
1953805,1507694,2025-03-05,House,"House Insurance & Banking Subcommittee",17,0,0,1,18
1953805,1520323,2025-03-17,House,"House Commerce Committee",24,0,0,2,26
1953841,1520749,2025-03-18,House,"House Housing, Agriculture & Tourism Subcommittee",16,0,0,2,18
1953841,1532167,2025-04-01,House,"House Intergovernmental Affairs Subcommittee",16,0,0,2,18
1953841,1549884,2025-04-15,House,"House Commerce Committee",25,0,0,1,26
1953907,1545407,2025-04-10,House,"House Health Professions & Programs Subcommittee",17,0,0,1,18
1954083,1527340,2025-03-25,House,"House Housing, Agriculture & Tourism Subcommittee",16,0,0,2,18
1954083,1534311,2025-04-02,House,"House Budget Committee",25,0,0,5,30
1954083,1549771,2025-04-15,House,"House Commerce Committee",25,0,0,1,26
1954083,1554975,2025-04-23,House,"House: Third Reading RCS#151",114,0,5,0,119
1954083,1559667,2025-04-29,Senate,"Senate: Third Reading RCS#7",37,0,1,0,38
1954083,1563571,2025-05-01,House,"House: Third Reading RCS#398",111,0,8,0,119
1954083,1563957,2025-05-01,Senate,"Senate: Third Reading RCS#24",37,0,1,0,38
1954185,1532203,2025-04-01,House,"House Human Services Subcommittee",17,0,0,1,18
1954185,1551115,2025-04-17,House,"House Judiciary Committee",20,0,0,2,22
1954185,1553275,2025-04-22,House,"House Health & Human Services Committee",22,0,0,5,27
1954185,1558205,2025-04-25,House,"House: Third Reading RCS#261",109,1,9,0,119
1954289,1515648,2025-03-10,Senate,"Senate Banking and Insurance",10,0,0,0,10
1954289,1518454,2025-03-17,Senate,"Senate Commerce and Tourism",6,3,0,0,9
1954289,1527556,2025-03-26,Senate,"Senate Rules",22,2,0,1,25
1954289,1535635,2025-04-03,Senate,"Senate: Third Reading RCS#6",32,4,1,1,38
1954289,1559930,2025-04-29,House,"House: Third Reading RCS#287",114,0,5,0,119
1954507,1506171,2025-03-05,House,"House Civil Justice & Claims Subcommittee",18,0,0,0,18
1954507,1517759,2025-03-13,House,"House Insurance & Banking Subcommittee",16,0,0,2,18
1954507,1527500,2025-03-26,House,"House Judiciary Committee",22,0,0,0,22
1955024,1533974,2025-03-31,Senate,"Senate Community Affairs",8,0,0,0,8
1956108,1532083,2025-04-01,House,"House Criminal Justice Subcommittee",16,0,0,2,18
1956161,1526492,2025-03-25,Senate,"Senate Criminal Justice",9,0,0,0,9
1956161,1544642,2025-04-10,Senate,"Senate Appropriations Committee on Criminal and Civil Justice",8,0,0,1,9
1956161,1555197,2025-04-22,Senate,"Senate Fiscal Policy",18,0,0,1,19
1956265,1507373,2025-03-06,House,"House Intergovernmental Affairs Subcommittee",16,0,0,2,18
1956265,1517049,2025-03-13,House,"House State Affairs Committee",20,0,0,6,26
1956265,1542119,2025-04-09,House,"House: Third Reading RCS#71",111,0,8,0,119
1956265,1562175,2025-04-30,Senate,"Senate: Third Reading RCS#11",36,0,1,1,38
1956291,1515938,2025-03-12,Senate,"Senate Judiciary",9,2,0,0,11
1956291,1533372,2025-03-31,Senate,"Senate Banking and Insurance",9,1,0,0,10
1956291,1540214,2025-04-08,Senate,"Senate Rules",17,7,0,1,25
1956291,1554968,2025-04-23,Senate,"Senate: Third Reading RCS#8",28,10,0,0,38
1956326,1522798,2025-03-20,House,"House Ways & Means Committee",17,0,0,2,19
1956326,1527273,2025-03-25,House,"House Housing, Agriculture & Tourism Subcommittee",16,0,0,2,18
1956326,1549610,2025-04-15,House,"House Commerce Committee",22,0,0,4,26
1956326,1557088,2025-04-24,House,"House: Third Reading RCS#207",113,0,6,0,119
1956354,1506215,2025-03-05,House,"House Civil Justice & Claims Subcommittee",18,0,0,0,18
1956354,1516792,2025-03-12,House,"House Industries & Professional Activities Subcommittee",16,0,0,2,18
1956354,1527369,2025-03-26,House,"House Judiciary Committee",19,0,0,3,22
1956390,1523234,2025-03-20,House,"House Rules & Ethics Committee",16,0,0,2,18
1956390,1534588,2025-04-02,House,"House Judiciary Committee",18,0,0,4,22
1956390,1539383,2025-04-08,House,"House State Affairs Committee",22,0,0,4,26
1956483,1533944,2025-04-01,Senate,"Senate Regulated Industries",7,0,0,1,8
1956483,1548331,2025-04-15,Senate,"Senate Appropriations Committee on Agriculture, Environment, and General Government",12,0,0,0,12
1956483,1555039,2025-04-22,Senate,"Senate Fiscal Policy",18,0,0,1,19
1956520,1505445,2025-03-04,Senate,"Senate Criminal Justice",7,1,0,1,9
1956520,1545069,2025-04-10,Senate,"Senate Appropriations Committee on Agriculture, Environment, and General Government",10,1,0,1,12
1956520,1554970,2025-04-22,Senate,"Senate Fiscal Policy",19,0,0,0,19
1956553,1513942,2025-03-11,Senate,"Senate Environment and Natural Resources",8,1,0,0,9
1956553,1543518,2025-04-10,Senate,"Senate Appropriations Committee on Agriculture, Environment, and General Government",11,0,0,1,12
1956553,1553227,2025-04-21,Senate,"Senate Rules",22,1,0,2,25
1956553,1559701,2025-04-29,Senate,"Senate: Third Reading RCS#3",35,3,0,0,38
1956553,1561772,2025-04-30,House,"House: Third Reading RCS#342",87,26,6,0,119
1956553,1564642,2025-05-02,Senate,"Senate: Third Reading RCS#15",30,3,4,1,38
1956827,1514678,2025-03-11,Senate,"Senate Education Pre-K - 12",9,0,0,0,9
1956827,1529734,2025-03-26,Senate,"Senate Appropriations Committee on Pre-K - 12 Education",9,0,0,1,10
1956827,1541052,2025-04-08,Senate,"Senate Rules",24,0,0,1,25
1956827,1554965,2025-04-23,Senate,"Senate: Third Reading RCS#7",37,1,0,0,38
1957008,1514577,2025-03-11,House,"House Student Academic Success Subcommittee",17,0,0,1,18
1957008,1525819,2025-03-11,House,"House Student Academic Success Subcommittee",17,0,0,1,18
1957189,1526559,2025-03-25,Senate,"Senate Criminal Justice",9,0,0,0,9
1957189,1545431,2025-04-10,Senate,"Senate Appropriations Committee on Criminal and Civil Justice",8,0,0,1,9
1957189,1555215,2025-04-22,Senate,"Senate Fiscal Policy",18,0,0,1,19
1957248,1504723,2025-03-04,Senate,"Senate Judiciary",11,0,0,0,11
1957306,1506882,2025-03-05,House,"House Civil Justice & Claims Subcommittee",17,0,0,1,18
1957367,1508613,2025-03-06,House,"House Criminal Justice Subcommittee",16,0,0,2,18
1957367,1517034,2025-03-13,House,"House Judiciary Committee",19,0,0,4,23
1957367,1527863,2025-03-26,House,"House: Third Reading RCS#28",113,0,6,0,119
1957367,1535583,2025-04-03,Senate,"Senate: Third Reading RCS#9",37,0,0,1,38
1957611,1529291,2025-03-27,House,"House Health Care Facilities & Systems Subcommittee",16,0,0,2,18
1957728,1520837,2025-03-19,Senate,"Senate Judiciary",11,0,0,0,11
1957846,1508014,2025-03-06,House,"House Industries & Professional Activities Subcommittee",16,0,0,2,18
1957846,1520341,2025-03-17,House,"House Commerce Committee",22,0,0,4,26
1957959,1493875,2025-02-18,Senate,"Senate Education Pre-K - 12",8,0,0,0,8
1957959,1507082,2025-03-06,Senate,"Senate Fiscal Policy",16,0,0,3,19
1957959,1516316,2025-03-12,Senate,"Senate: Third Reading RCS#2",38,0,0,1,39
1957959,1562453,2025-04-30,House,"House: Third Reading RCS#382",113,0,6,0,119
1958195,1493842,2025-02-18,Senate,"Senate Military and Veterans Affairs, Space, and Domestic Security",5,0,0,0,5
1958195,1505711,2025-03-05,Senate,"Senate Appropriations Committee on Health and Human Services",10,0,0,0,10
1958195,1515729,2025-03-12,Senate,"Senate Rules",25,0,0,0,25
1958195,1521202,2025-03-19,Senate,"Senate: Third Reading RCS#7",39,0,0,0,39
1958195,1562383,2025-04-30,House,"House: Third Reading RCS#361",112,0,7,0,119
1958195,1564722,2025-05-02,House,"House: Third Reading RCS#420",98,0,21,0,119
1958304,1516791,2025-03-12,House,"House Industries & Professional Activities Subcommittee",15,1,0,2,18
1958304,1535636,2025-04-03,House,"House Civil Justice & Claims Subcommittee",12,0,0,7,19
1958304,1549576,2025-04-15,House,"House Commerce Committee",23,0,0,3,26
1958304,1555511,2025-04-23,House,"House: Third Reading RCS#170",115,0,4,0,119
1958304,1557140,2025-04-24,Senate,"Senate: Third Reading RCS#45",37,0,0,1,38
1958640,1520339,2025-03-18,House,"House Government Operations Subcommittee",12,3,0,4,19
1958640,1524271,2025-03-18,House,"House Government Operations Subcommittee",12,3,0,4,19
1958640,1528930,2025-03-27,House,"House Budget Committee",22,4,0,4,30
1958640,1551401,2025-04-17,House,"House State Affairs Committee",20,0,0,6,26
1958668,1504802,2025-03-04,Senate,"Senate Health Policy",10,0,0,0,10
1958668,1548186,2025-04-15,Senate,"Senate Appropriations Committee on Health and Human Services",8,1,0,1,10
1958771,1526626,2025-03-25,Senate,"Senate Transportation",8,0,0,1,9
1958771,1543726,2025-04-10,Senate,"Senate Appropriations Committee on Transportation, Tourism, and Economic Development",13,0,0,2,15
1958806,1531169,2025-03-31,House,"House Economic Infrastructure Subcommittee",16,0,0,2,18
1958806,1553586,2025-04-22,House,"House Commerce Committee",24,0,0,3,27
1958842,1523281,2025-03-20,House,"House Health Professions & Programs Subcommittee",12,6,0,0,18
1958842,1549004,2025-04-15,House,"House Health & Human Services Committee",17,7,0,2,26
1958842,1557099,2025-04-24,House,"House: Third Reading RCS#237",88,24,7,0,119
1958878,1516471,2025-03-12,House,"House Criminal Justice Subcommittee",17,1,0,1,19
1958878,1528331,2025-03-26,House,"House Judiciary Committee",21,1,0,0,22
1958878,1543155,2025-04-09,House,"House: Third Reading RCS#76",110,1,8,0,119
1958878,1557373,2025-04-24,Senate,"Senate: Third Reading RCS#21",37,0,0,1,38
1958912,1504685,2025-03-04,House,"House Health Care Facilities & Systems Subcommittee",17,0,0,1,18
1958912,1516397,2025-03-12,House,"House Criminal Justice Subcommittee",15,0,0,4,19
1958912,1525277,2025-03-24,House,"House Health & Human Services Committee",26,0,0,1,27
1958950,1534489,2025-04-02,House,"House Education Administration Subcommittee",17,0,0,1,18
1958981,1527136,2025-03-25,House,"House Student Academic Success Subcommittee",17,0,0,1,18
1958981,1533699,2025-04-01,House,"House PreK-12 Budget Subcommittee",11,0,0,4,15
1958981,1540817,2025-04-08,House,"House Education & Employment Committee",16,0,0,6,22
1958981,1558497,2025-04-25,House,"House: Third Reading RCS#271",107,0,12,0,119
1958981,1558857,2025-04-28,Senate,"Senate: Third Reading RCS#10",35,0,0,3,38
1959086,1529292,2025-03-27,House,"House Education Administration Subcommittee",13,4,0,1,18
1959086,1540025,2025-04-08,House,"House Education & Employment Committee",13,3,0,6,22
1959086,1556611,2025-04-24,House,"House: Third Reading RCS#198",83,28,8,0,119
1959086,1562496,2025-04-30,Senate,"Senate: Third Reading RCS#52",30,7,0,1,38
1959086,1563378,2025-05-01,House,"House: Third Reading RCS#393",86,25,8,0,119
1959191,1527296,2025-03-25,Senate,"Senate Health Policy",10,0,0,0,10
1959191,1543807,2025-04-10,Senate,"Senate Appropriations Committee on Health and Human Services",8,0,0,2,10
1959191,1555324,2025-04-22,Senate,"Senate Fiscal Policy",18,0,0,1,19
1960301,1518487,2025-03-17,Senate,"Senate Ethics and Elections",6,2,0,1,9
1960310,1527665,2025-03-26,House,"House Industries & Professional Activities Subcommittee",12,0,0,6,18
1960310,1539126,2025-04-07,House,"House Commerce Committee",23,0,0,3,26
1960310,1549664,2025-04-16,House,"House: Third Reading RCS#114",116,0,3,0,119
1960474,1504933,2025-03-04,Senate,"Senate Judiciary",11,0,0,0,11
1960474,1520729,2025-03-18,Senate,"Senate Appropriations Committee on Criminal and Civil Justice",5,0,0,4,9
1960474,1527730,2025-03-26,Senate,"Senate Rules",24,0,0,1,25
1960474,1535708,2025-04-03,Senate,"Senate: Third Reading RCS#5",37,0,0,1,38
1960474,1559983,2025-04-29,House,"House: Third Reading RCS#301",115,0,4,0,119
1961566,1531533,2025-03-31,Senate,"Senate Education Pre-K - 12",9,0,0,0,9
1961566,1549954,2025-04-16,Senate,"Senate Rules",23,0,0,2,25
1961566,1559000,2025-04-28,Senate,"Senate: Third Reading RCS#9",35,0,0,3,38
1961673,1506936,2025-03-05,House,"House Civil Justice & Claims Subcommittee",18,0,0,0,18
1961673,1522509,2025-03-20,House,"House Judiciary Committee",20,1,0,2,23
1961673,1527459,2025-03-26,House,"House: Third Reading RCS#24",104,6,9,0,119
1961673,1530729,2025-03-05,House,"House Civil Justice & Claims Subcommittee",18,0,0,0,18
1961673,1530730,2025-03-20,House,"House Judiciary Committee",20,1,0,2,23
1961673,1562419,2025-04-30,Senate,"Senate: Third Reading RCS#39",18,19,0,1,38
1961673,1563696,2025-05-01,Senate,"Senate: Third Reading RCS#22",33,4,1,0,38
1961827,1532791,2025-04-01,House,"House Criminal Justice Subcommittee",17,0,0,1,18
1961827,1539521,2025-04-08,House,"House Judiciary Committee",22,0,0,0,22
1962096,1508544,2025-03-06,House,"House Criminal Justice Subcommittee",18,0,0,0,18
1962096,1517027,2025-03-13,House,"House Judiciary Committee",21,0,0,2,23
1962096,1535807,2025-04-03,House,"House: Third Reading RCS#44",107,0,12,0,119
1962096,1550053,2025-04-16,Senate,"Senate: Third Reading RCS#15",36,0,1,1,38
1962154,1521326,2025-03-19,House,"House Health Care Facilities & Systems Subcommittee",17,0,0,1,18
1962260,1515241,2025-03-11,House,"House Natural Resources & Disasters Subcommittee",18,0,0,0,18
1962260,1535543,2025-04-02,House,"House State Affairs Committee",25,0,0,1,26
1962260,1549685,2025-04-16,House,"House: Third Reading RCS#91",115,0,4,0,119
1962260,1553098,2025-04-21,Senate,"Senate Rules",16,7,0,2,25
1962260,1563243,2025-04-30,Senate,"Senate: Third Reading RCS#55",29,8,0,1,38
1962522,1532410,2025-04-01,House,"House Natural Resources & Disasters Subcommittee",17,0,0,1,18
1962522,1535666,2025-04-01,House,"House Natural Resources & Disasters Subcommittee",17,0,0,1,18
1962522,1551293,2025-04-17,House,"House State Affairs Committee",15,9,0,2,26
1963394,1534297,2025-04-02,House,"House Health Care Facilities & Systems Subcommittee",17,0,0,1,18
1963394,1548868,2025-04-15,House,"House Health & Human Services Committee",23,0,0,3,26
1963394,1555444,2025-04-23,House,"House: Third Reading RCS#179",114,0,5,0,119
1963419,1515715,2025-03-12,Senate,"Senate Children, Families, and Elder Affairs",7,0,0,0,7
1963432,1503631,2025-03-03,Senate,"Senate Agriculture",5,1,0,0,6
1963449,1507191,2025-03-05,House,"House Insurance & Banking Subcommittee",16,0,0,2,18
1963449,1514354,2025-03-11,House,"House Health Care Facilities & Systems Subcommittee",18,0,0,0,18
1963449,1531387,2025-03-31,House,"House Commerce Committee",21,0,0,5,26
1963504,1544354,2025-04-10,House,"House Insurance & Banking Subcommittee",18,0,0,0,18
1963529,1527855,2025-03-26,House,"House Criminal Justice Subcommittee",13,0,0,5,18
1963529,1551334,2025-04-17,House,"House Judiciary Committee",19,0,0,3,22
1963529,1557259,2025-04-24,House,"House: Third Reading RCS#239",114,1,4,0,119
1963560,1515675,2025-03-12,Senate,"Senate Regulated Industries",8,0,0,1,9
1963580,1492013,2025-02-18,Senate,"Senate Regulated Industries",7,0,0,2,9
1963580,1513599,2025-03-11,Senate,"Senate Governmental Oversight and Accountability",7,0,0,1,8
1963580,1520905,2025-03-19,Senate,"Senate Rules",25,0,0,0,25
1963580,1528796,2025-03-27,Senate,"Senate: Third Reading RCS#18",38,0,0,1,39
1963580,1560064,2025-04-29,House,"House: Third Reading RCS#340",115,0,4,0,119
1963605,1492943,2025-02-18,Senate,"Senate Environment and Natural Resources",7,0,0,2,9
1963605,1505876,2025-03-05,Senate,"Senate Appropriations Committee on Agriculture, Environment, and General Government",11,0,0,2,13
1963605,1534711,2025-04-02,Senate,"Senate Appropriations",18,0,0,0,18
1963605,1541922,2025-04-09,Senate,"Senate: Third Reading RCS#19",37,0,0,1,38
1963605,1562210,2025-04-30,House,"House: Third Reading RCS#380",92,20,7,0,119
1963657,1515667,2025-03-11,Senate,"Senate Community Affairs",7,0,0,1,8
1963657,1526551,2025-03-25,Senate,"Senate Governmental Oversight and Accountability",6,0,0,2,8
1963657,1532668,2025-04-01,Senate,"Senate Rules",25,0,0,0,25
1963657,1542146,2025-04-09,Senate,"Senate: Third Reading RCS#39",34,0,3,1,38
1963657,1560117,2025-04-29,House,"House: Third Reading RCS#315",115,1,3,0,119
1963716,1495072,2025-02-18,Senate,"Senate Community Affairs",7,0,0,1,8
1963716,1513734,2025-03-11,Senate,"Senate Governmental Oversight and Accountability",7,0,0,1,8
1963716,1521136,2025-03-19,Senate,"Senate Rules",25,0,0,0,25
1963716,1528578,2025-03-27,Senate,"Senate: Third Reading RCS#17",37,1,0,1,39
1963716,1560257,2025-04-29,House,"House: Third Reading RCS#339",115,0,4,0,119
1963746,1508448,2025-03-06,House,"House Criminal Justice Subcommittee",15,0,0,3,18
1963746,1527845,2025-03-26,House,"House Judiciary Committee",22,0,0,0,22
1963746,1535777,2025-04-03,House,"House: Third Reading RCS#35",108,0,11,0,119
1963746,1542227,2025-04-09,Senate,"Senate: Third Reading RCS#44",37,0,0,1,38
1963769,1515932,2025-03-12,Senate,"Senate Regulated Industries",8,0,0,1,9
1963769,1525971,2025-03-25,Senate,"Senate Commerce and Tourism",8,1,0,0,9
1963769,1532669,2025-04-01,Senate,"Senate Rules",25,0,0,0,25
1963769,1542055,2025-04-09,Senate,"Senate: Third Reading RCS#38",36,1,0,1,38
1963769,1559939,2025-04-29,House,"House: Third Reading RCS#280",115,0,4,0,119
1963800,1517488,2025-03-13,House,"House Civil Justice & Claims Subcommittee",18,0,0,1,19
1963800,1525765,2025-03-24,House,"House Commerce Committee",25,0,0,1,26
1963800,1534710,2025-04-02,House,"House Judiciary Committee",20,0,0,2,22
1963800,1549645,2025-04-16,House,"House: Third Reading RCS#113",115,0,4,0,119
1963800,1555105,2025-04-23,Senate,"Senate: Third Reading RCS#20",38,0,0,0,38
1963822,1503253,2025-03-03,Senate,"Senate Agriculture",6,0,0,0,6
1963822,1533972,2025-04-01,Senate,"Senate Judiciary",11,0,0,0,11
1963822,1555184,2025-04-22,Senate,"Senate Fiscal Policy",19,0,0,0,19
1963853,1527477,2025-03-26,House,"House Industries & Professional Activities Subcommittee",13,2,0,3,18
1963853,1534530,2025-04-02,House,"House State Administration Budget Subcommittee",12,1,0,2,15
1963881,1516834,2025-03-12,House,"House Industries & Professional Activities Subcommittee",15,0,0,3,18
1963881,1542099,2025-04-09,House,"House Intergovernmental Affairs Subcommittee",17,0,0,1,18
1963907,1526618,2025-03-25,House,"House Human Services Subcommittee",17,0,0,1,18
1963907,1539414,2025-04-08,House,"House Judiciary Committee",19,0,0,3,22
1963937,1515726,2025-03-12,Senate,"Senate Judiciary",10,0,0,1,11
1963937,1533173,2025-04-01,Senate,"Senate Governmental Oversight and Accountability",7,0,0,0,7
1963937,1539821,2025-04-08,Senate,"Senate Rules",24,0,0,1,25
1963968,1516910,2025-03-13,House,"House Ways & Means Committee",14,5,0,0,19
1963968,1521769,2025-03-19,House,"House Intergovernmental Affairs Subcommittee",12,4,0,2,18
1964073,1527411,2025-03-25,Senate,"Senate Transportation",8,0,0,1,9
1964073,1543501,2025-04-10,Senate,"Senate Appropriations Committee on Transportation, Tourism, and Economic Development",14,0,0,1,15
1964133,1506122,2025-03-04,Senate,"Senate Transportation",7,1,0,1,9
1964133,1518816,2025-03-17,Senate,"Senate Environment and Natural Resources",8,0,0,1,9
1964159,1517765,2025-03-13,House,"House Civil Justice & Claims Subcommittee",15,0,0,4,19
1964159,1534823,2025-04-02,House,"House Judiciary Committee",20,0,0,2,22
1964238,1503883,2025-03-03,Senate,"Senate Commerce and Tourism",7,0,0,2,9
1964238,1516882,2025-03-11,Senate,"Senate Appropriations Committee on Transportation, Tourism, and Economic Development",15,0,0,0,15
1964238,1552047,2025-04-17,Senate,"Senate Appropriations",15,0,0,3,18
1964238,1558965,2025-04-28,Senate,"Senate: Third Reading RCS#11",35,0,0,3,38
1964260,1503906,2025-03-03,Senate,"Senate Commerce and Tourism",7,0,0,2,9
1964260,1512542,2025-03-11,Senate,"Senate Appropriations Committee on Transportation, Tourism, and Economic Development",15,0,0,0,15
1964260,1558864,2025-04-28,Senate,"Senate: Third Reading RCS#12",35,0,0,3,38
1964289,1530821,2025-03-31,Senate,"Senate Education Postsecondary",5,0,0,2,7
1964289,1547512,2025-04-10,Senate,"Senate Appropriations Committee on Health and Human Services",8,0,0,2,10
1964289,1551243,2025-04-17,Senate,"Senate Fiscal Policy",17,0,0,2,19
1964289,1555198,2025-04-23,Senate,"Senate: Third Reading RCS#6",38,0,0,0,38
1964289,1559796,2025-04-29,House,"House: Third Reading RCS#292",116,0,3,0,119
1964335,1503397,2025-03-03,Senate,"Senate Banking and Insurance",10,0,0,0,10
1964335,1526622,2025-03-25,Senate,"Senate Regulated Industries",8,0,0,1,9
1964335,1555044,2025-04-22,Senate,"Senate Fiscal Policy",18,0,0,1,19
1964414,1515677,2025-03-12,Senate,"Senate Regulated Industries",8,0,0,1,9
1964414,1532550,2025-04-01,Senate,"Senate Criminal Justice",8,1,0,0,9
1964414,1540146,2025-04-08,Senate,"Senate Rules",22,2,0,1,25
1964414,1549707,2025-04-16,Senate,"Senate: Third Reading RCS#6",35,1,1,1,38
1964414,1562117,2025-04-30,House,"House: Third Reading RCS#348",104,9,6,0,119
1964414,1563488,2025-05-01,Senate,"Senate: Third Reading RCS#14",35,2,1,0,38
1964440,1522149,2025-03-19,House,"House Intergovernmental Affairs Subcommittee",16,0,0,2,18
1964440,1527861,2025-03-26,House,"House Industries & Professional Activities Subcommittee",13,0,0,5,18
1964440,1535537,2025-04-02,House,"House State Affairs Committee",23,0,0,3,26
1964440,1557721,2025-04-24,House,"House: Third Reading RCS#231",112,0,7,0,119
1964440,1562025,2025-04-30,Senate,"Senate: Third Reading RCS#12",36,0,1,1,38
1964783,1534598,2025-04-01,Senate,"Senate Children, Families, and Elder Affairs",6,0,0,1,7
1964783,1548152,2025-04-15,Senate,"Senate Appropriations Committee on Health and Human Services",10,0,0,0,10
1964783,1555174,2025-04-22,Senate,"Senate Fiscal Policy",19,0,0,0,19
1964835,1505357,2025-03-04,Senate,"Senate Criminal Justice",8,0,0,1,9
1964835,1516995,2025-03-12,Senate,"Senate Transportation",9,0,0,0,9
1964835,1541277,2025-04-08,Senate,"Senate Fiscal Policy",19,0,0,0,19
1964855,1526458,2025-03-25,Senate,"Senate Regulated Industries",8,0,0,1,9
1964855,1548342,2025-04-15,Senate,"Senate Appropriations Committee on Agriculture, Environment, and General Government",12,0,0,0,12
1964855,1554728,2025-04-22,Senate,"Senate Fiscal Policy",18,0,0,1,19
1964855,1560308,2025-04-29,Senate,"Senate: Third Reading RCS#28",37,1,0,0,38
1964877,1533113,2025-04-01,Senate,"Senate Governmental Oversight and Accountability",7,0,0,0,7
1964877,1540444,2025-04-08,Senate,"Senate Rules",24,0,0,1,25
1964918,1526572,2025-03-25,Senate,"Senate Criminal Justice",9,0,0,0,9
1964918,1549547,2025-04-15,Senate,"Senate Appropriations Committee on Criminal and Civil Justice",8,1,0,0,9
1964918,1554109,2025-04-22,Senate,"Senate Fiscal Policy",14,4,0,1,19
1964918,1557069,2025-04-24,Senate,"Senate: Third Reading RCS#27",31,5,1,1,38
1964918,1560124,2025-04-29,House,"House: Third Reading RCS#321",113,1,5,0,119
1964976,1515777,2025-03-11,Senate,"Senate Community Affairs",4,3,0,1,8
1964976,1534452,2025-04-02,Senate,"Senate Fiscal Policy",10,5,0,4,19
1964997,1506779,2025-03-04,Senate,"Senate Transportation",8,0,0,1,9
1964997,1522191,2025-03-18,Senate,"Senate Appropriations Committee on Transportation, Tourism, and Economic Development",14,0,0,1,15
1965049,1516808,2025-03-12,House,"House Industries & Professional Activities Subcommittee",17,0,0,1,18
1965049,1541898,2025-04-09,House,"House Intergovernmental Affairs Subcommittee",17,0,0,1,18
1965049,1549657,2025-04-15,House,"House Commerce Committee",23,0,0,3,26
1965049,1555247,2025-04-23,House,"House: Third Reading RCS#172",112,2,5,0,119
1965049,1556692,2025-04-24,Senate,"Senate: Third Reading RCS#49",37,0,0,1,38
1965086,1517215,2025-03-12,House,"House Industries & Professional Activities Subcommittee",14,3,0,1,18
1965086,1531967,2025-04-01,House,"House Criminal Justice Subcommittee",11,6,0,1,18
1965086,1554005,2025-04-22,House,"House Commerce Committee",22,2,0,3,27
1965119,1516853,2025-03-12,House,"House Industries & Professional Activities Subcommittee",10,5,0,3,18
1965119,1526178,2025-03-25,House,"House Careers & Workforce Subcommittee",12,4,0,2,18
1965119,1539004,2025-04-07,House,"House Commerce Committee",14,6,0,6,26
1965131,1533266,2025-04-01,Senate,"Senate Transportation",8,0,0,1,9
1965140,1517146,2025-03-13,House,"House Education & Employment Committee",16,2,0,4,22
1965140,1522430,2025-03-20,House,"House State Affairs Committee",18,7,0,1,26
1965140,1535888,2025-04-03,House,"House: Third Reading RCS#54",78,29,12,0,119
1965140,1542325,2025-04-09,Senate,"Senate: Third Reading RCS#47",28,9,0,1,38
1965197,1517063,2025-03-12,House,"House Industries & Professional Activities Subcommittee",17,0,0,1,18
1965197,1549704,2025-04-15,House,"House Commerce Committee",24,0,0,2,26
1965224,1521279,2025-03-19,Senate,"Senate Regulated Industries",8,0,0,1,9
1965244,1529282,2025-03-27,House,"House Health Care Facilities & Systems Subcommittee",16,0,0,2,18
1965244,1538562,2025-04-07,House,"House Health & Human Services Committee",24,0,0,2,26
1965244,1549944,2025-04-16,House,"House: Third Reading RCS#140",116,0,3,0,119
1965244,1555106,2025-04-23,Senate,"Senate: Third Reading RCS#4",38,0,0,0,38
1965336,1517248,2025-03-13,House,"House Health Professions & Programs Subcommittee",14,0,0,4,18
1965336,1525306,2025-03-24,House,"House Health & Human Services Committee",25,0,0,2,27
1965336,1536099,2025-04-03,House,"House: Third Reading RCS#45",108,0,11,0,119
1965336,1556754,2025-04-24,Senate,"Senate: Third Reading RCS#42",37,0,0,1,38
1965376,1512830,2025-03-11,House,"House Human Services Subcommittee",18,0,0,0,18
1965376,1541541,2025-04-09,House,"House Health Care Budget Subcommittee",13,0,0,2,15
1965376,1553743,2025-04-22,House,"House Health & Human Services Committee",22,0,0,5,27
1965376,1558335,2025-04-25,House,"House: Third Reading RCS#268",107,0,12,0,119
1965376,1558862,2025-04-28,Senate,"Senate: Third Reading RCS#13",36,0,0,2,38
1965399,1504980,2025-03-04,House,"House Health Care Facilities & Systems Subcommittee",17,0,0,1,18
1966032,1527126,2025-03-25,Senate,"Senate Judiciary",10,0,0,1,11
1966032,1531761,2025-03-31,Senate,"Senate Community Affairs",8,0,0,0,8
1966032,1539944,2025-04-08,Senate,"Senate Rules",23,0,0,2,25
1966032,1550121,2025-04-16,Senate,"Senate: Third Reading RCS#7",36,0,1,1,38
1966187,1515909,2025-03-12,Senate,"Senate Regulated Industries",5,2,0,2,9
1966263,1517010,2025-03-12,Senate,"Senate Transportation",9,0,0,0,9
1966263,1546279,2025-04-10,Senate,"Senate Appropriations Committee on Pre-K - 12 Education",8,0,0,1,9
1966263,1550401,2025-04-16,Senate,"Senate Rules",23,0,0,2,25
1966346,1535829,2025-04-03,House,"House Health Professions & Programs Subcommittee",16,0,0,2,18
1966346,1548878,2025-04-15,House,"House Health & Human Services Committee",21,0,0,5,26
1966346,1558102,2025-04-25,House,"House: Third Reading RCS#260",110,0,9,0,119
1966426,1527215,2025-03-25,Senate,"Senate Health Policy",10,0,0,0,10
1966426,1531449,2025-03-31,Senate,"Senate Commerce and Tourism",9,0,0,0,9
1966426,1541014,2025-04-08,Senate,"Senate Rules",24,0,0,1,25
1966580,1509138,2025-03-04,Senate,"Senate Transportation",9,0,0,0,9
1966580,1519382,2025-03-18,Senate,"Senate Appropriations Committee on Transportation, Tourism, and Economic Development",14,0,0,1,15
1966658,1516253,2025-03-12,Senate,"Senate Transportation",9,0,0,0,9
1966658,1524901,2025-03-24,Senate,"Senate Appropriations Committee on Transportation, Tourism, and Economic Development",14,0,0,1,15
1966982,1534348,2025-04-01,House,"House Housing, Agriculture & Tourism Subcommittee",14,0,0,4,18
1966982,1544140,2025-04-10,House,"House Transportation & Economic Development Budget Subcommittee",10,0,0,5,15
1966982,1553736,2025-04-22,House,"House Commerce Committee",23,0,0,4,27
1967029,1521608,2025-03-19,House,"House Intergovernmental Affairs Subcommittee",18,0,0,0,18
1967029,1534190,2025-04-01,House,"House Industries & Professional Activities Subcommittee",16,0,0,3,19
1967029,1551052,2025-04-17,House,"House State Affairs Committee",23,0,0,3,26
1967029,1555440,2025-04-23,House,"House: Third Reading RCS#188",112,0,7,0,119
1967060,1525877,2025-03-25,House,"House Economic Infrastructure Subcommittee",16,0,0,2,18
1967060,1543594,2025-04-10,House,"House Transportation & Economic Development Budget Subcommittee",10,0,0,5,15
1967060,1553886,2025-04-22,House,"House Commerce Committee",23,0,0,4,27
1967112,1529021,2025-03-27,House,"House Civil Justice & Claims Subcommittee",14,0,0,4,18
1967112,1539630,2025-04-08,House,"House Judiciary Committee",21,0,0,1,22
1967112,1556996,2025-04-24,House,"House: Third Reading RCS#232",113,0,6,0,119
1967112,1558792,2025-04-28,Senate,"Senate: Third Reading RCS#21",36,0,0,2,38
1967143,1529571,2025-03-27,House,"House Education Administration Subcommittee",17,0,0,1,18
1967165,1526360,2025-03-25,Senate,"Senate Community Affairs",8,0,0,0,8
1967165,1548780,2025-04-15,Senate,"Senate Finance and Tax",5,0,0,1,6
1967165,1553206,2025-04-21,Senate,"Senate Rules",23,0,0,2,25
1967198,1520527,2025-03-18,House,"House Government Operations Subcommittee",16,0,0,3,19
1967198,1524108,2025-03-18,House,"House Government Operations Subcommittee",16,0,0,3,19
1967198,1551043,2025-04-17,House,"House State Affairs Committee",23,0,0,3,26
1967198,1555069,2025-04-23,House,"House: Third Reading RCS#156",115,0,4,0,119
1967251,1521250,2025-03-19,Senate,"Senate Transportation",9,0,0,0,9
1967251,1527751,2025-03-26,Senate,"Senate Appropriations Committee on Transportation, Tourism, and Economic Development",15,0,0,0,15
1967286,1516310,2025-03-12,House,"House Intergovernmental Affairs Subcommittee",12,2,0,4,18
1967286,1529476,2025-03-27,House,"House Education Administration Subcommittee",13,4,0,1,18
1967286,1539692,2025-04-08,House,"House State Affairs Committee",16,6,0,4,26
1967286,1549526,2025-04-16,House,"House: Third Reading RCS#97",86,26,7,0,119
1967313,1534769,2025-04-01,House,"House Housing, Agriculture & Tourism Subcommittee",14,0,0,4,18
1967313,1544123,2025-04-10,House,"House Transportation & Economic Development Budget Subcommittee",10,0,0,5,15
1967313,1554730,2025-04-22,House,"House Commerce Committee",23,0,0,4,27
1967372,1514673,2025-03-11,House,"House Government Operations Subcommittee",13,4,0,1,18
1967372,1522703,2025-03-20,House,"House State Affairs Committee",16,7,0,3,26
1967372,1536190,2025-04-03,House,"House: Third Reading RCS#53",78,27,14,0,119
1967372,1541982,2025-04-09,Senate,"Senate: Third Reading RCS#40",28,9,0,1,38
1967393,1514466,2025-03-11,House,"House Natural Resources & Disasters Subcommittee",13,5,0,0,18
1967427,1513856,2025-03-11,House,"House Housing, Agriculture & Tourism Subcommittee",17,0,0,1,18
1967427,1532075,2025-04-01,House,"House Intergovernmental Affairs Subcommittee",16,0,0,2,18
1967427,1553686,2025-04-22,House,"House Commerce Committee",15,8,0,4,27
1967454,1517477,2025-03-13,House,"House Civil Justice & Claims Subcommittee",15,0,0,4,19
1967454,1534931,2025-04-02,House,"House Judiciary Committee",19,0,0,3,22
1967478,1513955,2025-03-11,Senate,"Senate Health Policy",9,1,0,0,10
1967535,1516496,2025-03-12,House,"House Careers & Workforce Subcommittee",15,0,0,3,18
1967535,1517007,2025-03-12,House,"House Careers & Workforce Subcommittee",15,0,0,3,18
1967535,1521836,2025-03-19,House,"House Education Administration Subcommittee",16,0,0,2,18
1967572,1509564,2025-03-10,Senate,"Senate Commerce and Tourism",8,0,0,1,9
1967572,1528150,2025-03-26,Senate,"Senate Appropriations Committee on Agriculture, Environment, and General Government",12,0,0,1,13
1967572,1533574,2025-04-01,Senate,"Senate Rules",24,0,0,1,25
1967572,1541520,2025-04-09,Senate,"Senate: Third Reading RCS#41",37,0,0,1,38
1967572,1560806,2025-04-29,House,"House: Third Reading RCS#305",115,0,4,0,119
1967715,1505245,2025-03-04,House,"House Natural Resources & Disasters Subcommittee",16,2,0,0,18
1967715,1535843,2025-04-03,House,"House Civil Justice & Claims Subcommittee",14,0,0,5,19
1967815,1522008,2025-03-18,Senate,"Senate Military and Veterans Affairs, Space, and Domestic Security",5,0,0,1,6
1967866,1509137,2025-03-10,Senate,"Senate Commerce and Tourism",5,3,0,1,9
1967866,1526371,2025-03-25,Senate,"Senate Governmental Oversight and Accountability",5,1,0,2,8
1968017,1543466,2025-04-10,House,"House Civil Justice & Claims Subcommittee",13,2,0,3,18
1968271,1521436,2025-03-19,House,"House Intergovernmental Affairs Subcommittee",16,0,0,2,18
1968271,1539420,2025-04-08,House,"House Judiciary Committee",21,0,0,1,22
1968271,1551343,2025-04-17,House,"House State Affairs Committee",23,0,0,3,26
1968271,1555276,2025-04-23,House,"House: Third Reading RCS#187",115,0,4,0,119
1968271,1558769,2025-03-19,House,"House Intergovernmental Affairs Subcommittee",16,0,0,2,18
1968271,1558770,2025-04-08,House,"House Judiciary Committee",21,0,0,1,22
1968271,1558771,2025-04-17,House,"House State Affairs Committee",23,0,0,3,26
1968271,1558772,2025-04-28,Senate,"Senate: Third Reading RCS#2",36,0,0,2,38
1968271,1562122,2025-04-30,House,"House: Third Reading RCS#366",112,0,7,0,119
1968310,1529352,2025-03-27,House,"House Ways & Means Committee",18,0,0,1,19
1968330,1520010,2025-03-18,House,"House Student Academic Success Subcommittee",16,0,0,2,18
1968330,1520977,2025-03-18,House,"House Student Academic Success Subcommittee",16,0,0,2,18
1968330,1524080,2025-03-18,House,"House Student Academic Success Subcommittee",16,0,0,2,18
1968330,1528581,2025-03-27,House,"House Health Professions & Programs Subcommittee",16,0,0,2,18
1968330,1534225,2025-04-02,House,"House Budget Committee",20,0,0,10,30
1968330,1539589,2025-04-08,House,"House Education & Employment Committee",16,0,0,6,22
1968501,1522115,2025-03-19,House,"House Intergovernmental Affairs Subcommittee",17,0,0,1,18
1968501,1535266,2025-04-02,House,"House State Affairs Committee",24,0,0,2,26
1968501,1549692,2025-04-16,House,"House: Third Reading RCS#121",112,0,7,0,119
1968501,1563152,2025-04-30,Senate,"Senate: Third Reading RCS#13",36,0,1,1,38
1968600,1516513,2025-03-12,House,"House Intergovernmental Affairs Subcommittee",16,0,0,2,18
1968600,1521825,2025-03-19,House,"House Criminal Justice Subcommittee",18,0,0,0,18
1968600,1535509,2025-04-02,House,"House State Affairs Committee",25,0,0,1,26
1968600,1549701,2025-04-16,House,"House: Third Reading RCS#128",112,0,7,0,119
1968600,1561877,2025-04-30,Senate,"Senate: Third Reading RCS#14",36,0,1,1,38
1968812,1504770,2025-03-04,House,"House Education Administration Subcommittee",18,0,0,0,18
1968812,1517249,2025-03-13,House,"House Health Professions & Programs Subcommittee",14,0,0,4,18
1968812,1525782,2025-03-04,House,"House Education Administration Subcommittee",18,0,0,0,18
1968812,1534745,2025-04-02,House,"House Education & Employment Committee",17,0,0,5,22
1968812,1542145,2025-04-09,House,"House: Third Reading RCS#88",110,0,9,0,119
1968812,1549700,2025-04-16,Senate,"Senate: Third Reading RCS#10",36,0,1,1,38
1969068,1526265,2025-03-25,Senate,"Senate Criminal Justice",9,0,0,0,9
1969068,1533931,2025-04-01,Senate,"Senate Regulated Industries",8,0,0,0,8
1969068,1539650,2025-04-08,Senate,"Senate Rules",24,0,0,1,25
1969171,1509310,2025-03-10,Senate,"Senate Commerce and Tourism",7,1,0,1,9
1969327,1513526,2025-03-11,Senate,"Senate Criminal Justice",9,0,0,0,9
1969327,1549513,2025-04-15,Senate,"Senate Appropriations Committee on Criminal and Civil Justice",9,0,0,0,9
1969327,1554991,2025-04-22,Senate,"Senate Fiscal Policy",17,1,0,1,19
1969426,1534537,2025-03-31,Senate,"Senate Community Affairs",8,0,0,0,8
1969426,1548441,2025-04-15,Senate,"Senate Appropriations Committee on Agriculture, Environment, and General Government",12,0,0,0,12
1969426,1553317,2025-04-21,Senate,"Senate Rules",23,0,0,2,25
1969535,1514281,2025-03-11,Senate,"Senate Agriculture",6,0,0,0,6
1969535,1528115,2025-03-26,Senate,"Senate Appropriations Committee on Agriculture, Environment, and General Government",8,4,0,1,13
1969535,1541268,2025-04-08,Senate,"Senate Fiscal Policy",13,5,0,1,19
1969535,1548873,2025-04-15,Senate,"Senate: Third Reading RCS#8",13,21,2,2,38
1969535,1549853,2025-04-16,Senate,"Senate: Third Reading RCS#19",27,9,1,1,38
1969535,1559666,2025-04-29,House,"House: Third Reading RCS#275",88,27,4,0,119
1969589,1533950,2025-04-01,Senate,"Senate Judiciary",11,0,0,0,11
1969698,1513742,2025-03-11,Senate,"Senate Criminal Justice",9,0,0,0,9
1969698,1532683,2025-04-01,Senate,"Senate Governmental Oversight and Accountability",7,0,0,0,7
1969698,1540348,2025-04-08,Senate,"Senate Rules",22,2,0,1,25
1969698,1549675,2025-04-16,Senate,"Senate: Third Reading RCS#8",36,0,1,1,38
1969805,1504965,2025-03-04,Senate,"Senate Judiciary",9,2,0,0,11
1969805,1519358,2025-03-18,Senate,"Senate Appropriations Committee on Health and Human Services",8,2,0,0,10
1969805,1527748,2025-03-26,Senate,"Senate Rules",23,1,0,1,25
1969855,1504737,2025-03-04,Senate,"Senate Health Policy",10,0,0,0,10
1969855,1519743,2025-03-18,Senate,"Senate Appropriations Committee on Health and Human Services",9,0,0,1,10
1969855,1534554,2025-04-02,Senate,"Senate Fiscal Policy",17,0,0,2,19
1969855,1541723,2025-04-09,Senate,"Senate: Third Reading RCS#42",37,0,0,1,38
1970006,1516157,2025-03-12,Senate,"Senate Transportation",9,0,0,0,9
1970006,1524796,2025-03-24,Senate,"Senate Appropriations Committee on Transportation, Tourism, and Economic Development",14,0,0,1,15
1970026,1517035,2025-03-12,Senate,"Senate Children, Families, and Elder Affairs",6,0,0,1,7
1970026,1527948,2025-03-26,Senate,"Senate Appropriations Committee on Health and Human Services",10,0,0,0,10
1970026,1534380,2025-04-02,Senate,"Senate Fiscal Policy",17,0,0,2,19
1970026,1554998,2025-04-23,Senate,"Senate: Third Reading RCS#2",37,0,1,0,38
1970026,1562171,2025-04-30,House,"House: Third Reading RCS#355",114,0,5,0,119
1970027,1526204,2025-03-25,Senate,"Senate Community Affairs",7,0,0,1,8
1970061,1515781,2025-03-12,Senate,"Senate Judiciary",8,2,0,1,11
1970061,1525983,2025-03-25,Senate,"Senate Commerce and Tourism",6,3,0,0,9
1970101,1515316,2025-03-11,Senate,"Senate Education Pre-K - 12",8,0,0,1,9
1970101,1546290,2025-04-10,Senate,"Senate Appropriations Committee on Pre-K - 12 Education",8,0,0,1,9
1970101,1555655,2025-04-22,Senate,"Senate Fiscal Policy",18,0,0,1,19
1970181,1527930,2025-03-25,Senate,"Senate Community Affairs",7,0,0,1,8
1970227,1507742,2025-03-06,House,"House Intergovernmental Affairs Subcommittee",15,0,0,3,18
1970240,1531541,2025-03-31,Senate,"Senate Education Pre-K - 12",9,0,0,0,9
1970240,1549585,2025-04-15,Senate,"Senate Appropriations Committee on Higher Education",7,0,0,1,8
1970240,1555158,2025-04-22,Senate,"Senate Fiscal Policy",18,0,0,1,19
1970257,1515665,2025-03-10,Senate,"Senate Banking and Insurance",9,0,0,1,10
1970257,1519394,2025-03-18,Senate,"Senate Appropriations Committee on Health and Human Services",10,0,0,0,10
1970257,1534080,2025-04-02,Senate,"Senate Fiscal Policy",17,0,0,2,19
1970257,1541986,2025-04-09,Senate,"Senate: Third Reading RCS#43",37,0,0,1,38
1970265,1517576,2025-03-13,House,"House Civil Justice & Claims Subcommittee",12,4,0,3,19
1970265,1520795,2025-03-18,House,"House Housing, Agriculture & Tourism Subcommittee",16,1,0,1,18
1970265,1527441,2025-03-26,House,"House Judiciary Committee",18,3,0,1,22
1970265,1535930,2025-04-03,House,"House: Third Reading RCS#36",108,0,11,0,119
1970265,1550361,2025-04-16,Senate,"Senate: Third Reading RCS#14",35,1,1,1,38
1970297,1514704,2025-03-11,Senate,"Senate Environment and Natural Resources",9,0,0,0,9
1970297,1527725,2025-03-26,Senate,"Senate Appropriations Committee on Agriculture, Environment, and General Government",12,0,0,1,13
1970297,1540171,2025-04-08,Senate,"Senate Rules",23,0,0,2,25
1970671,1517217,2025-03-13,House,"House Civil Justice & Claims Subcommittee",18,0,0,1,19
1970671,1534560,2025-04-02,House,"House Judiciary Committee",19,0,0,3,22
1970800,1519559,2025-03-18,House,"House Human Services Subcommittee",17,0,0,1,18
1970800,1532835,2025-04-01,House,"House Health Care Budget Subcommittee",14,0,0,1,15
1970800,1548825,2025-04-15,House,"House Health & Human Services Committee",22,0,0,4,26
1970800,1556993,2025-04-24,House,"House: Third Reading RCS#211",113,0,6,0,119
1970800,1560179,2025-04-29,Senate,"Senate: Third Reading RCS#18",38,0,0,0,38
1970927,1507584,2025-03-06,House,"House Intergovernmental Affairs Subcommittee",16,0,0,2,18
1970927,1523086,2025-03-20,House,"House Ways & Means Committee",17,0,0,2,19
1970927,1527993,2025-03-26,House,"House State Affairs Committee",21,0,0,6,27
1970927,1542426,2025-04-09,House,"House: Third Reading RCS#73",111,0,8,0,119
1970927,1562394,2025-04-30,Senate,"Senate: Third Reading RCS#15",36,0,1,1,38
1970969,1530968,2025-03-31,Senate,"Senate Ethics and Elections",8,0,0,1,9
1970969,1543317,2025-04-10,Senate,"Senate Appropriations Committee on Transportation, Tourism, and Economic Development",13,0,0,2,15
1971008,1514223,2025-03-11,Senate,"Senate Health Policy",10,0,0,0,10
1971020,1503225,2025-03-03,Senate,"Senate Environment and Natural Resources",9,0,0,0,9
1971020,1519716,2025-03-18,Senate,"Senate Appropriations Committee on Agriculture, Environment, and General Government",12,0,0,1,13
1971020,1529193,2025-03-27,Senate,"Senate Fiscal Policy",18,0,0,1,19
1971020,1535629,2025-04-03,Senate,"Senate: Third Reading RCS#10",37,0,0,1,38
1971020,1561943,2025-04-30,House,"House: Third Reading RCS#363",113,0,6,0,119
1971107,1515723,2025-03-12,Senate,"Senate Judiciary",11,0,0,0,11
1971107,1525820,2025-03-24,Senate,"Senate Appropriations Committee on Criminal and Civil Justice",9,0,0,0,9
1971107,1534264,2025-04-02,Senate,"Senate Fiscal Policy",18,0,0,1,19
1971206,1519472,2025-03-18,House,"House Natural Resources & Disasters Subcommittee",17,0,0,1,18
1971206,1534835,2025-04-02,House,"House State Affairs Committee",21,2,0,3,26
1971252,1506342,2025-03-05,House,"House Health Professions & Programs Subcommittee",12,6,0,0,18
1971252,1525420,2025-03-24,House,"House Health & Human Services Committee",18,7,0,2,27
1971252,1535766,2025-04-03,House,"House: Third Reading RCS#40",77,30,12,0,119
1971304,1521112,2025-03-18,Senate,"Senate Health Policy",8,1,0,1,10
1971304,1533895,2025-04-01,Senate,"Senate Judiciary",11,0,0,0,11
1971304,1540126,2025-04-08,Senate,"Senate Rules",24,0,0,1,25
1971304,1549977,2025-04-16,Senate,"Senate: Third Reading RCS#9",35,0,2,1,38
1971304,1559963,2025-04-29,House,"House: Third Reading RCS#307",113,0,6,0,119
1971304,1563828,2025-05-01,Senate,"Senate: Third Reading RCS#17",37,0,1,0,38
1971304,1564590,2025-05-02,House,"House: Third Reading RCS#407",114,0,5,0,119
1971349,1528698,2025-03-27,House,"House Health Professions & Programs Subcommittee",17,0,0,1,18
1971349,1538564,2025-04-07,House,"House Health & Human Services Committee",23,0,0,3,26
1971349,1549969,2025-04-16,House,"House: Third Reading RCS#137",111,0,8,0,119
1971349,1555194,2025-04-23,Senate,"Senate: Third Reading RCS#30",38,0,0,0,38
1971398,1529512,2025-03-27,House,"House Insurance & Banking Subcommittee",17,1,0,0,18
1971398,1535865,2025-04-03,House,"House Civil Justice & Claims Subcommittee",14,0,0,5,19
1971398,1553612,2025-04-22,House,"House Commerce Committee",24,0,0,3,27
1971398,1558086,2025-04-25,House,"House: Third Reading RCS#251",100,3,16,0,119
1971493,1518591,2025-03-17,Senate,"Senate Education Pre-K - 12",8,0,0,1,9
1971493,1534279,2025-04-01,Senate,"Senate Health Policy",10,0,0,0,10
1971493,1539669,2025-04-08,Senate,"Senate Rules",24,0,0,1,25
1971548,1520764,2025-03-18,House,"House Housing, Agriculture & Tourism Subcommittee",14,3,0,1,18
1971548,1527400,2025-03-26,House,"House Criminal Justice Subcommittee",14,4,0,0,18
1971548,1531409,2025-03-31,House,"House Agriculture & Natural Resources Budget Subcommittee",11,4,0,1,16
1971548,1549882,2025-04-15,House,"House Commerce Committee",22,3,0,1,26
1971879,1507126,2025-03-05,House,"House Insurance & Banking Subcommittee",17,0,0,1,18
1971879,1519557,2025-03-17,House,"House Commerce Committee",24,0,0,2,26
1971879,1535834,2025-04-03,House,"House: Third Reading RCS#37",110,0,9,0,119
1971879,1542441,2025-04-09,Senate,"Senate: Third Reading RCS#52",36,0,0,2,38
1971907,1516498,2025-03-12,House,"House Intergovernmental Affairs Subcommittee",15,0,0,3,18
1971907,1523197,2025-03-20,House,"House State Affairs Committee",23,0,0,3,26
1971907,1543160,2025-04-09,House,"House: Third Reading RCS#72",111,0,8,0,119
1971907,1562021,2025-04-30,Senate,"Senate: Third Reading RCS#16",36,0,1,1,38
1972025,1516476,2025-03-12,House,"House Criminal Justice Subcommittee",16,0,0,3,19
1972025,1527919,2025-03-26,House,"House Judiciary Committee",20,2,0,0,22
1972025,1557687,2025-04-24,House,"House: Third Reading RCS#206",99,13,7,0,119
1972025,1563276,2025-04-30,Senate,"Senate: Third Reading RCS#54",25,12,0,1,38
1972053,1520596,2025-03-18,Senate,"Senate Criminal Justice",7,2,0,0,9
1972053,1550139,2025-04-15,Senate,"Senate Appropriations Committee on Criminal and Civil Justice",6,3,0,0,9
1972053,1555854,2025-04-22,Senate,"Senate Fiscal Policy",15,3,0,1,19
1972079,1532770,2025-04-01,House,"House Natural Resources & Disasters Subcommittee",16,0,0,2,18
1972091,1516434,2025-03-12,House,"House Intergovernmental Affairs Subcommittee",15,0,0,3,18
1972091,1523411,2025-03-20,House,"House Ways & Means Committee",17,0,0,2,19
1972091,1535369,2025-04-02,House,"House State Affairs Committee",24,0,0,2,26
1972091,1549688,2025-04-16,House,"House: Third Reading RCS#111",113,0,6,0,119
1972091,1556587,2025-04-24,Senate,"Senate: Third Reading RCS#31",36,0,1,1,38
1972165,1516242,2025-03-12,House,"House Intergovernmental Affairs Subcommittee",16,0,0,2,18
1972165,1522945,2025-03-20,House,"House Ways & Means Committee",17,0,0,2,19
1972165,1531616,2025-03-12,House,"House Intergovernmental Affairs Subcommittee",16,0,0,2,18
1972165,1531617,2025-03-20,House,"House Ways & Means Committee",17,0,0,2,19
1972165,1534740,2025-04-02,House,"House State Affairs Committee",23,0,0,3,26
1972165,1549651,2025-04-16,House,"House: Third Reading RCS#125",116,0,3,0,119
1972165,1562222,2025-04-30,Senate,"Senate: Third Reading RCS#18",36,0,1,1,38
1972204,1520793,2025-03-18,House,"House Housing, Agriculture & Tourism Subcommittee",16,1,0,1,18
1972204,1542221,2025-04-09,House,"House Intergovernmental Affairs Subcommittee",16,0,0,2,18
1972242,1516182,2025-03-12,House,"House Criminal Justice Subcommittee",16,0,0,3,19
1972242,1527872,2025-03-26,House,"House Judiciary Committee",21,0,0,1,22
1972281,1520051,2025-03-17,Senate,"Senate Community Affairs",8,0,0,0,8
1972281,1533898,2025-04-01,Senate,"Senate Judiciary",11,0,0,0,11
1972281,1540289,2025-04-08,Senate,"Senate Rules",24,0,0,1,25
1972281,1549679,2025-04-16,Senate,"Senate: Third Reading RCS#11",36,0,1,1,38
1972281,1560107,2025-04-29,House,"House: Third Reading RCS#283",115,0,4,0,119
1972320,1513838,2025-03-11,Senate,"Senate Agriculture",6,0,0,0,6
1972402,1528664,2025-03-27,House,"House Civil Justice & Claims Subcommittee",15,0,0,3,18
1972564,1508118,2025-03-06,House,"House Intergovernmental Affairs Subcommittee",16,0,0,2,18
1972564,1520239,2025-03-18,House,"House Government Operations Subcommittee",15,0,0,4,19
1972564,1524082,2025-03-18,House,"House Government Operations Subcommittee",15,0,0,4,19
1972564,1535353,2025-04-02,House,"House State Affairs Committee",24,0,0,2,26
1972564,1549666,2025-04-16,House,"House: Third Reading RCS#127",116,0,3,0,119
1972564,1562592,2025-04-30,Senate,"Senate: Third Reading RCS#17",36,0,1,1,38
1972698,1513752,2025-03-11,House,"House Health Care Facilities & Systems Subcommittee",16,0,0,2,18
1972698,1522839,2025-03-20,House,"House Budget Committee",26,0,0,4,30
1972698,1531122,2025-03-31,House,"House Health & Human Services Committee",25,0,0,2,27
1972698,1549696,2025-04-16,House,"House: Third Reading RCS#138",115,0,4,0,119
1972698,1556382,2025-04-24,Senate,"Senate: Third Reading RCS#4",32,4,1,1,38
1972784,1519555,2025-03-18,House,"House Natural Resources & Disasters Subcommittee",13,0,0,5,18
1972871,1527356,2025-03-25,Senate,"Senate Military and Veterans Affairs, Space, and Domestic Security",6,0,0,0,6
1972871,1544333,2025-04-10,Senate,"Senate Appropriations Committee on Health and Human Services",8,0,0,2,10
1972871,1551275,2025-04-17,Senate,"Senate Fiscal Policy",16,0,0,3,19
1973099,1508418,2025-03-06,House,"House Criminal Justice Subcommittee",17,1,0,0,18
1973099,1517028,2025-03-13,House,"House Judiciary Committee",20,0,0,3,23
1973099,1535785,2025-04-03,House,"House: Third Reading RCS#43",96,10,13,0,119
1973099,1556613,2025-04-24,Senate,"Senate: Third Reading RCS#3",32,5,0,1,38
1973118,1520303,2025-03-18,House,"House Natural Resources & Disasters Subcommittee",16,1,0,1,18
1973118,1528455,2025-03-26,House,"House State Affairs Committee",22,0,0,5,27
1973135,1521690,2025-03-19,House,"House Intergovernmental Affairs Subcommittee",12,5,0,1,18
1973135,1534692,2025-04-02,House,"House Education Administration Subcommittee",11,6,0,1,18
1973135,1539435,2025-04-08,House,"House State Affairs Committee",16,6,0,4,26
1973135,1550076,2025-04-16,House,"House: Third Reading RCS#144",82,33,4,0,119
1973157,1516800,2025-03-12,House,"House Industries & Professional Activities Subcommittee",16,1,0,1,18
1973157,1532087,2025-04-01,House,"House Intergovernmental Affairs Subcommittee",15,0,0,3,18
1973157,1549857,2025-04-15,House,"House Commerce Committee",25,0,0,1,26
1973157,1555417,2025-04-23,House,"House: Third Reading RCS#171",114,0,5,0,119
1973157,1562291,2025-04-30,Senate,"Senate: Third Reading RCS#40",36,0,1,1,38
1973172,1526497,2025-03-25,Senate,"Senate Banking and Insurance",9,0,0,1,10
1973193,1516493,2025-03-12,House,"House Intergovernmental Affairs Subcommittee",16,0,0,2,18
1973193,1526405,2025-03-25,House,"House Government Operations Subcommittee",18,0,0,0,18
1973193,1535533,2025-04-02,House,"House State Affairs Committee",24,0,0,2,26
1973193,1537305,2025-03-25,House,"House Government Operations Subcommittee",18,0,0,0,18
1973193,1549702,2025-04-16,House,"House: Third Reading RCS#126",115,0,4,0,119
1973193,1563162,2025-04-30,Senate,"Senate: Third Reading RCS#19",36,0,1,1,38
1973230,1533057,2025-04-01,Senate,"Senate Governmental Oversight and Accountability",6,1,0,0,7
1973249,1513840,2025-03-11,Senate,"Senate Environment and Natural Resources",9,0,0,0,9
1973249,1527921,2025-03-26,Senate,"Senate Appropriations Committee on Agriculture, Environment, and General Government",12,0,0,1,13
1973249,1541263,2025-04-08,Senate,"Senate Fiscal Policy",19,0,0,0,19
1973249,1548799,2025-04-15,Senate,"Senate: Third Reading RCS#7",36,0,0,2,38
1973249,1560252,2025-04-29,House,"House: Third Reading RCS#314",114,0,5,0,119
1973264,1513815,2025-03-11,Senate,"Senate Environment and Natural Resources",9,0,0,0,9
1973264,1526075,2025-03-24,Senate,"Senate Appropriations Committee on Transportation, Tourism, and Economic Development",14,0,0,1,15
1973264,1534224,2025-04-02,Senate,"Senate Fiscal Policy",15,2,0,2,19
1973282,1521234,2025-03-19,House,"House Criminal Justice Subcommittee",17,0,0,1,18
1973282,1551102,2025-04-17,House,"House Judiciary Committee",19,0,0,3,22
1973282,1556801,2025-04-24,House,"House: Third Reading RCS#214",113,0,6,0,119
1973282,1561654,2025-04-30,Senate,"Senate: Third Reading RCS#2",37,0,0,1,38
1973282,1562110,2025-04-30,House,"House: Third Reading RCS#378",111,0,8,0,119
1973300,1515858,2025-03-12,Senate,"Senate Judiciary",10,0,0,1,11
1973300,1525951,2025-03-24,Senate,"Senate Appropriations Committee on Criminal and Civil Justice",9,0,0,0,9
1973300,1532061,2025-04-01,Senate,"Senate Rules",24,1,0,0,25
1973321,1518589,2025-03-17,Senate,"Senate Ethics and Elections",6,2,0,1,9
1973373,1525914,2025-03-25,House,"House Careers & Workforce Subcommittee",16,0,0,2,18
1973373,1532312,2025-04-01,House,"House Higher Education Budget Subcommittee",14,0,0,1,15
1973373,1540093,2025-04-08,House,"House Education & Employment Committee",17,0,0,5,22
1973373,1549598,2025-04-16,House,"House: Third Reading RCS#96",117,0,2,0,119
1973373,1557169,2025-04-24,Senate,"Senate: Third Reading RCS#39",37,0,0,1,38
1973421,1513652,2025-03-11,Senate,"Senate Environment and Natural Resources",9,0,0,0,9
1973421,1526046,2025-03-25,Senate,"Senate Commerce and Tourism",9,0,0,0,9
1973439,1532824,2025-04-01,House,"House Intergovernmental Affairs Subcommittee",14,0,0,4,18
1973439,1540360,2025-04-08,House,"House Ways & Means Committee",15,0,0,4,19
1973439,1551347,2025-04-17,House,"House State Affairs Committee",22,0,0,4,26
1973439,1557258,2025-04-24,House,"House: Third Reading RCS#219",115,0,4,0,119
1973439,1562008,2025-04-30,Senate,"Senate: Third Reading RCS#22",36,0,1,1,38
1973452,1519924,2025-03-18,House,"House Government Operations Subcommittee",14,0,0,5,19
1973452,1524068,2025-03-18,House,"House Government Operations Subcommittee",14,0,0,5,19
1973474,1533348,2025-04-01,Senate,"Senate Governmental Oversight and Accountability",6,1,0,0,7
1973474,1548516,2025-04-15,Senate,"Senate Appropriations Committee on Agriculture, Environment, and General Government",9,3,0,0,12
1973474,1554843,2025-04-22,Senate,"Senate Appropriations",14,4,0,0,18
1973474,1556659,2025-04-24,Senate,"Senate: Third Reading RCS#24",13,23,1,1,38
1973474,1556660,2025-04-24,Senate,"Senate: Third Reading RCS#25",27,9,1,1,38
1973519,1527360,2025-03-25,House,"House Housing, Agriculture & Tourism Subcommittee",16,0,0,2,18
1973519,1542007,2025-04-09,House,"House Intergovernmental Affairs Subcommittee",17,0,0,1,18
1973519,1549638,2025-04-15,House,"House Commerce Committee",26,0,0,0,26
1973519,1555266,2025-04-23,House,"House: Third Reading RCS#155",115,0,4,0,119
1973541,1516128,2025-03-12,House,"House Economic Infrastructure Subcommittee",18,0,0,0,18
1973541,1538413,2025-04-07,House,"House Commerce Committee",23,1,0,2,26
1973541,1558110,2025-04-25,House,"House: Third Reading RCS#254",106,0,13,0,119
1973541,1562260,2025-04-30,Senate,"Senate: Third Reading RCS#41",37,0,0,1,38
1973592,1521215,2025-03-19,Senate,"Senate Transportation",9,0,0,0,9
1973592,1543282,2025-04-10,Senate,"Senate Appropriations Committee on Transportation, Tourism, and Economic Development",14,0,0,1,15
1973592,1551910,2025-04-17,Senate,"Senate Fiscal Policy",16,0,0,3,19
1973592,1557027,2025-04-24,Senate,"Senate: Third Reading RCS#7",37,0,0,1,38
1973618,1518701,2025-03-17,Senate,"Senate Environment and Natural Resources",8,0,0,1,9
1973618,1544122,2025-04-10,Senate,"Senate Appropriations Committee on Agriculture, Environment, and General Government",11,0,0,1,12
1973618,1551063,2025-04-17,Senate,"Senate Fiscal Policy",17,0,0,2,19
1973618,1556455,2025-04-24,Senate,"Senate: Third Reading RCS#6",36,0,1,1,38
1973618,1562421,2025-04-30,House,"House: Third Reading RCS#362",112,0,7,0,119
1973638,1531421,2025-03-31,Senate,"Senate Education Pre-K - 12",8,1,0,0,9
1973638,1549554,2025-04-15,Senate,"Senate Appropriations Committee on Pre-K - 12 Education",5,2,0,2,9
1973638,1553302,2025-04-21,Senate,"Senate Rules",17,5,0,3,25
1973683,1516362,2025-03-12,House,"House Intergovernmental Affairs Subcommittee",16,0,0,2,18
1973683,1521583,2025-03-19,House,"House Industries & Professional Activities Subcommittee",14,0,0,4,18
1973683,1527884,2025-03-26,House,"House State Affairs Committee",22,0,0,5,27
1973683,1536311,2025-04-03,House,"House: Third Reading RCS#51",108,0,11,0,119
1973683,1563304,2025-04-30,Senate,"Senate: Third Reading RCS#20",35,1,1,1,38
1973727,1519003,2025-03-17,Senate,"Senate Environment and Natural Resources",8,0,0,1,9
1973795,1526495,2025-03-25,Senate,"Senate Criminal Justice",3,4,0,2,9
1973819,1532433,2025-04-01,House,"House Intergovernmental Affairs Subcommittee",14,0,0,4,18
1973819,1551151,2025-04-17,House,"House State Affairs Committee",22,0,0,4,26
1973819,1557110,2025-04-24,House,"House: Third Reading RCS#218",111,2,6,0,119
1973819,1562380,2025-04-30,Senate,"Senate: Third Reading RCS#21",36,0,1,1,38
1973837,1515673,2025-03-12,Senate,"Senate Judiciary",10,0,0,1,11
1973837,1525916,2025-03-25,Senate,"Senate Environment and Natural Resources",8,0,0,1,9
1973837,1540008,2025-04-08,Senate,"Senate Rules",24,0,0,1,25
1973837,1548398,2025-04-15,Senate,"Senate: Third Reading RCS#6",33,3,0,2,38
1973837,1557974,2025-04-25,House,"House: Third Reading RCS#250",80,20,19,0,119
1973861,1526666,2025-03-25,Senate,"Senate Regulated Industries",8,0,0,1,9
1973861,1533356,2025-04-01,Senate,"Senate Transportation",8,1,0,0,9
1973861,1550023,2025-04-16,Senate,"Senate Rules",23,0,0,2,25
1973861,1553979,2025-04-22,Senate,"Senate Appropriations",17,0,0,1,18
1974038,1526035,2025-03-25,Senate,"Senate Commerce and Tourism",9,0,0,0,9
1974038,1533953,2025-04-01,Senate,"Senate Judiciary",11,0,0,0,11
1974038,1550544,2025-04-16,Senate,"Senate Rules",23,0,0,2,25
1974117,1526796,2025-03-25,Senate,"Senate Commerce and Tourism",9,0,0,0,9
1974652,1521320,2025-03-19,House,"House Industries & Professional Activities Subcommittee",15,0,0,3,18
1974652,1527551,2025-03-26,House,"House Criminal Justice Subcommittee",15,0,0,3,18
1974652,1553816,2025-04-22,House,"House Commerce Committee",24,0,0,3,27
1974680,1525932,2025-03-25,Senate,"Senate Commerce and Tourism",7,2,0,0,9
1974680,1533882,2025-04-01,Senate,"Senate Judiciary",9,2,0,0,11
1974680,1550016,2025-04-16,Senate,"Senate Rules",21,0,0,4,25
1974680,1557190,2025-04-24,Senate,"Senate: Third Reading RCS#52",34,3,0,1,38
1974703,1514467,2025-03-11,House,"House Natural Resources & Disasters Subcommittee",18,0,0,0,18
1974703,1522359,2025-03-20,House,"House State Affairs Committee",23,0,0,3,26
1974703,1527933,2025-03-26,House,"House: Third Reading RCS#21",112,0,7,0,119
1974703,1557916,2025-04-24,Senate,"Senate: Third Reading RCS#16",37,0,0,1,38
1974729,1520280,2025-03-18,House,"House Government Operations Subcommittee",16,0,0,3,19
1974729,1524135,2025-03-18,House,"House Government Operations Subcommittee",16,0,0,3,19
1974729,1531249,2025-03-31,House,"House Health & Human Services Committee",24,0,0,3,27
1974729,1540530,2025-04-08,House,"House Budget Committee",28,0,0,2,30
1974729,1551386,2025-04-17,House,"House State Affairs Committee",21,0,0,5,26
1974729,1555379,2025-04-23,House,"House: Third Reading RCS#190",115,0,4,0,119
1974729,1559670,2025-04-29,Senate,"Senate: Third Reading RCS#5",37,0,1,0,38
1974729,1563610,2025-05-01,House,"House: Third Reading RCS#395",113,0,6,0,119
1974729,1564705,2025-05-02,House,"House: Third Reading RCS#421",99,0,20,0,119
1974742,1527307,2025-03-26,House,"House Industries & Professional Activities Subcommittee",12,0,0,6,18
1974755,1516881,2025-03-12,House,"House Industries & Professional Activities Subcommittee",16,0,0,2,18
1974755,1531371,2025-03-31,House,"House Commerce Committee",21,0,0,5,26
1974755,1555200,2025-04-23,House,"House: Third Reading RCS#168",112,1,6,0,119
1974755,1557242,2025-04-24,Senate,"Senate: Third Reading RCS#50",37,0,0,1,38
1974796,1526000,2025-03-25,Senate,"Senate Environment and Natural Resources",7,1,0,1,9
1974849,1517494,2025-03-13,House,"House Civil Justice & Claims Subcommittee",18,0,0,1,19
1974849,1534904,2025-04-02,House,"House Judiciary Committee",21,0,0,1,22
1974860,1507546,2025-03-05,House,"House Insurance & Banking Subcommittee",17,0,0,1,18
1974860,1517039,2025-03-13,House,"House State Affairs Committee",24,0,0,2,26
1974860,1527650,2025-03-26,House,"House: Third Reading RCS#27",113,0,6,0,119
1974860,1548402,2025-04-15,Senate,"Senate: Third Reading RCS#3",36,0,0,2,38
1974884,1526743,2025-03-25,House,"House Government Operations Subcommittee",14,4,0,0,18
1974884,1537357,2025-03-25,House,"House Government Operations Subcommittee",14,4,0,0,18
1974923,1519558,2025-03-18,House,"House Natural Resources & Disasters Subcommittee",17,0,0,1,18
1974923,1529002,2025-03-27,House,"House Ways & Means Committee",18,0,0,1,19
1974923,1539593,2025-04-08,House,"House State Affairs Committee",22,0,0,4,26
1974923,1549748,2025-04-16,House,"House: Third Reading RCS#103",116,0,3,0,119
1974923,1564632,2025-05-02,Senate,"Senate: Third Reading RCS#14",32,0,5,1,38
1974993,1515413,2025-03-11,Senate,"Senate Criminal Justice",9,0,0,0,9
1974993,1520771,2025-03-18,Senate,"Senate Appropriations Committee on Criminal and Civil Justice",6,0,0,3,9
1974993,1527407,2025-03-26,Senate,"Senate Rules",23,1,0,1,25
1974993,1536288,2025-04-03,Senate,"Senate: Third Reading RCS#4",36,1,0,1,38
1974993,1559934,2025-04-29,House,"House: Third Reading RCS#319",115,0,4,0,119
1975029,1533027,2025-04-01,House,"House Government Operations Subcommittee",16,0,0,3,19
1975029,1540714,2025-04-08,House,"House Budget Committee",27,0,0,3,30
1975029,1551104,2025-04-17,House,"House State Affairs Committee",23,0,0,3,26
1975029,1557091,2025-04-24,House,"House: Third Reading RCS#209",111,0,8,0,119
1975029,1558856,2025-04-28,Senate,"Senate: Third Reading RCS#19",36,0,0,2,38
1975043,1516908,2025-03-12,Senate,"Senate Transportation",9,0,0,0,9
1975043,1528078,2025-03-25,Senate,"Senate Community Affairs",6,2,0,0,8
1975058,1516455,2025-03-12,House,"House Intergovernmental Affairs Subcommittee",15,0,0,3,18
1975058,1522161,2025-03-19,House,"House Industries & Professional Activities Subcommittee",14,0,0,4,18
1975058,1535417,2025-04-02,House,"House State Affairs Committee",24,0,0,2,26
1975073,1516331,2025-03-12,House,"House Criminal Justice Subcommittee",13,5,0,1,19
1975073,1522524,2025-03-20,House,"House Judiciary Committee",16,6,0,1,23
1975073,1528093,2025-03-26,House,"House: Third Reading RCS#26",78,34,7,0,119
1975096,1533156,2025-04-01,House,"House Natural Resources & Disasters Subcommittee",16,0,0,2,18
1975096,1539874,2025-04-08,House,"House State Affairs Committee",21,0,0,5,26
1975109,1527662,2025-03-26,House,"House Intergovernmental Affairs Subcommittee",11,4,0,4,19
1975135,1521316,2025-03-19,House,"House Criminal Justice Subcommittee",17,0,0,1,18
1975135,1534444,2025-04-02,House,"House Judiciary Committee",21,0,0,1,22
1975135,1555481,2025-04-23,House,"House: Third Reading RCS#195",115,0,4,0,119
1975135,1556462,2025-04-24,Senate,"Senate: Third Reading RCS#19",37,0,0,1,38
1975159,1520175,2025-03-18,House,"House Government Operations Subcommittee",17,0,0,2,19
1975159,1524093,2025-03-18,House,"House Government Operations Subcommittee",17,0,0,2,19
1975159,1529026,2025-03-27,House,"House Budget Committee",24,0,0,6,30
1975159,1551363,2025-04-17,House,"House State Affairs Committee",22,0,0,4,26
1975187,1526375,2025-03-25,Senate,"Senate Environment and Natural Resources",8,0,0,1,9
1975187,1543612,2025-04-10,Senate,"Senate Appropriations Committee on Agriculture, Environment, and General Government",11,0,0,1,12
1975198,1506188,2025-03-05,House,"House Health Professions & Programs Subcommittee",18,0,0,0,18
1975198,1513072,2025-03-11,House,"House Education Administration Subcommittee",17,0,0,1,18
1975198,1525181,2025-03-24,House,"House Health & Human Services Committee",26,0,0,1,27
1975213,1541843,2025-04-09,House,"House Intergovernmental Affairs Subcommittee",17,0,0,1,18
1975213,1551734,2025-04-17,House,"House State Affairs Committee",23,0,0,3,26
1975213,1557694,2025-04-24,House,"House: Third Reading RCS#221",112,0,7,0,119
1975213,1561998,2025-04-30,Senate,"Senate: Third Reading RCS#23",36,0,1,1,38
1975226,1517065,2025-03-12,House,"House Industries & Professional Activities Subcommittee",15,0,0,3,18
1975226,1531456,2025-03-31,House,"House Commerce Committee",21,0,0,5,26
1975226,1543021,2025-04-09,House,"House: Third Reading RCS#89",110,0,9,0,119
1975251,1528848,2025-03-27,House,"House Ways & Means Committee",18,0,0,1,19
1975251,1542069,2025-04-09,House,"House Intergovernmental Affairs Subcommittee",17,0,0,1,18
1975312,1518353,2025-03-17,Senate,"Senate Education Postsecondary",7,0,0,0,7
1975312,1549686,2025-04-15,Senate,"Senate Appropriations Committee on Higher Education",7,0,0,1,8
1975312,1553915,2025-04-22,Senate,"Senate Fiscal Policy",18,0,0,1,19
1975312,1556579,2025-04-24,Senate,"Senate: Third Reading RCS#23",37,0,0,1,38
1975312,1562527,2025-04-30,House,"House: Third Reading RCS#387",112,0,7,0,119
1975328,1533768,2025-04-01,House,"House Government Operations Subcommittee",16,0,0,3,19
1975328,1551143,2025-04-17,House,"House State Affairs Committee",24,0,0,2,26
1975386,1503687,2025-03-03,Senate,"Senate Community Affairs",6,0,0,2,8
1975386,1516883,2025-03-13,Senate,"Senate Fiscal Policy",19,0,0,0,19
1975386,1521269,2025-03-19,Senate,"Senate: Third Reading RCS#17",39,0,0,0,39
1975386,1558152,2025-04-25,House,"House: Third Reading RCS#252",69,42,8,0,119
1975405,1534399,2025-04-01,Senate,"Senate Children, Families, and Elder Affairs",6,0,0,1,7
1975419,1513162,2025-03-11,Senate,"Senate Health Policy",10,0,0,0,10
1975419,1548122,2025-04-15,Senate,"Senate Appropriations Committee on Health and Human Services",9,1,0,0,10
1975419,1555179,2025-04-22,Senate,"Senate Fiscal Policy",19,0,0,0,19
1975439,1516190,2025-03-12,Senate,"Senate Rules",24,0,0,1,25
1975439,1521939,2025-03-19,Senate,"Senate: Third Reading RCS#2",38,0,1,0,39
1975439,1535652,2025-04-03,House,"House: Third Reading RCS#31",108,0,11,0,119
1975477,1513730,2025-03-11,Senate,"Senate Military and Veterans Affairs, Space, and Domestic Security",5,0,0,1,6
1975493,1515690,2025-03-12,Senate,"Senate Rules",23,0,0,2,25
1975493,1521188,2025-03-19,Senate,"Senate: Third Reading RCS#4",39,0,0,0,39
1975493,1535812,2025-04-03,House,"House: Third Reading RCS#33",110,0,9,0,119
1975511,1503321,2025-03-03,Senate,"Senate Education Pre-K - 12",7,0,0,2,9
1975511,1512484,2025-03-11,Senate,"Senate Appropriations Committee on Pre-K - 12 Education",9,0,0,1,10
1975511,1528898,2025-03-27,Senate,"Senate Fiscal Policy",18,0,0,1,19
1975511,1535655,2025-04-03,Senate,"Senate: Third Reading RCS#11",37,0,0,1,38
1975596,1516107,2025-03-12,Senate,"Senate Rules",24,0,0,1,25
1975596,1521142,2025-03-19,Senate,"Senate: Third Reading RCS#3",39,0,0,0,39
1975596,1535783,2025-04-03,House,"House: Third Reading RCS#34",107,0,12,0,119
1975632,1521730,2025-03-19,Senate,"Senate Children, Families, and Elder Affairs",5,1,0,1,7
1975689,1514044,2025-03-11,Senate,"Senate Governmental Oversight and Accountability",6,1,0,1,8
1975689,1534037,2025-03-31,Senate,"Senate Banking and Insurance",9,1,0,0,10
1975689,1552042,2025-04-17,Senate,"Senate Appropriations",15,1,0,2,18
1975721,1526662,2025-03-25,Senate,"Senate Banking and Insurance",9,0,0,1,10
1975755,1518875,2025-03-17,Senate,"Senate Commerce and Tourism",6,3,0,0,9
1975755,1533977,2025-04-01,Senate,"Senate Judiciary",9,2,0,0,11
1975755,1549980,2025-04-16,Senate,"Senate Rules",21,2,0,2,25
1975787,1523287,2025-03-20,House,"House Civil Justice & Claims Subcommittee",15,0,0,3,18
1975885,1521513,2025-03-19,Senate,"Senate Transportation",9,0,0,0,9
1975885,1533894,2025-04-01,Senate,"Senate Judiciary",11,0,0,0,11
1975885,1551330,2025-04-17,Senate,"Senate Fiscal Policy",17,0,0,2,19
1975960,1522127,2025-03-19,House,"House Criminal Justice Subcommittee",15,0,0,3,18
1976023,1521012,2025-03-18,Senate,"Senate Military and Veterans Affairs, Space, and Domestic Security",5,0,0,1,6
1976023,1531188,2025-03-31,Senate,"Senate Commerce and Tourism",9,0,0,0,9
1976023,1540519,2025-04-08,Senate,"Senate Rules",24,0,0,1,25
1976023,1548737,2025-04-15,Senate,"Senate: Third Reading RCS#5",36,0,0,2,38
1976023,1560362,2025-04-29,House,"House: Third Reading RCS#324",114,0,5,0,119
1976189,1526069,2025-03-25,Senate,"Senate Commerce and Tourism",5,4,0,0,9
1976221,1519508,2025-03-18,House,"House Natural Resources & Disasters Subcommittee",16,0,0,2,18
1976221,1527897,2025-03-26,House,"House State Affairs Committee",22,0,0,5,27
1976248,1516366,2025-03-12,House,"House Criminal Justice Subcommittee",17,0,0,2,19
1976248,1527554,2025-03-26,House,"House Judiciary Committee",22,0,0,0,22
1976248,1542448,2025-04-09,House,"House: Third Reading RCS#77",111,0,8,0,119
1976248,1556493,2025-04-24,Senate,"Senate: Third Reading RCS#20",37,0,0,1,38
1976248,1562479,2025-04-30,House,"House: Third Reading RCS#370",111,0,8,0,119
1976646,1514250,2025-03-11,House,"House Health Care Facilities & Systems Subcommittee",18,0,0,0,18
1976646,1525194,2025-03-24,House,"House Health & Human Services Committee",25,0,0,2,27
1976646,1535920,2025-04-03,House,"House: Third Reading RCS#48",106,0,13,0,119
1976646,1549930,2025-04-16,Senate,"Senate: Third Reading RCS#17",33,4,0,1,38
1976673,1521348,2025-03-19,House,"House Industries & Professional Activities Subcommittee",15,1,0,2,18
1976731,1516349,2025-03-12,House,"House Intergovernmental Affairs Subcommittee",16,0,0,2,18
1976731,1521815,2025-03-19,House,"House Health Care Facilities & Systems Subcommittee",17,0,0,1,18
1976731,1539520,2025-04-08,House,"House State Affairs Committee",22,0,0,4,26
1976731,1557268,2025-04-24,House,"House: Third Reading RCS#238",115,0,4,0,119
1976731,1558980,2025-04-28,Senate,"Senate: Third Reading RCS#18",36,0,0,2,38
1976761,1515841,2025-03-12,Senate,"Senate Regulated Industries",8,0,0,1,9
1976793,1516845,2025-03-13,House,"House Ways & Means Committee",17,1,0,1,19
1976793,1534216,2025-04-01,House,"House Industries & Professional Activities Subcommittee",12,2,0,5,19
1976850,1526857,2025-03-25,House,"House Natural Resources & Disasters Subcommittee",13,3,0,2,18
1976850,1549888,2025-04-15,House,"House Commerce Committee",21,2,0,3,26
1976881,1521590,2025-03-19,House,"House Industries & Professional Activities Subcommittee",15,0,0,3,18
1976931,1520874,2025-03-19,House,"House Transportation & Economic Development Budget Subcommittee",15,0,0,0,15
1976931,1527658,2025-03-25,House,"House Housing, Agriculture & Tourism Subcommittee",16,0,0,2,18
1976931,1534522,2025-04-02,House,"House Budget Committee",23,0,0,7,30
1977024,1528909,2025-03-27,House,"House Health Professions & Programs Subcommittee",16,1,0,1,18
1977024,1548569,2025-04-15,House,"House Health & Human Services Committee",21,0,0,5,26
1977024,1557252,2025-04-24,House,"House: Third Reading RCS#240",113,1,5,0,119
1977082,1522134,2025-03-19,House,"House Careers & Workforce Subcommittee",18,0,0,0,18
1977082,1535248,2025-04-02,House,"House Education Administration Subcommittee",18,0,0,0,18
1977082,1540746,2025-04-08,House,"House Education & Employment Committee",16,0,0,6,22
1977082,1557679,2025-04-24,House,"House: Third Reading RCS#202",109,0,10,0,119
1977082,1563268,2025-04-30,Senate,"Senate: Third Reading RCS#47",37,0,0,1,38
1977113,1533041,2025-04-01,House,"House Government Operations Subcommittee",16,0,0,3,19
1977113,1539796,2025-04-08,House,"House State Affairs Committee",22,0,0,4,26
1977164,1531505,2025-03-31,House,"House Careers & Workforce Subcommittee",17,0,0,1,18
1977164,1544045,2025-04-10,House,"House Transportation & Economic Development Budget Subcommittee",10,0,0,5,15
1977164,1551740,2025-04-17,House,"House Education & Employment Committee",21,0,0,2,23
1977164,1555363,2025-04-23,House,"House: Third Reading RCS#180",112,1,6,0,119
1977164,1560131,2025-04-29,Senate,"Senate: Third Reading RCS#9",35,0,3,0,38
1977185,1521021,2025-03-19,Senate,"Senate Regulated Industries",8,0,0,1,9
1977185,1530931,2025-03-31,Senate,"Senate Commerce and Tourism",9,0,0,0,9
1977185,1540780,2025-04-08,Senate,"Senate Rules",24,0,0,1,25
1977185,1550362,2025-04-16,Senate,"Senate: Third Reading RCS#13",37,0,0,1,38
1977185,1559680,2025-04-29,House,"House: Third Reading RCS#281",114,0,5,0,119
1977223,1515480,2025-03-11,Senate,"Senate Criminal Justice",9,0,0,0,9
1977223,1531594,2025-03-31,Senate,"Senate Community Affairs",8,0,0,0,8
1977223,1540702,2025-04-08,Senate,"Senate Rules",23,1,0,1,25
1977248,1517762,2025-03-13,House,"House Civil Justice & Claims Subcommittee",16,0,0,3,19
1977248,1520333,2025-03-18,House,"House Justice Budget Subcommittee",14,0,0,1,15
1977248,1528359,2025-03-26,House,"House Judiciary Committee",20,0,0,2,22
1977285,1515728,2025-03-10,Senate,"Senate Banking and Insurance",9,0,0,1,10
1977285,1521260,2025-03-18,Senate,"Senate Health Policy",9,0,0,1,10
1977285,1527402,2025-03-26,Senate,"Senate Rules",24,0,0,1,25
1977285,1535608,2025-04-03,Senate,"Senate: Third Reading RCS#3",37,0,0,1,38
1977285,1559715,2025-04-29,House,"House: Third Reading RCS#288",115,0,4,0,119
1977329,1526259,2025-03-25,Senate,"Senate Environment and Natural Resources",8,0,0,1,9
1977392,1522125,2025-03-19,House,"House Criminal Justice Subcommittee",17,0,0,1,18
1977392,1540669,2025-04-08,House,"House Judiciary Committee",17,1,0,4,22
1977392,1549687,2025-04-16,House,"House: Third Reading RCS#131",114,0,5,0,119
1977392,1557211,2025-04-24,Senate,"Senate: Third Reading RCS#2",37,0,0,1,38
1977448,1534130,2025-03-31,Senate,"Senate Community Affairs",6,2,0,0,8
1977448,1548161,2025-04-15,Senate,"Senate Appropriations Committee on Health and Human Services",7,2,0,1,10
1977448,1553436,2025-04-21,Senate,"Senate Rules",23,0,0,2,25
1977448,1556741,2025-04-24,Senate,"Senate: Third Reading RCS#22",37,0,0,1,38
1977448,1562127,2025-04-30,House,"House: Third Reading RCS#349",97,10,12,0,119
1977478,1515839,2025-03-12,Senate,"Senate Judiciary",11,0,0,0,11
1977478,1527246,2025-03-25,Senate,"Senate Regulated Industries",8,0,0,1,9
1977478,1532255,2025-04-01,Senate,"Senate Rules",24,0,0,1,25
1977478,1541721,2025-04-09,Senate,"Senate: Third Reading RCS#45",37,0,0,1,38
1977478,1559700,2025-04-29,House,"House: Third Reading RCS#284",114,0,5,0,119
1977496,1513731,2025-03-11,Senate,"Senate Health Policy",8,2,0,0,10
1977557,1534187,2025-04-02,House,"House Health Care Facilities & Systems Subcommittee",17,0,0,1,18
1977580,1516491,2025-03-12,House,"House Criminal Justice Subcommittee",16,0,0,3,19
1977580,1532704,2025-04-01,House,"House Intergovernmental Affairs Subcommittee",16,0,0,2,18
1977580,1551371,2025-04-17,House,"House Judiciary Committee",20,0,0,2,22
1977580,1556823,2025-04-24,House,"House: Third Reading RCS#212",114,0,5,0,119
1977606,1526089,2025-03-25,House,"House Agriculture & Natural Resources Budget Subcommittee",14,0,0,1,15
1977606,1532963,2025-04-01,House,"House Natural Resources & Disasters Subcommittee",17,0,0,1,18
1977606,1540620,2025-04-08,House,"House Budget Committee",29,0,0,1,30
1977647,1531104,2025-03-31,Senate,"Senate Commerce and Tourism",9,0,0,0,9
1977647,1550523,2025-04-15,Senate,"Senate Appropriations Committee on Transportation, Tourism, and Economic Development",15,0,0,0,15
1977647,1555364,2025-04-22,Senate,"Senate Fiscal Policy",18,0,0,1,19
1977709,1517610,2025-03-13,House,"House Insurance & Banking Subcommittee",17,0,0,1,18
1977709,1543827,2025-04-10,House,"House Health Care Facilities & Systems Subcommittee",15,0,0,3,18
1977709,1549639,2025-04-15,House,"House Commerce Committee",24,0,0,2,26
1977751,1541866,2025-04-09,House,"House Intergovernmental Affairs Subcommittee",17,0,0,1,18
1977763,1531047,2025-03-31,House,"House Economic Infrastructure Subcommittee",15,1,0,2,18
1977811,1528679,2025-03-27,House,"House Civil Justice & Claims Subcommittee",14,0,0,4,18
1977811,1553747,2025-04-22,House,"House Budget Committee",28,0,0,2,30
1977811,1558349,2025-04-25,House,"House: Third Reading RCS#270",107,0,12,0,119
1977874,1528798,2025-03-27,House,"House Civil Justice & Claims Subcommittee",14,0,0,4,18
1977874,1539363,2025-04-08,House,"House Judiciary Committee",20,0,0,2,22
1977874,1557253,2025-04-24,House,"House: Third Reading RCS#233",115,0,4,0,119
1977909,1516115,2025-03-12,House,"House Economic Infrastructure Subcommittee",18,0,0,0,18
1977909,1528993,2025-03-27,House,"House Civil Justice & Claims Subcommittee",13,0,0,5,18
1977909,1538721,2025-04-07,House,"House Commerce Committee",24,0,0,2,26
1977909,1549713,2025-04-16,House,"House: Third Reading RCS#115",114,0,5,0,119
1977909,1556838,2025-04-24,Senate,"Senate: Third Reading RCS#5",35,2,0,1,38
1977941,1529129,2025-03-27,House,"House Education Administration Subcommittee",17,0,0,1,18
1977941,1547155,2025-04-14,House,"House PreK-12 Budget Subcommittee",14,0,0,2,16
1977941,1551327,2025-04-17,House,"House Education & Employment Committee",19,0,0,4,23
1977941,1556698,2025-04-24,House,"House: Third Reading RCS#199",114,0,5,0,119
1977941,1560570,2025-04-29,Senate,"Senate: Third Reading RCS#29",38,0,0,0,38
1977973,1527865,2025-03-26,House,"House Criminal Justice Subcommittee",18,0,0,0,18
1977973,1531244,2025-03-31,House,"House Economic Infrastructure Subcommittee",16,0,0,2,18
1977973,1539522,2025-04-08,House,"House Judiciary Committee",19,0,0,3,22
1978070,1516739,2025-03-12,House,"House Criminal Justice Subcommittee",15,3,0,1,19
1978070,1522796,2025-03-20,House,"House Judiciary Committee",19,1,0,3,23
1978070,1550259,2025-04-16,House,"House: Third Reading RCS#119",86,28,5,0,119
1978070,1555089,2025-04-23,Senate,"Senate: Third Reading RCS#31",32,5,1,0,38
1978929,1521203,2025-03-19,Senate,"Senate Regulated Industries",8,0,0,1,9
1978976,1521165,2025-03-19,House,"House Industries & Professional Activities Subcommittee",15,1,0,2,18
1979028,1520586,2025-03-18,Senate,"Senate Criminal Justice",7,2,0,0,9
1979028,1544950,2025-04-10,Senate,"Senate Appropriations Committee on Criminal and Civil Justice",6,2,0,1,9
1979028,1551294,2025-04-17,Senate,"Senate Fiscal Policy",14,3,0,2,19
1979043,1529253,2025-03-27,House,"House Education Administration Subcommittee",16,0,0,2,18
1979058,1526619,2025-03-25,Senate,"Senate Criminal Justice",9,0,0,0,9
1979058,1549622,2025-04-15,Senate,"Senate Appropriations Committee on Criminal and Civil Justice",9,0,0,0,9
1979058,1555213,2025-04-22,Senate,"Senate Fiscal Policy",18,0,0,1,19
1979078,1525944,2025-03-25,House,"House Careers & Workforce Subcommittee",12,4,0,2,18
1979078,1532616,2025-04-01,House,"House Higher Education Budget Subcommittee",11,3,0,1,15
1979078,1539446,2025-04-08,House,"House Education & Employment Committee",17,0,0,5,22
1979078,1555216,2025-04-23,House,"House: Third Reading RCS#160",84,27,8,0,119
1979078,1563434,2025-05-01,Senate,"Senate: Third Reading RCS#5",38,0,0,0,38
1979078,1564581,2025-05-02,House,"House: Third Reading RCS#408",91,22,6,0,119
1979078,1564664,2025-05-02,Senate,"Senate: Third Reading RCS#20",31,0,4,3,38
1979128,1514983,2025-03-11,Senate,"Senate Agriculture",6,0,0,0,6
1979142,1520959,2025-03-18,Senate,"Senate Health Policy",9,0,0,1,10
1979142,1529876,2025-03-26,Senate,"Senate Appropriations Committee on Health and Human Services",10,0,0,0,10
1979142,1534299,2025-04-02,Senate,"Senate Fiscal Policy",17,0,0,2,19
1979142,1542310,2025-04-09,Senate,"Senate: Third Reading RCS#46",37,0,0,1,38
1979142,1560166,2025-04-29,House,"House: Third Reading RCS#286",115,0,4,0,119
1979158,1533952,2025-04-01,Senate,"Senate Children, Families, and Elder Affairs",6,0,0,1,7
1979158,1544410,2025-04-10,Senate,"Senate Appropriations Committee on Health and Human Services",8,0,0,2,10
1979158,1555033,2025-04-22,Senate,"Senate Fiscal Policy",18,0,0,1,19
1979176,1519196,2025-03-17,Senate,"Senate Ethics and Elections",8,0,0,1,9
1979222,1518974,2025-03-17,Senate,"Senate Environment and Natural Resources",8,0,0,1,9
1979222,1543707,2025-04-10,Senate,"Senate Appropriations Committee on Agriculture, Environment, and General Government",11,0,0,1,12
1979308,1531503,2025-03-31,House,"House Careers & Workforce Subcommittee",16,0,0,2,18
1979308,1551285,2025-04-17,House,"House Education & Employment Committee",19,0,0,4,23
1979344,1534156,2025-04-01,Senate,"Senate Health Policy",10,0,0,0,10
1979344,1550142,2025-04-16,Senate,"Senate Rules",23,0,0,2,25
1979491,1526768,2025-03-25,House,"House Student Academic Success Subcommittee",15,0,0,3,18
1979491,1551083,2025-04-17,House,"House Education & Employment Committee",19,0,0,4,23
1979568,1529481,2025-03-27,House,"House Education Administration Subcommittee",17,0,0,1,18
1979568,1539647,2025-04-08,House,"House Education & Employment Committee",17,0,0,5,22
1979604,1516361,2025-03-12,Senate,"Senate Transportation",9,0,0,0,9
1979604,1525271,2025-03-24,Senate,"Senate Appropriations Committee on Transportation, Tourism, and Economic Development",14,0,0,1,15
1979604,1534884,2025-04-02,Senate,"Senate Fiscal Policy",18,0,0,1,19
1979604,1549178,2025-04-15,Senate,"Senate: Third Reading RCS#12",36,0,0,2,38
1979604,1559708,2025-04-29,House,"House: Third Reading RCS#277",112,0,7,0,119
1979604,1563017,2025-04-30,Senate,"Senate: Third Reading RCS#56",37,0,0,1,38
1979604,1564756,2025-05-02,Senate,"Senate: Third Reading RCS#7",33,0,4,1,38
1979642,1517218,2025-03-13,House,"House Health Professions & Programs Subcommittee",15,3,0,0,18
1979642,1531408,2025-03-31,House,"House Health & Human Services Committee",23,3,0,1,27
1979642,1542512,2025-04-09,House,"House: Third Reading RCS#84",87,22,10,0,119
1979680,1515633,2025-03-10,Senate,"Senate Banking and Insurance",10,0,0,0,10
1979680,1545098,2025-04-10,Senate,"Senate Appropriations Committee on Agriculture, Environment, and General Government",11,0,0,1,12
1979680,1551308,2025-04-17,Senate,"Senate Fiscal Policy",16,0,0,3,19
1979751,1536107,2025-04-03,House,"House Insurance & Banking Subcommittee",17,1,0,0,18
1979819,1527139,2025-03-25,House,"House Government Operations Subcommittee",18,0,0,0,18
1979819,1535297,2025-04-02,House,"House State Affairs Committee",24,0,0,2,26
1979819,1537505,2025-03-25,House,"House Government Operations Subcommittee",18,0,0,0,18
1979863,1534434,2025-04-02,House,"House Health Care Facilities & Systems Subcommittee",17,0,0,1,18
1979881,1533965,2025-04-01,House,"House Housing, Agriculture & Tourism Subcommittee",15,0,0,3,18
1979881,1544121,2025-04-10,House,"House Civil Justice & Claims Subcommittee",15,0,0,3,18
1979881,1549695,2025-04-15,House,"House Commerce Committee",24,0,0,2,26
1979881,1555058,2025-04-23,House,"House: Third Reading RCS#153",115,0,4,0,119
1979881,1559289,2025-04-28,Senate,"Senate: Third Reading RCS#8",36,0,0,2,38
1979897,1533112,2025-04-01,Senate,"Senate Criminal Justice",9,0,0,0,9
1979915,1515674,2025-03-11,Senate,"Senate Community Affairs",6,1,0,1,8
1979915,1533897,2025-04-01,Senate,"Senate Regulated Industries",8,0,0,0,8
1979915,1541062,2025-04-08,Senate,"Senate Rules",23,0,0,2,25
1979933,1523315,2025-03-20,House,"House Civil Justice & Claims Subcommittee",13,1,0,4,18
1979933,1528626,2025-03-27,House,"House Health Professions & Programs Subcommittee",15,1,0,2,18
1979933,1535247,2025-04-02,House,"House Judiciary Committee",21,0,0,1,22
1979933,1549894,2025-04-16,House,"House: Third Reading RCS#139",112,4,3,0,119
1979933,1559793,2025-04-29,Senate,"Senate: Third Reading RCS#11",37,0,1,0,38
1979950,1527822,2025-03-26,House,"House Criminal Justice Subcommittee",14,3,0,1,18
1979950,1534712,2025-04-02,House,"House Judiciary Committee",16,5,0,1,22
1979950,1549690,2025-04-16,House,"House: Third Reading RCS#129",83,33,3,0,119
1979950,1560642,2025-04-29,Senate,"Senate: Third Reading RCS#31",22,16,0,0,38
1979950,1560643,2025-04-29,Senate,"Senate: Third Reading RCS#32",26,11,1,0,38
1979950,1561684,2025-03-26,House,"House Criminal Justice Subcommittee",14,3,0,1,18
1979950,1561685,2025-04-02,House,"House Judiciary Committee",16,5,0,1,22
1980680,1536222,2025-04-03,House,"House Civil Justice & Claims Subcommittee",14,0,0,5,19
1980680,1551136,2025-04-17,House,"House Judiciary Committee",17,0,0,5,22
1980680,1557596,2025-04-24,House,"House: Third Reading RCS#244",114,1,4,0,119
1980680,1559246,2025-04-28,Senate,"Senate: Third Reading RCS#22",36,0,1,1,38
1980681,1517222,2025-03-13,House,"House Health Professions & Programs Subcommittee",15,0,0,3,18
1980681,1518292,2025-03-13,House,"House Health Professions & Programs Subcommittee",15,0,0,3,18
1980681,1521842,2025-03-19,House,"House Careers & Workforce Subcommittee",18,0,0,0,18
1980681,1548698,2025-04-15,House,"House Health & Human Services Committee",22,0,0,4,26
1980681,1555366,2025-04-23,House,"House: Third Reading RCS#175",112,1,6,0,119
1980682,1514899,2025-03-11,House,"House Housing, Agriculture & Tourism Subcommittee",18,0,0,0,18
1980682,1549577,2025-04-15,House,"House Commerce Committee",23,0,0,3,26
1980682,1555154,2025-04-23,House,"House: Third Reading RCS#150",113,2,4,0,119
1980682,1561984,2025-04-30,Senate,"Senate: Third Reading RCS#4",37,0,0,1,38
1980682,1562497,2025-04-30,House,"House: Third Reading RCS#377",112,0,7,0,119
1980683,1517754,2025-03-13,House,"House Health Professions & Programs Subcommittee",13,0,0,5,18
1980685,1529228,2025-03-27,House,"House Health Care Facilities & Systems Subcommittee",16,0,0,2,18
1980686,1514037,2025-03-11,House,"House Student Academic Success Subcommittee",17,0,0,1,18
1980686,1522306,2025-03-20,House,"House Education & Employment Committee",21,0,0,1,22
1980686,1525857,2025-03-11,House,"House Student Academic Success Subcommittee",17,0,0,1,18
1980686,1527990,2025-03-26,House,"House: Third Reading RCS#29",113,0,6,0,119
1980687,1517132,2025-03-13,House,"House Health Professions & Programs Subcommittee",13,0,0,5,18
1980688,1513250,2025-03-11,House,"House Education Administration Subcommittee",17,0,0,1,18
1980688,1525310,2025-03-24,House,"House Health & Human Services Committee",25,0,0,2,27
1980688,1531886,2025-04-01,House,"House Health Care Budget Subcommittee",14,0,0,1,15
1980688,1539949,2025-04-08,House,"House Education & Employment Committee",17,0,0,5,22
1980688,1549895,2025-04-16,House,"House: Third Reading RCS#135",116,0,3,0,119
1980688,1562437,2025-04-30,Senate,"Senate: Third Reading RCS#43",37,0,0,1,38
1980709,1527578,2025-03-26,House,"House Intergovernmental Affairs Subcommittee",14,0,0,5,19
1980709,1533962,2025-04-02,House,"House Ways & Means Committee",15,0,0,4,19
1980709,1539385,2025-04-08,House,"House State Affairs Committee",22,0,0,4,26
1980709,1557251,2025-04-24,House,"House: Third Reading RCS#222",115,0,4,0,119
1980709,1561990,2025-04-30,Senate,"Senate: Third Reading RCS#24",36,0,1,1,38
1980726,1551128,2025-04-17,House,"House Judiciary Committee",18,0,0,4,22
1980745,1518686,2025-03-17,Senate,"Senate Environment and Natural Resources",8,0,0,1,9
1980858,1521369,2025-03-19,Senate,"Senate Transportation",9,0,0,0,9
1980858,1544427,2025-04-10,Senate,"Senate Appropriations Committee on Transportation, Tourism, and Economic Development",13,0,0,2,15
1980979,1514765,2025-03-11,Senate,"Senate Criminal Justice",9,0,0,0,9
1981045,1521872,2025-03-19,House,"House Intergovernmental Affairs Subcommittee",17,0,0,1,18
1981045,1536020,2025-04-03,House,"House Insurance & Banking Subcommittee",16,0,0,2,18
1981045,1543506,2025-04-10,House,"House State Administration Budget Subcommittee",15,0,0,0,15
1981045,1551111,2025-04-17,House,"House State Affairs Committee",22,0,0,4,26
1981045,1555494,2025-04-23,House,"House: Third Reading RCS#193",115,0,4,0,119
1981045,1562423,2025-04-30,Senate,"Senate: Third Reading RCS#42",37,0,0,1,38
1981075,1515755,2025-03-12,Senate,"Senate Rules",23,0,0,2,25
1981075,1521309,2025-03-19,Senate,"Senate: Third Reading RCS#5",37,0,2,0,39
1981075,1535832,2025-04-03,House,"House: Third Reading RCS#32",108,0,11,0,119
1981161,1514627,2025-03-11,Senate,"Senate Criminal Justice",9,0,0,0,9
1981161,1544754,2025-04-10,Senate,"Senate Appropriations Committee on Criminal and Civil Justice",8,0,0,1,9
1981161,1554782,2025-04-22,Senate,"Senate Fiscal Policy",18,0,0,1,19
1981199,1513115,2025-03-11,Senate,"Senate Governmental Oversight and Accountability",6,1,0,1,8
1981199,1526120,2025-03-24,Senate,"Senate Appropriations Committee on Pre-K - 12 Education",8,0,0,2,10
1981199,1533551,2025-04-01,Senate,"Senate Rules",22,3,0,0,25
1981211,1534356,2025-04-01,House,"House Industries & Professional Activities Subcommittee",12,4,0,3,19
1981211,1539022,2025-04-07,House,"House Commerce Committee",19,3,0,4,26
1981211,1555416,2025-04-23,House,"House: Third Reading RCS#165",88,25,6,0,119
1981248,1503905,2025-03-03,Senate,"Senate Banking and Insurance",10,0,0,0,10
1981248,1533790,2025-04-01,Senate,"Senate Governmental Oversight and Accountability",7,0,0,0,7
1981248,1540705,2025-04-08,Senate,"Senate Rules",24,0,0,1,25
1981258,1523323,2025-03-20,House,"House Civil Justice & Claims Subcommittee",15,0,0,3,18
1981258,1527772,2025-03-26,House,"House Judiciary Committee",19,3,0,0,22
1981258,1551134,2025-04-17,House,"House Judiciary Committee",16,4,0,2,22
1981326,1543828,2025-04-10,House,"House Government Operations Subcommittee",17,0,0,1,18
1981326,1548198,2025-04-15,House,"House Transportation & Economic Development Budget Subcommittee",13,0,0,2,15
1981326,1551358,2025-04-17,House,"House State Affairs Committee",22,0,0,4,26
1981326,1555243,2025-04-23,House,"House: Third Reading RCS#183",115,0,4,0,119
1981326,1559890,2025-04-29,Senate,"Senate: Third Reading RCS#17",38,0,0,0,38
1981374,1514767,2025-03-11,Senate,"Senate Education Pre-K - 12",8,0,0,1,9
1981374,1521047,2025-03-18,Senate,"Senate Health Policy",9,0,0,1,10
1981374,1534200,2025-04-02,Senate,"Senate Fiscal Policy",18,0,0,1,19
1981374,1542073,2025-04-09,Senate,"Senate: Third Reading RCS#48",37,0,0,1,38
1981374,1562159,2025-04-30,House,"House: Third Reading RCS#357",111,0,8,0,119
1981374,1563550,2025-05-01,Senate,"Senate: Third Reading RCS#9",37,0,1,0,38
1981384,1512596,2025-03-11,House,"House Education Administration Subcommittee",17,0,0,1,18
1981384,1534757,2025-04-02,House,"House Education & Employment Committee",19,0,0,3,22
1981384,1549708,2025-04-16,House,"House: Third Reading RCS#95",117,0,2,0,119
1981399,1527325,2025-03-25,House,"House Housing, Agriculture & Tourism Subcommittee",14,1,0,3,18
1981399,1541433,2025-04-09,House,"House Intergovernmental Affairs Subcommittee",13,3,0,2,18
1981399,1554015,2025-04-22,House,"House Commerce Committee",20,3,0,4,27
1981409,1503889,2025-03-03,Senate,"Senate Banking and Insurance",10,0,0,0,10
1981409,1533106,2025-04-01,Senate,"Senate Governmental Oversight and Accountability",7,0,0,0,7
1981409,1539954,2025-04-08,Senate,"Senate Rules",24,0,0,1,25
1981409,1548484,2025-04-15,Senate,"Senate: Third Reading RCS#2",35,0,1,2,38
1981409,1560603,2025-04-29,House,"House: Third Reading RCS#337",114,0,5,0,119
1981445,1535752,2025-04-03,House,"House Civil Justice & Claims Subcommittee",14,0,0,5,19
1981445,1545328,2025-04-10,House,"House Housing, Agriculture & Tourism Subcommittee",17,0,0,1,18
1981491,1533683,2025-04-01,House,"House Government Operations Subcommittee",15,0,0,4,19
1981545,1527717,2025-03-26,House,"House Intergovernmental Affairs Subcommittee",12,3,0,4,19
1981545,1538198,2025-04-07,House,"House Agriculture & Natural Resources Budget Subcommittee",12,3,0,1,16
1981574,1520958,2025-03-18,Senate,"Senate Health Policy",9,0,0,1,10
1981574,1548178,2025-04-15,Senate,"Senate Appropriations Committee on Health and Human Services",10,0,0,0,10
1981574,1554013,2025-04-22,Senate,"Senate Appropriations",18,0,0,0,18
1981574,1558948,2025-04-28,Senate,"Senate: Third Reading RCS#16",35,0,1,2,38
1981587,1521441,2025-03-19,House,"House Education Administration Subcommittee",15,0,0,3,18
1981587,1532457,2025-04-01,House,"House Human Services Subcommittee",16,0,0,2,18
1981587,1551351,2025-04-17,House,"House Education & Employment Committee",17,0,0,6,23
1981587,1555261,2025-04-23,House,"House: Third Reading RCS#162",106,1,12,0,119
1981587,1556696,2025-04-24,Senate,"Senate: Third Reading RCS#14",37,0,0,1,38
1981625,1535561,2025-04-01,Senate,"Senate Children, Families, and Elder Affairs",6,0,0,1,7
1981625,1548132,2025-04-15,Senate,"Senate Appropriations Committee on Health and Human Services",9,1,0,0,10
1981625,1554065,2025-04-22,Senate,"Senate Appropriations",17,1,0,0,18
1981684,1522143,2025-03-19,House,"House Industries & Professional Activities Subcommittee",15,1,0,2,18
1981684,1535390,2025-04-02,House,"House Education & Employment Committee",17,0,0,5,22
1981730,1515852,2025-03-10,Senate,"Senate Banking and Insurance",9,0,0,1,10
1981730,1528670,2025-03-25,Senate,"Senate Community Affairs",5,3,0,0,8
1981730,1550221,2025-04-16,Senate,"Senate Rules",22,0,0,3,25
1981744,1519499,2025-03-18,House,"House Natural Resources & Disasters Subcommittee",17,0,0,1,18
1981744,1529100,2025-03-27,House,"House Ways & Means Committee",18,0,0,1,19
1981744,1538297,2025-04-07,House,"House Agriculture & Natural Resources Budget Subcommittee",15,0,0,1,16
1981744,1551385,2025-04-17,House,"House State Affairs Committee",22,0,0,4,26
1981744,1555239,2025-04-23,House,"House: Third Reading RCS#152",115,0,4,0,119
1981753,1520597,2025-03-18,Senate,"Senate Criminal Justice",9,0,0,0,9
1981753,1544922,2025-04-10,Senate,"Senate Appropriations Committee on Criminal and Civil Justice",8,0,0,1,9
1981753,1555169,2025-04-22,Senate,"Senate Fiscal Policy",18,0,0,1,19
1981782,1533807,2025-04-01,Senate,"Senate Governmental Oversight and Accountability",7,0,0,0,7
1981805,1522964,2025-03-20,House,"House Insurance & Banking Subcommittee",16,0,0,2,18
1981805,1534063,2025-04-02,House,"House Ways & Means Committee",19,0,0,0,19
1981805,1549607,2025-04-15,House,"House Commerce Committee",25,0,0,1,26
1981805,1555186,2025-04-23,House,"House: Third Reading RCS#167",112,1,6,0,119
1981805,1560594,2025-04-29,Senate,"Senate: Third Reading RCS#27",38,0,0,0,38
1981805,1562132,2025-04-30,House,"House: Third Reading RCS#374",113,0,6,0,119
1981821,1519466,2025-03-17,Senate,"Senate Community Affairs",6,2,0,0,8
1981821,1533884,2025-04-01,Senate,"Senate Judiciary",8,3,0,0,11
1981821,1550119,2025-04-16,Senate,"Senate Rules",18,4,0,3,25
1981821,1555230,2025-04-23,Senate,"Senate: Third Reading RCS#33",18,19,1,0,38
1981821,1558940,2025-04-28,Senate,"Senate: Third Reading RCS#3",26,8,2,2,38
1981821,1562037,2025-04-30,House,"House: Third Reading RCS#345",84,29,6,0,119
1981821,1563783,2025-05-01,Senate,"Senate: Third Reading RCS#15",29,8,1,0,38
1981896,1520326,2025-03-18,House,"House Human Services Subcommittee",17,0,0,1,18
1981896,1531419,2025-03-31,House,"House Health & Human Services Committee",25,0,0,2,27
1981896,1542530,2025-04-09,House,"House: Third Reading RCS#80",111,0,8,0,119
1981896,1556447,2025-04-24,Senate,"Senate: Third Reading RCS#15",37,0,0,1,38
1981909,1504820,2025-03-04,Senate,"Senate Criminal Justice",9,0,0,0,9
1981909,1534610,2025-04-02,Senate,"Senate Appropriations",18,0,0,0,18
1981909,1541353,2025-04-09,Senate,"Senate: Third Reading RCS#2",37,0,0,1,38
1981909,1541354,2025-04-09,Senate,"Senate: Third Reading RCS#3",37,0,0,1,38
1981909,1562485,2025-04-30,House,"House: Third Reading RCS#383",112,0,7,0,119
1981909,1564649,2025-05-02,House,"House: Third Reading RCS#417",99,0,20,0,119
1981925,1533340,2025-04-01,Senate,"Senate Criminal Justice",9,0,0,0,9
1981925,1544844,2025-04-10,Senate,"Senate Appropriations Committee on Criminal and Civil Justice",8,0,0,1,9
1981925,1551934,2025-04-17,Senate,"Senate Fiscal Policy",17,0,0,2,19
1981938,1517137,2025-03-13,House,"House State Affairs Committee",17,8,0,1,26
1981938,1554032,2025-04-22,House,"House Commerce Committee",13,8,0,6,27
1981949,1516525,2025-03-12,House,"House Economic Infrastructure Subcommittee",17,0,0,1,18
1981949,1550276,2025-04-15,House,"House Commerce Committee",25,0,0,1,26
1981949,1554962,2025-04-23,House,"House: Third Reading RCS#147",112,0,7,0,119
1981949,1555702,2025-04-23,Senate,"Senate: Third Reading RCS#27",38,0,0,0,38
1981949,1562681,2025-04-30,House,"House: Third Reading RCS#375",111,0,8,0,119
1981949,1564129,2025-05-01,Senate,"Senate: Third Reading RCS#13",37,0,1,0,38
1981960,1527378,2025-03-25,Senate,"Senate Health Policy",7,3,0,0,10
1981960,1532992,2025-04-01,Senate,"Senate Rules",22,1,0,2,25
1981960,1541551,2025-04-09,Senate,"Senate: Third Reading RCS#27",37,0,0,1,38
1981975,1533881,2025-04-01,Senate,"Senate Regulated Industries",7,0,0,1,8
1981975,1550591,2025-04-16,Senate,"Senate Rules",23,0,0,2,25
1982284,1519057,2025-03-17,Senate,"Senate Education Pre-K - 12",8,0,0,1,9
1982284,1545991,2025-04-10,Senate,"Senate Appropriations Committee on Pre-K - 12 Education",8,0,0,1,9
1982284,1551348,2025-04-17,Senate,"Senate Fiscal Policy",17,0,0,2,19
1982284,1556385,2025-04-24,Senate,"Senate: Third Reading RCS#18",37,0,0,1,38
1982284,1560138,2025-04-29,House,"House: Third Reading RCS#293",116,0,3,0,119
1982314,1516219,2025-03-12,House,"House Criminal Justice Subcommittee",16,1,0,2,19
1982314,1522462,2025-03-20,House,"House Judiciary Committee",21,0,0,2,23
1982314,1555498,2025-04-23,House,"House: Third Reading RCS#185",111,2,6,0,119
1982323,1521685,2025-03-19,House,"House Intergovernmental Affairs Subcommittee",16,0,0,2,18
1982323,1528924,2025-03-27,House,"House Ways & Means Committee",18,0,0,1,19
1982323,1534875,2025-04-02,House,"House State Affairs Committee",23,0,0,3,26
1982323,1549807,2025-04-16,House,"House: Third Reading RCS#122",116,0,3,0,119
1982323,1562274,2025-04-30,Senate,"Senate: Third Reading RCS#25",36,0,1,1,38
1982339,1515782,2025-03-11,Senate,"Senate Community Affairs",7,0,0,1,8
1982361,1519871,2025-03-17,Senate,"Senate Community Affairs",7,1,0,0,8
1982367,1533427,2025-04-01,Senate,"Senate Criminal Justice",9,0,0,0,9
1982367,1545338,2025-04-10,Senate,"Senate Appropriations Committee on Criminal and Civil Justice",8,0,0,1,9
1982367,1551335,2025-04-17,Senate,"Senate Fiscal Policy",17,0,0,2,19
1982381,1531547,2025-03-31,Senate,"Senate Education Pre-K - 12",9,0,0,0,9
1982381,1549660,2025-04-15,Senate,"Senate Appropriations Committee on Pre-K - 12 Education",8,0,0,1,9
1982381,1553062,2025-04-21,Senate,"Senate Rules",23,0,0,2,25
1982390,1521563,2025-03-19,House,"House Criminal Justice Subcommittee",17,0,0,1,18
1982390,1534529,2025-04-02,House,"House Judiciary Committee",20,0,0,2,22
1982400,1534473,2025-04-02,House,"House Education Administration Subcommittee",17,1,0,0,18
1982400,1551082,2025-04-17,House,"House Education & Employment Committee",21,0,0,2,23
1982400,1555365,2025-04-23,House,"House: Third Reading RCS#161",102,7,10,0,119
1982412,1509172,2025-03-10,Senate,"Senate Commerce and Tourism",7,1,0,1,9
1982412,1526337,2025-03-25,Senate,"Senate Agriculture",5,0,0,1,6
1982412,1539938,2025-04-08,Senate,"Senate Rules",19,5,0,1,25
1982433,1533659,2025-04-01,Senate,"Senate Governmental Oversight and Accountability",7,0,0,0,7
1982451,1507455,2025-03-06,House,"House Intergovernmental Affairs Subcommittee",14,0,0,4,18
1982451,1520330,2025-03-18,House,"House Government Operations Subcommittee",15,0,0,4,19
1982451,1524034,2025-03-18,House,"House Government Operations Subcommittee",15,0,0,4,19
1982451,1535052,2025-04-02,House,"House State Affairs Committee",24,0,0,2,26
1982451,1549921,2025-04-16,House,"House: Third Reading RCS#124",115,0,4,0,119
1982451,1562010,2025-04-30,Senate,"Senate: Third Reading RCS#26",36,0,1,1,38
1982464,1533062,2025-04-01,Senate,"Senate Governmental Oversight and Accountability",6,1,0,0,7
1982475,1533591,2025-04-01,House,"House Government Operations Subcommittee",12,4,0,3,19
1982494,1520889,2025-03-17,Senate,"Senate Community Affairs",5,3,0,0,8
1982521,1504472,2025-03-04,Senate,"Senate Health Policy",10,0,0,0,10
1982521,1529826,2025-03-26,Senate,"Senate Appropriations Committee on Health and Human Services",10,0,0,0,10
1982521,1534474,2025-04-02,Senate,"Senate Appropriations",18,0,0,0,18
1982521,1541719,2025-04-09,Senate,"Senate: Third Reading RCS#26",37,0,0,1,38
1982573,1514768,2025-03-11,House,"House Housing, Agriculture & Tourism Subcommittee",18,0,0,0,18
1982573,1528895,2025-03-27,House,"House Civil Justice & Claims Subcommittee",13,0,0,5,18
1982573,1549762,2025-04-15,House,"House Commerce Committee",24,0,0,2,26
1982584,1518698,2025-03-17,Senate,"Senate Environment and Natural Resources",8,0,0,1,9
1982584,1526801,2025-03-25,Senate,"Senate Judiciary",11,0,0,0,11
1982601,1519005,2025-03-17,Senate,"Senate Environment and Natural Resources",8,0,0,1,9
1982629,1518650,2025-03-17,Senate,"Senate Education Pre-K - 12",9,0,0,0,9
1982629,1545942,2025-04-10,Senate,"Senate Appropriations Committee on Pre-K - 12 Education",8,0,0,1,9
1982629,1552054,2025-04-17,Senate,"Senate Appropriations",15,0,0,3,18
1982629,1556680,2025-04-24,Senate,"Senate: Third Reading RCS#17",37,0,0,1,38
1982673,1526696,2025-03-25,House,"House Human Services Subcommittee",17,0,0,1,18
1982673,1541979,2025-04-09,House,"House Health Care Budget Subcommittee",13,0,0,2,15
1982673,1548527,2025-04-15,House,"House Health & Human Services Committee",23,0,0,3,26
1982673,1555650,2025-04-23,House,"House: Third Reading RCS#192",115,0,4,0,119
1982681,1526233,2025-03-25,Senate,"Senate Criminal Justice",9,0,0,0,9
1982681,1549518,2025-04-15,Senate,"Senate Appropriations Committee on Criminal and Civil Justice",9,0,0,0,9
1982681,1554649,2025-04-22,Senate,"Senate Fiscal Policy",19,0,0,0,19
1982759,1533747,2025-03-31,Senate,"Senate Banking and Insurance",10,0,0,0,10
1982767,1521638,2025-03-19,House,"House Industries & Professional Activities Subcommittee",15,0,0,3,18
1982781,1515341,2025-03-11,Senate,"Senate Environment and Natural Resources",9,0,0,0,9
1982781,1527079,2025-03-25,Senate,"Senate Regulated Industries",8,0,0,1,9
1982781,1532323,2025-04-01,Senate,"Senate Rules",25,0,0,0,25
1982781,1542049,2025-04-09,Senate,"Senate: Third Reading RCS#53",36,0,0,2,38
1982781,1559813,2025-04-29,House,"House: Third Reading RCS#273",109,0,10,0,119
1982813,1523061,2025-03-20,House,"House Health Professions & Programs Subcommittee",17,0,0,1,18
1982813,1532168,2025-04-01,House,"House Health Care Budget Subcommittee",14,0,0,1,15
1982813,1548895,2025-04-15,House,"House Health & Human Services Committee",22,0,0,4,26
1982813,1555496,2025-04-23,House,"House: Third Reading RCS#176",115,0,4,0,119
1982813,1559780,2025-04-29,Senate,"Senate: Third Reading RCS#6",36,0,2,0,38
1982828,1521264,2025-03-19,House,"House Criminal Justice Subcommittee",17,0,0,1,18
1982828,1527455,2025-03-26,House,"House Judiciary Committee",22,0,0,0,22
1982828,1536034,2025-04-03,House,"House: Third Reading RCS#42",108,0,11,0,119
1982828,1557147,2025-04-24,Senate,"Senate: Third Reading RCS#40",37,0,0,1,38
1982852,1526513,2025-03-25,House,"House Government Operations Subcommittee",16,0,0,2,18
1982852,1537346,2025-03-25,House,"House Government Operations Subcommittee",16,0,0,2,18
1982852,1540162,2025-04-08,House,"House Higher Education Budget Subcommittee",14,0,0,1,15
1982852,1551212,2025-04-17,House,"House State Affairs Committee",21,0,0,5,26
1982873,1523305,2025-03-20,House,"House Health Professions & Programs Subcommittee",17,0,0,1,18
1982873,1531582,2025-03-31,House,"House Health & Human Services Committee",19,7,0,1,27
1982873,1542656,2025-04-09,House,"House: Third Reading RCS#83",86,20,13,0,119
1982897,1521113,2025-03-19,House,"House Industries & Professional Activities Subcommittee",16,0,0,2,18
1982897,1532077,2025-04-01,House,"House Intergovernmental Affairs Subcommittee",16,0,0,2,18
1982937,1527651,2025-03-26,House,"House Criminal Justice Subcommittee",17,0,0,1,18
1982937,1533285,2025-04-01,House,"House Justice Budget Subcommittee",11,0,0,4,15
1982937,1540697,2025-04-08,House,"House Judiciary Committee",22,0,0,0,22
1982937,1558070,2025-04-25,House,"House: Third Reading RCS#259",111,0,8,0,119
1982937,1559299,2025-04-28,Senate,"Senate: Third Reading RCS#23",37,0,0,1,38
1982943,1516486,2025-03-12,House,"House Intergovernmental Affairs Subcommittee",15,0,0,3,18
1982943,1551214,2025-04-17,House,"House State Affairs Committee",23,0,0,3,26
1982957,1526344,2025-03-25,Senate,"Senate Criminal Justice",9,0,0,0,9
1982957,1545370,2025-04-10,Senate,"Senate Appropriations Committee on Criminal and Civil Justice",8,0,0,1,9
1982957,1554674,2025-04-22,Senate,"Senate Fiscal Policy",18,0,0,1,19
1982965,1533604,2025-04-01,House,"House Intergovernmental Affairs Subcommittee",16,0,0,2,18
1982965,1540810,2025-04-08,House,"House Ways & Means Committee",16,0,0,3,19
1982965,1551131,2025-04-17,House,"House State Affairs Committee",21,0,0,5,26
1982965,1557194,2025-04-24,House,"House: Third Reading RCS#216",113,0,6,0,119
1982965,1562217,2025-04-30,Senate,"Senate: Third Reading RCS#28",36,0,1,1,38
1982976,1527900,2025-03-26,House,"House Criminal Justice Subcommittee",15,0,0,3,18
1982976,1534531,2025-04-02,House,"House Judiciary Committee",20,0,0,2,22
1982976,1550271,2025-04-16,House,"House: Third Reading RCS#130",116,0,3,0,119
1982976,1557126,2025-04-24,Senate,"Senate: Third Reading RCS#29",36,0,1,1,38
1982976,1562610,2025-04-30,House,"House: Third Reading RCS#369",113,0,6,0,119
1982982,1529360,2025-03-27,House,"House Education Administration Subcommittee",17,0,0,1,18
1983005,1515671,2025-03-11,Senate,"Senate Community Affairs",7,0,0,1,8
1983005,1527913,2025-03-26,Senate,"Senate Finance and Tax",6,0,0,0,6
1983005,1552036,2025-04-17,Senate,"Senate Appropriations",14,0,0,4,18
1983010,1519338,2025-03-17,Senate,"Senate Community Affairs",6,2,0,0,8
1983010,1533059,2025-04-01,Senate,"Senate Transportation",6,3,0,0,9
1983055,1528696,2025-03-27,House,"House Insurance & Banking Subcommittee",12,6,0,0,18
1983070,1519996,2025-03-18,House,"House Human Services Subcommittee",16,0,0,2,18
1983070,1548519,2025-04-15,House,"House Health & Human Services Committee",21,0,0,5,26
1983070,1557220,2025-04-24,House,"House: Third Reading RCS#243",115,0,4,0,119
1983070,1559917,2025-04-29,Senate,"Senate: Third Reading RCS#14",37,0,1,0,38
1983070,1562034,2025-04-30,House,"House: Third Reading RCS#371",112,0,7,0,119
1983089,1522812,2025-03-20,House,"House Ways & Means Committee",17,0,0,2,19
1983089,1527774,2025-03-26,House,"House Intergovernmental Affairs Subcommittee",13,0,0,6,19
1983089,1534631,2025-04-02,House,"House State Affairs Committee",24,0,0,2,26
1983104,1521404,2025-03-19,House,"House Health Care Facilities & Systems Subcommittee",14,3,0,1,18
1983104,1548377,2025-04-15,House,"House Health Care Budget Subcommittee",15,0,0,0,15
1983104,1553297,2025-04-22,House,"House Health & Human Services Committee",22,0,0,5,27
1983147,1527821,2025-03-26,House,"House Criminal Justice Subcommittee",16,0,0,2,18
1983147,1540401,2025-04-08,House,"House Budget Committee",29,0,0,1,30
1983147,1551402,2025-04-17,House,"House Judiciary Committee",18,0,0,4,22
1983147,1556905,2025-04-24,House,"House: Third Reading RCS#213",114,0,5,0,119
1983147,1560114,2025-04-29,Senate,"Senate: Third Reading RCS#16",37,0,1,0,38
1983149,1518863,2025-03-17,Senate,"Senate Environment and Natural Resources",8,0,0,1,9
1983166,1533990,2025-04-01,Senate,"Senate Health Policy",10,0,0,0,10
1983166,1544447,2025-04-10,Senate,"Senate Appropriations Committee on Health and Human Services",8,0,0,2,10
1983166,1555301,2025-04-22,Senate,"Senate Fiscal Policy",18,0,0,1,19
1983166,1560014,2025-04-29,Senate,"Senate: Third Reading RCS#13",37,0,1,0,38
1983166,1562106,2025-04-30,House,"House: Third Reading RCS#354",113,0,6,0,119
1983199,1515693,2025-03-11,Senate,"Senate Community Affairs",7,0,0,1,8
1983199,1526208,2025-03-25,Senate,"Senate Governmental Oversight and Accountability",7,0,0,1,8
1983199,1534429,2025-04-02,Senate,"Senate Appropriations",18,0,0,0,18
1983199,1542427,2025-04-09,Senate,"Senate: Third Reading RCS#51",36,0,0,2,38
1983199,1560363,2025-04-29,House,"House: Third Reading RCS#323",116,0,3,0,119
1983210,1526561,2025-03-24,Senate,"Senate Appropriations Committee on Higher Education",8,0,0,0,8
1983210,1534639,2025-04-02,Senate,"Senate Appropriations",18,0,0,0,18
1983210,1541956,2025-04-09,Senate,"Senate: Third Reading RCS#25",37,0,0,1,38
1983230,1515400,2025-03-11,Senate,"Senate Environment and Natural Resources",9,0,0,0,9
1983230,1527713,2025-03-26,Senate,"Senate Appropriations Committee on Agriculture, Environment, and General Government",12,0,0,1,13
1983230,1534619,2025-04-02,Senate,"Senate Fiscal Policy",17,0,0,2,19
1983233,1521156,2025-03-17,Senate,"Senate Banking and Insurance",7,0,0,3,10
1983247,1533124,2025-04-01,House,"House Natural Resources & Disasters Subcommittee",15,2,0,1,18
1983260,1532058,2025-04-01,House,"House Intergovernmental Affairs Subcommittee",16,0,0,2,18
1983260,1539986,2025-04-08,House,"House Ways & Means Committee",16,0,0,3,19
1983260,1551318,2025-04-17,House,"House State Affairs Committee",21,0,0,5,26
1983260,1557736,2025-04-24,House,"House: Third Reading RCS#215",114,0,5,0,119
1983260,1562734,2025-04-30,Senate,"Senate: Third Reading RCS#27",36,0,1,1,38
1983263,1534036,2025-04-01,Senate,"Senate Health Policy",10,0,0,0,10
1983263,1548442,2025-04-15,Senate,"Senate Appropriations Committee on Health and Human Services",10,0,0,0,10
1983278,1517006,2025-03-12,Senate,"Senate Children, Families, and Elder Affairs",7,0,0,0,7
1983278,1544119,2025-04-10,Senate,"Senate Appropriations Committee on Health and Human Services",8,0,0,2,10
1983278,1549840,2025-04-16,Senate,"Senate Rules",22,0,0,3,25
1983286,1522599,2025-03-20,House,"House Ways & Means Committee",17,0,0,2,19
1983286,1528227,2025-03-26,House,"House Intergovernmental Affairs Subcommittee",14,0,0,5,19
1983286,1534564,2025-04-02,House,"House State Affairs Committee",24,0,0,2,26
1983321,1519226,2025-03-17,Senate,"Senate Commerce and Tourism",9,0,0,0,9
1983327,1515718,2025-03-12,Senate,"Senate Judiciary",10,0,0,1,11
1983327,1533108,2025-03-31,Senate,"Senate Community Affairs",8,0,0,0,8
1983327,1539682,2025-04-08,Senate,"Senate Rules",23,1,0,1,25
1983346,1532215,2025-04-01,House,"House Human Services Subcommittee",17,0,0,1,18
1983419,1520876,2025-03-17,Senate,"Senate Banking and Insurance",7,0,0,3,10
1983419,1543675,2025-04-10,Senate,"Senate Appropriations Committee on Agriculture, Environment, and General Government",11,0,0,1,12
1983419,1555120,2025-04-22,Senate,"Senate Fiscal Policy",19,0,0,0,19
1983429,1527711,2025-03-26,House,"House Intergovernmental Affairs Subcommittee",15,0,0,4,19
1983429,1533383,2025-04-01,House,"House Government Operations Subcommittee",16,0,0,3,19
1983429,1539344,2025-04-08,House,"House State Affairs Committee",22,0,0,4,26
1983429,1557183,2025-04-24,House,"House: Third Reading RCS#225",113,0,6,0,119
1983429,1561931,2025-04-30,Senate,"Senate: Third Reading RCS#38",36,0,1,1,38
1983438,1517709,2025-03-13,House,"House Insurance & Banking Subcommittee",16,0,0,2,18
1983438,1529115,2025-03-27,House,"House Budget Committee",26,0,0,4,30
1983438,1549681,2025-04-15,House,"House Commerce Committee",23,0,0,3,26
1983449,1513285,2025-03-11,Senate,"Senate Criminal Justice",9,0,0,0,9
1983449,1525776,2025-03-24,Senate,"Senate Appropriations Committee on Criminal and Civil Justice",9,0,0,0,9
1983449,1532671,2025-04-01,Senate,"Senate Rules",24,0,0,1,25
1983449,1541976,2025-04-09,Senate,"Senate: Third Reading RCS#50",37,0,0,1,38
1983449,1560074,2025-04-29,House,"House: Third Reading RCS#298",115,0,4,0,119
1983455,1514660,2025-03-11,Senate,"Senate Criminal Justice",9,0,0,0,9
1983455,1525873,2025-03-24,Senate,"Senate Appropriations Committee on Criminal and Civil Justice",9,0,0,0,9
1983455,1533053,2025-04-01,Senate,"Senate Rules",25,0,0,0,25
1983455,1542340,2025-04-09,Senate,"Senate: Third Reading RCS#49",37,0,0,1,38
1983455,1560572,2025-04-29,House,"House: Third Reading RCS#320",116,0,3,0,119
1983487,1515662,2025-03-11,Senate,"Senate Community Affairs",7,0,0,1,8
1983487,1527628,2025-03-26,Senate,"Senate Finance and Tax",6,0,0,0,6
1983487,1552049,2025-04-17,Senate,"Senate Appropriations",15,0,0,3,18
1983495,1513198,2025-03-10,Senate,"Senate Banking and Insurance",10,0,0,0,10
1983495,1528124,2025-03-26,Senate,"Senate Appropriations Committee on Agriculture, Environment, and General Government",12,0,0,1,13
1983495,1534517,2025-04-02,Senate,"Senate Fiscal Policy",15,0,0,4,19
1983510,1527342,2025-03-25,Senate,"Senate Health Policy",10,0,0,0,10
1983510,1548238,2025-04-15,Senate,"Senate Appropriations Committee on Health and Human Services",10,0,0,0,10
1983510,1553104,2025-04-21,Senate,"Senate Rules",23,0,0,2,25
1983528,1526793,2025-03-25,Senate,"Senate Transportation",8,0,0,1,9
1983555,1533197,2025-04-01,Senate,"Senate Governmental Oversight and Accountability",7,0,0,0,7
1983555,1552037,2025-04-17,Senate,"Senate Appropriations",16,0,0,2,18
1983559,1532849,2025-04-01,Senate,"Senate Transportation",8,0,0,1,9
1983559,1544678,2025-04-10,Senate,"Senate Appropriations Committee on Transportation, Tourism, and Economic Development",13,0,0,2,15
1983587,1513340,2025-03-11,House,"House Health Care Facilities & Systems Subcommittee",16,0,0,2,18
1983587,1525384,2025-03-24,House,"House Health & Human Services Committee",26,0,0,1,27
1983587,1549985,2025-04-16,House,"House: Third Reading RCS#141",113,0,6,0,119
1983597,1520722,2025-03-19,Senate,"Senate Children, Families, and Elder Affairs",6,0,0,1,7
1983597,1548236,2025-04-15,Senate,"Senate Appropriations Committee on Health and Human Services",8,1,0,1,10
1983597,1553204,2025-04-21,Senate,"Senate Rules",23,0,0,2,25
1983633,1515797,2025-03-11,Senate,"Senate Community Affairs",4,3,0,1,8
1983633,1534006,2025-04-01,Senate,"Senate Judiciary",8,3,0,0,11
1983633,1553265,2025-04-21,Senate,"Senate Rules",22,0,0,3,25
1983647,1519098,2025-03-17,Senate,"Senate Commerce and Tourism",9,0,0,0,9
1983647,1545358,2025-04-10,Senate,"Senate Appropriations Committee on Criminal and Civil Justice",8,0,0,1,9
1983647,1554747,2025-04-22,Senate,"Senate Fiscal Policy",19,0,0,0,19
1983666,1509507,2025-03-10,Senate,"Senate Commerce and Tourism",8,0,0,1,9
1983670,1527213,2025-03-25,Senate,"Senate Transportation",8,0,0,1,9
1983670,1543550,2025-04-10,Senate,"Senate Appropriations Committee on Transportation, Tourism, and Economic Development",13,0,0,2,15
1983681,1513877,2025-03-11,House,"House Student Academic Success Subcommittee",17,0,0,1,18
1983681,1525800,2025-03-11,House,"House Student Academic Success Subcommittee",17,0,0,1,18
1983681,1526773,2025-03-25,House,"House PreK-12 Budget Subcommittee",15,0,0,0,15
1983681,1534885,2025-04-02,House,"House Education & Employment Committee",17,0,0,5,22
1983681,1549524,2025-04-16,House,"House: Third Reading RCS#98",114,1,4,0,119
1983700,1521273,2025-03-19,Senate,"Senate Regulated Industries",8,0,0,1,9
1983721,1531447,2025-03-31,Senate,"Senate Commerce and Tourism",6,3,0,0,9
1983730,1521511,2025-03-19,House,"House Health Care Facilities & Systems Subcommittee",15,2,0,1,18
1983730,1531546,2025-03-31,House,"House Health & Human Services Committee",17,8,0,2,27
1983730,1541917,2025-04-09,House,"House: Third Reading RCS#85",79,29,11,0,119
1983730,1563789,2025-05-01,Senate,"Senate: Third Reading RCS#19",34,2,2,0,38
1983730,1564569,2025-05-02,House,"House: Third Reading RCS#409",87,27,5,0,119
1983741,1519389,2025-03-17,Senate,"Senate Community Affairs",8,0,0,0,8
1983749,1529451,2025-03-27,House,"House Education Administration Subcommittee",13,3,0,2,18
1983749,1539548,2025-04-08,House,"House PreK-12 Budget Subcommittee",13,2,0,0,15
1983749,1551753,2025-04-17,House,"House Education & Employment Committee",15,4,0,4,23
1983749,1555257,2025-04-23,House,"House: Third Reading RCS#159",86,26,7,0,119
1983749,1563404,2025-05-01,Senate,"Senate: Third Reading RCS#6",38,0,0,0,38
1983749,1564660,2025-05-02,House,"House: Third Reading RCS#413",84,19,16,0,119
1983777,1533749,2025-04-01,Senate,"Senate Criminal Justice",8,1,0,0,9
1983777,1550403,2025-04-16,Senate,"Senate Rules",21,1,0,3,25
1983777,1557297,2025-04-24,Senate,"Senate: Third Reading RCS#47",18,19,0,1,38
1983777,1557298,2025-04-24,Senate,"Senate: Third Reading RCS#48",23,14,0,1,38
1983785,1520216,2025-03-18,House,"House Student Academic Success Subcommittee",15,0,0,3,18
1983785,1521157,2025-03-18,House,"House Student Academic Success Subcommittee",15,0,0,3,18
1983785,1524110,2025-03-18,House,"House Student Academic Success Subcommittee",15,0,0,3,18
1983785,1531251,2025-03-31,House,"House Careers & Workforce Subcommittee",15,0,0,3,18
1983792,1530880,2025-03-31,Senate,"Senate Commerce and Tourism",7,2,0,0,9
1983792,1549990,2025-04-15,Senate,"Senate Appropriations Committee on Transportation, Tourism, and Economic Development",13,2,0,0,15
1983804,1522122,2025-03-19,House,"House Criminal Justice Subcommittee",17,0,0,1,18
1983804,1540666,2025-04-08,House,"House Judiciary Committee",16,0,0,6,22
1983804,1555040,2025-04-23,House,"House: Third Reading RCS#148",114,0,5,0,119
1983804,1557410,2025-04-24,Senate,"Senate: Third Reading RCS#41",37,0,0,1,38
1983813,1519567,2025-03-18,House,"House Human Services Subcommittee",17,0,0,1,18
1983813,1529139,2025-03-27,House,"House Budget Committee",26,0,0,4,30
1983813,1548573,2025-04-15,House,"House Health & Human Services Committee",23,0,0,3,26
1983813,1555264,2025-04-23,House,"House: Third Reading RCS#173",114,0,5,0,119
1983813,1562539,2025-04-30,Senate,"Senate: Third Reading RCS#49",37,0,0,1,38
1983813,1563429,2025-05-01,House,"House: Third Reading RCS#391",110,0,9,0,119
1983822,1526013,2025-03-25,House,"House Careers & Workforce Subcommittee",15,0,0,3,18
1983822,1540264,2025-04-08,House,"House Higher Education Budget Subcommittee",14,0,0,1,15
1983822,1551299,2025-04-17,House,"House Education & Employment Committee",19,0,0,4,23
1983822,1556658,2025-04-24,House,"House: Third Reading RCS#197",115,0,4,0,119
1983822,1563412,2025-05-01,Senate,"Senate: Third Reading RCS#3",38,0,0,0,38
1983822,1564661,2025-05-02,House,"House: Third Reading RCS#415",85,14,20,0,119
1983822,1564744,2025-05-02,Senate,"Senate: Third Reading RCS#21",26,5,4,3,38
1983907,1520891,2025-03-19,House,"House Education Administration Subcommittee",15,0,0,3,18
1983907,1527690,2025-03-26,House,"House Education & Employment Committee",18,1,0,3,22
1983927,1513129,2025-03-11,House,"House Human Services Subcommittee",18,0,0,0,18
1983927,1521171,2025-03-19,House,"House Health Care Budget Subcommittee",14,0,0,1,15
1983927,1553604,2025-04-22,House,"House Health & Human Services Committee",22,0,0,5,27
1983946,1532479,2025-04-01,House,"House Human Services Subcommittee",12,5,0,1,18
1983946,1541853,2025-04-09,House,"House Intergovernmental Affairs Subcommittee",11,4,0,3,18
1983946,1553338,2025-04-22,House,"House Health & Human Services Committee",15,6,0,6,27
1983968,1534011,2025-04-01,Senate,"Senate Health Policy",6,3,0,1,10
1983968,1544527,2025-04-10,Senate,"Senate Appropriations Committee on Health and Human Services",5,3,0,2,10
1983968,1553352,2025-04-21,Senate,"Senate Rules",17,6,0,2,25
1983996,1532868,2025-04-01,House,"House Natural Resources & Disasters Subcommittee",16,0,0,2,18
1983996,1540468,2025-04-08,House,"House Ways & Means Committee",16,0,0,3,19
1983996,1553672,2025-04-22,House,"House State Affairs Committee",19,7,0,2,28
1984006,1520809,2025-03-18,House,"House Housing, Agriculture & Tourism Subcommittee",13,4,0,1,18
1984006,1531457,2025-03-31,House,"House Commerce Committee",15,3,0,8,26
1984006,1549870,2025-04-16,House,"House: Third Reading RCS#107",83,31,5,0,119
1984041,1528019,2025-03-25,Senate,"Senate Military and Veterans Affairs, Space, and Domestic Security",6,0,0,0,6
1984062,1520220,2025-03-18,Senate,"Senate Criminal Justice",9,0,0,0,9
1984062,1544743,2025-04-10,Senate,"Senate Appropriations Committee on Criminal and Civil Justice",8,0,0,1,9
1984062,1555347,2025-04-22,Senate,"Senate Fiscal Policy",18,0,0,1,19
1984064,1520847,2025-03-19,Senate,"Senate Regulated Industries",8,0,0,1,9
1984070,1520209,2025-03-18,House,"House Student Academic Success Subcommittee",16,0,0,2,18
1984070,1521192,2025-03-18,House,"House Student Academic Success Subcommittee",16,0,0,2,18
1984070,1524139,2025-03-18,House,"House Student Academic Success Subcommittee",16,0,0,2,18
1984070,1534509,2025-04-02,House,"House Education & Employment Committee",18,0,0,4,22
1984091,1521266,2025-03-19,Senate,"Senate Transportation",9,0,0,0,9
1984091,1528147,2025-03-26,Senate,"Senate Finance and Tax",6,0,0,0,6
1984091,1552043,2025-04-17,Senate,"Senate Appropriations",15,0,0,3,18
1984094,1520757,2025-03-19,Senate,"Senate Transportation",9,0,0,0,9
1984094,1527947,2025-03-26,Senate,"Senate Finance and Tax",5,1,0,0,6
1984094,1552033,2025-04-17,Senate,"Senate Appropriations",15,1,0,2,18
1984120,1521101,2025-03-19,Senate,"Senate Regulated Industries",8,0,0,1,9
1984138,1526469,2025-03-25,Senate,"Senate Environment and Natural Resources",7,0,0,2,9
1984138,1543757,2025-04-10,Senate,"Senate Appropriations Committee on Agriculture, Environment, and General Government",11,0,0,1,12
1984138,1550060,2025-04-16,Senate,"Senate Rules",23,0,0,2,25
1984144,1531475,2025-03-31,Senate,"Senate Education Pre-K - 12",9,0,0,0,9
1984155,1526463,2025-03-25,Senate,"Senate Education Pre-K - 12",5,4,0,0,9
1984155,1534009,2025-04-01,Senate,"Senate Judiciary",8,3,0,0,11
1984155,1553251,2025-04-21,Senate,"Senate Rules",13,9,0,3,25
1984167,1526811,2025-03-25,House,"House Natural Resources & Disasters Subcommittee",16,0,0,2,18
1984167,1532469,2025-04-01,House,"House Criminal Justice Subcommittee",16,0,0,2,18
1984167,1539334,2025-04-08,House,"House State Affairs Committee",23,0,0,3,26
1984167,1549614,2025-04-16,House,"House: Third Reading RCS#102",116,0,3,0,119
1984167,1553965,2025-04-22,Senate,"Senate Appropriations",17,0,0,1,18
1984167,1559959,2025-04-29,Senate,"Senate: Third Reading RCS#23",36,2,0,0,38
1984169,1533886,2025-04-01,Senate,"Senate Judiciary",9,0,0,2,11
1984179,1515891,2025-03-12,House,"House Economic Infrastructure Subcommittee",18,0,0,0,18
1984179,1532269,2025-04-01,House,"House Intergovernmental Affairs Subcommittee",15,1,0,2,18
1984179,1549579,2025-04-15,House,"House Commerce Committee",23,0,0,3,26
1984179,1555076,2025-04-23,House,"House: Third Reading RCS#154",109,5,5,0,119
1984179,1558805,2025-04-28,Senate,"Senate: Third Reading RCS#14",36,0,0,2,38
1984203,1522106,2025-03-19,House,"House Economic Infrastructure Subcommittee",17,0,0,1,18
1984203,1534496,2025-04-02,House,"House Transportation & Economic Development Budget Subcommittee",13,0,0,2,15
1984212,1526176,2025-03-25,Senate,"Senate Environment and Natural Resources",8,0,0,1,9
1984212,1544161,2025-04-10,Senate,"Senate Appropriations Committee on Agriculture, Environment, and General Government",11,0,0,1,12
1984230,1531025,2025-03-31,Senate,"Senate Commerce and Tourism",9,0,0,0,9
1984254,1534078,2025-04-01,Senate,"Senate Children, Families, and Elder Affairs",6,0,0,1,7
1984254,1551200,2025-04-17,Senate,"Senate Fiscal Policy",16,0,0,3,19
1984266,1527708,2025-03-25,Senate,"Senate Military and Veterans Affairs, Space, and Domestic Security",6,0,0,0,6
1984274,1521839,2025-03-19,House,"House Intergovernmental Affairs Subcommittee",17,0,0,1,18
1984274,1526227,2025-03-25,House,"House Economic Infrastructure Subcommittee",15,0,0,3,18
1984274,1551985,2025-04-17,House,"House State Affairs Committee",23,0,0,3,26
1984274,1558060,2025-04-25,House,"House: Third Reading RCS#258",111,0,8,0,119
1984274,1564446,2025-05-02,Senate,"Senate: Third Reading RCS#3",37,0,0,1,38
1984282,1521448,2025-03-19,House,"House Industries & Professional Activities Subcommittee",14,0,0,4,18
1984282,1527825,2025-03-26,House,"House Judiciary Committee",20,0,0,2,22
1984282,1538761,2025-04-07,House,"House Commerce Committee",24,0,0,2,26
1984282,1549616,2025-04-16,House,"House: Third Reading RCS#120",116,0,3,0,119
1984282,1555246,2025-04-23,Senate,"Senate: Third Reading RCS#28",38,0,0,0,38
1984295,1526854,2025-03-25,House,"House Natural Resources & Disasters Subcommittee",15,1,0,2,18
1984295,1532136,2025-04-01,House,"House Criminal Justice Subcommittee",15,0,0,3,18
1984295,1551053,2025-04-17,House,"House State Affairs Committee",22,1,0,3,26
1984309,1527901,2025-03-26,House,"House Criminal Justice Subcommittee",18,0,0,0,18
1984318,1533872,2025-04-01,Senate,"Senate Judiciary",6,4,0,1,11
1984318,1544431,2025-04-10,Senate,"Senate Appropriations Committee on Criminal and Civil Justice",5,3,0,1,9
1984338,1520335,2025-03-18,Senate,"Senate Appropriations Committee on Agriculture, Environment, and General Government",12,0,0,1,13
1984338,1535404,2025-04-02,Senate,"Senate Appropriations",18,0,0,0,18
1984348,1515869,2025-03-12,Senate,"Senate Transportation",9,0,0,0,9
1984348,1527584,2025-03-26,Senate,"Senate Appropriations Committee on Transportation, Tourism, and Economic Development",15,0,0,0,15
1984348,1532280,2025-04-01,Senate,"Senate Rules",22,2,0,1,25
1984348,1541902,2025-04-09,Senate,"Senate: Third Reading RCS#55",29,7,0,2,38
1984362,1520823,2025-03-19,Senate,"Senate Children, Families, and Elder Affairs",6,0,0,1,7
1984362,1525904,2025-03-24,Senate,"Senate Appropriations Committee on Criminal and Civil Justice",9,0,0,0,9
1984362,1532291,2025-04-01,Senate,"Senate Rules",25,0,0,0,25
1984362,1541748,2025-04-09,Senate,"Senate: Third Reading RCS#54",36,0,0,2,38
1984362,1560350,2025-04-29,House,"House: Third Reading RCS#316",116,0,3,0,119
1984376,1531376,2025-03-31,Senate,"Senate Education Pre-K - 12",9,0,0,0,9
1984376,1545882,2025-04-10,Senate,"Senate Appropriations Committee on Pre-K - 12 Education",8,0,0,1,9
1984376,1552738,2025-04-21,Senate,"Senate Rules",23,0,0,2,25
1984383,1516503,2025-03-12,House,"House Careers & Workforce Subcommittee",16,0,0,2,18
1984383,1517011,2025-03-12,House,"House Careers & Workforce Subcommittee",16,0,0,2,18
1984383,1519977,2025-03-18,House,"House Higher Education Budget Subcommittee",13,1,0,1,15
1984383,1527514,2025-03-26,House,"House Education & Employment Committee",18,0,0,4,22
1984383,1536003,2025-04-03,House,"House: Third Reading RCS#38",100,4,15,0,119
1984383,1559871,2025-04-29,Senate,"Senate: Third Reading RCS#8",37,0,1,0,38
1984396,1526657,2025-03-25,House,"House Natural Resources & Disasters Subcommittee",16,0,0,2,18
1984396,1539525,2025-04-08,House,"House State Affairs Committee",23,0,0,3,26
1984396,1549661,2025-04-16,House,"House: Third Reading RCS#101",116,0,3,0,119
1984396,1555315,2025-04-23,Senate,"Senate: Third Reading RCS#29",37,1,0,0,38
1984396,1562087,2025-04-30,House,"House: Third Reading RCS#365",109,0,10,0,119
1984439,1523723,2025-03-20,House,"House Civil Justice & Claims Subcommittee",14,2,0,2,18
1984439,1529579,2025-03-27,House,"House Insurance & Banking Subcommittee",16,0,0,2,18
1984439,1535445,2025-04-02,House,"House Judiciary Committee",17,0,0,5,22
1984439,1541814,2025-04-09,House,"House: Third Reading RCS#74",107,3,9,0,119
1984439,1550343,2025-04-16,Senate,"Senate: Third Reading RCS#2",32,4,1,1,38
1984447,1529127,2025-03-27,House,"House Health Care Facilities & Systems Subcommittee",15,0,0,3,18
1984447,1541525,2025-04-09,House,"House Health Care Budget Subcommittee",13,0,0,2,15
1984447,1548842,2025-04-15,House,"House Health & Human Services Committee",24,0,0,2,26
1984447,1555428,2025-04-23,House,"House: Third Reading RCS#177",115,0,4,0,119
1984461,1533964,2025-04-01,Senate,"Senate Health Policy",10,0,0,0,10
1984461,1544249,2025-04-10,Senate,"Senate Appropriations Committee on Health and Human Services",8,0,0,2,10
1984461,1549858,2025-04-16,Senate,"Senate Rules",22,0,0,3,25
1984523,1526782,2025-03-25,Senate,"Senate Children, Families, and Elder Affairs",5,0,0,2,7
1984523,1544086,2025-04-10,Senate,"Senate Appropriations Committee on Health and Human Services",8,0,0,2,10
1984523,1555372,2025-04-22,Senate,"Senate Fiscal Policy",18,0,0,1,19
1984540,1531565,2025-03-31,Senate,"Senate Ethics and Elections",8,0,0,1,9
1984566,1529261,2025-03-27,House,"House Health Care Facilities & Systems Subcommittee",16,0,0,2,18
1984566,1538567,2025-04-07,House,"House Health & Human Services Committee",24,0,0,2,26
1984566,1549538,2025-04-16,House,"House: Third Reading RCS#92",114,0,5,0,119
1984566,1549922,2025-04-16,Senate,"Senate: Third Reading RCS#12",37,0,0,1,38
1984595,1518925,2025-03-17,Senate,"Senate Education Pre-K - 12",9,0,0,0,9
1984595,1529167,2025-03-26,Senate,"Senate Appropriations Committee on Pre-K - 12 Education",9,0,0,1,10
1984595,1534384,2025-04-02,Senate,"Senate Fiscal Policy",17,0,0,2,19
1984595,1542442,2025-04-09,Senate,"Senate: Third Reading RCS#57",36,0,0,2,38
1984595,1560031,2025-04-29,House,"House: Third Reading RCS#294",116,0,3,0,119
1984625,1522504,2025-03-20,House,"House Ways & Means Committee",16,1,0,2,19
1984625,1534367,2025-04-01,House,"House Housing, Agriculture & Tourism Subcommittee",15,0,0,3,18
1984625,1553585,2025-04-22,House,"House State Affairs Committee",22,4,0,2,28
1984625,1558101,2025-04-25,House,"House: Third Reading RCS#256",110,1,8,0,119
1984625,1564440,2025-05-02,Senate,"Senate: Third Reading RCS#5",37,0,0,1,38
1984663,1532757,2025-04-01,House,"House Human Services Subcommittee",16,0,0,2,18
1984663,1539523,2025-04-08,House,"House Judiciary Committee",18,0,0,4,22
1984663,1548638,2025-04-15,House,"House Health & Human Services Committee",22,0,0,4,26
1984671,1520893,2025-03-19,Senate,"Senate Regulated Industries",8,0,0,1,9
1984688,1521241,2025-03-18,Senate,"Senate Health Policy",9,0,0,1,10
1984688,1527978,2025-03-26,Senate,"Senate Appropriations Committee on Health and Human Services",10,0,0,0,10
1984688,1532147,2025-04-01,Senate,"Senate Rules",24,0,0,1,25
1984688,1542468,2025-04-09,Senate,"Senate: Third Reading RCS#56",36,0,0,2,38
1984764,1529250,2025-03-27,House,"House Education Administration Subcommittee",17,0,0,1,18
1984764,1540174,2025-04-08,House,"House PreK-12 Budget Subcommittee",15,0,0,0,15
1984764,1551209,2025-04-17,House,"House Education & Employment Committee",18,0,0,5,23
1984764,1556591,2025-04-24,House,"House: Third Reading RCS#200",114,0,5,0,119
1984810,1518692,2025-03-17,Senate,"Senate Commerce and Tourism",9,0,0,0,9
1984810,1532617,2025-04-01,Senate,"Senate Criminal Justice",9,0,0,0,9
1984810,1540234,2025-04-08,Senate,"Senate Rules",24,0,0,1,25
1984840,1520328,2025-03-18,House,"House Student Academic Success Subcommittee",15,0,0,3,18
1984840,1521876,2025-03-18,House,"House Student Academic Success Subcommittee",15,0,0,3,18
1984840,1524265,2025-03-18,House,"House Student Academic Success Subcommittee",15,0,0,3,18
1984889,1534495,2025-04-01,House,"House Industries & Professional Activities Subcommittee",12,6,0,1,19
1984889,1551069,2025-04-17,House,"House Education & Employment Committee",14,6,0,3,23
1984889,1553598,2025-04-22,House,"House Commerce Committee",15,7,0,5,27
1984889,1558307,2025-04-25,House,"House: Third Reading RCS#264",78,30,11,0,119
1984901,1534355,2025-04-01,Senate,"Senate Transportation",9,0,0,0,9
1984901,1549863,2025-04-15,Senate,"Senate Appropriations Committee on Transportation, Tourism, and Economic Development",15,0,0,0,15
1984901,1553819,2025-04-22,Senate,"Senate Appropriations",17,0,0,1,18
1984946,1527026,2025-03-25,Senate,"Senate Environment and Natural Resources",8,0,0,1,9
1984946,1544851,2025-04-10,Senate,"Senate Appropriations Committee on Agriculture, Environment, and General Government",11,0,0,1,12
1984946,1555507,2025-04-22,Senate,"Senate Fiscal Policy",18,0,0,1,19
1984946,1559037,2025-04-28,Senate,"Senate: Third Reading RCS#4",35,0,1,2,38
1984946,1563093,2025-04-30,House,"House: Third Reading RCS#389",104,7,8,0,119
1984946,1564311,2025-05-01,Senate,"Senate: Third Reading RCS#16",35,2,1,0,38
1984969,1527827,2025-03-25,Senate,"Senate Transportation",8,0,0,1,9
1984969,1532368,2025-04-01,Senate,"Senate Criminal Justice",9,0,0,0,9
1984969,1540619,2025-04-08,Senate,"Senate Rules",24,0,0,1,25
1984979,1526865,2025-03-25,Senate,"Senate Regulated Industries",8,0,0,1,9
1984979,1548581,2025-04-15,Senate,"Senate Appropriations Committee on Agriculture, Environment, and General Government",12,0,0,0,12
1984993,1520994,2025-03-19,Senate,"Senate Transportation",9,0,0,0,9
1984993,1527394,2025-03-26,Senate,"Senate Appropriations Committee on Transportation, Tourism, and Economic Development",14,0,0,1,15
1984993,1551756,2025-04-17,Senate,"Senate Fiscal Policy",17,0,0,2,19
1985026,1523003,2025-03-20,House,"House Ways & Means Committee",13,4,0,2,19
1985026,1542121,2025-04-09,House,"House Intergovernmental Affairs Subcommittee",10,7,0,1,18
1985026,1553679,2025-04-22,House,"House State Affairs Committee",14,12,0,2,28
1985026,1558114,2025-04-25,House,"House: Third Reading RCS#247",62,45,12,0,119
1985042,1507781,2025-03-06,House,"House Government Operations Subcommittee",14,4,0,0,18
1985042,1527815,2025-03-26,House,"House State Affairs Committee",18,7,0,2,27
1985042,1536108,2025-04-03,House,"House: Third Reading RCS#41",76,31,12,0,119
1985042,1562066,2025-04-30,Senate,"Senate: Third Reading RCS#5",10,26,1,1,38
1985042,1563439,2025-05-01,Senate,"Senate: Third Reading RCS#2",28,10,0,0,38
1985042,1563814,2025-05-01,House,"House: Third Reading RCS#402",27,82,10,0,119
1985042,1563815,2025-05-01,House,"House: Third Reading RCS#403",81,30,8,0,119
1985042,1564585,2025-05-02,Senate,"Senate: Third Reading RCS#10",28,9,0,1,38
1985088,1541459,2025-04-09,House,"House Intergovernmental Affairs Subcommittee",12,4,0,2,18
1985101,1533382,2025-04-01,House,"House Government Operations Subcommittee",15,0,0,4,19
1985119,1521297,2025-03-19,House,"House Industries & Professional Activities Subcommittee",11,5,0,2,18
1985119,1534965,2025-04-02,House,"House Judiciary Committee",18,1,0,3,22
1985119,1549859,2025-04-15,House,"House Commerce Committee",15,6,0,5,26
1985119,1555433,2025-04-23,House,"House: Third Reading RCS#166",91,21,7,0,119
1985119,1557039,2025-04-24,Senate,"Senate: Third Reading RCS#51",28,9,0,1,38
1985130,1534871,2025-04-02,House,"House Education Administration Subcommittee",17,0,0,1,18
1985130,1539674,2025-04-08,House,"House Education & Employment Committee",16,0,0,6,22
1985146,1515087,2025-03-11,Senate,"Senate Agriculture",6,0,0,0,6
1985146,1528372,2025-03-26,Senate,"Senate Appropriations Committee on Agriculture, Environment, and General Government",12,0,0,1,13
1985146,1534229,2025-04-02,Senate,"Senate Fiscal Policy",17,0,0,2,19
1985146,1542602,2025-04-09,Senate,"Senate: Third Reading RCS#4",36,0,1,1,38
1985165,1518840,2025-03-17,Senate,"Senate Education Pre-K - 12",8,0,0,1,9
1985165,1545725,2025-04-10,Senate,"Senate Appropriations Committee on Pre-K - 12 Education",8,0,0,1,9
1985165,1555038,2025-04-22,Senate,"Senate Fiscal Policy",18,0,0,1,19
1985213,1521324,2025-03-19,House,"House Criminal Justice Subcommittee",16,0,0,2,18
1985213,1533028,2025-04-01,House,"House Human Services Subcommittee",15,0,0,3,18
1985213,1551054,2025-04-17,House,"House Judiciary Committee",20,0,0,2,22
1985242,1522129,2025-03-19,House,"House Criminal Justice Subcommittee",16,0,0,2,18
1985274,1525795,2025-03-25,House,"House Information Technology Budget & Policy Subcommittee",14,2,0,2,18
1985274,1535768,2025-04-03,House,"House Civil Justice & Claims Subcommittee",13,1,0,5,19
1985288,1529078,2025-03-27,House,"House Civil Justice & Claims Subcommittee",13,2,0,3,18
1985288,1536386,2025-04-03,House,"House Insurance & Banking Subcommittee",17,1,0,0,18
1985318,1519569,2025-03-18,House,"House Natural Resources & Disasters Subcommittee",12,3,0,3,18
1985318,1535020,2025-04-02,House,"House State Affairs Committee",17,6,0,3,26
1985332,1527370,2025-03-25,Senate,"Senate Health Policy",10,0,0,0,10
1985332,1533933,2025-04-01,Senate,"Senate Judiciary",11,0,0,0,11
1985332,1540453,2025-04-08,Senate,"Senate Rules",24,0,0,1,25
1985349,1520213,2025-03-18,Senate,"Senate Criminal Justice",8,1,0,0,9
1985349,1549522,2025-04-15,Senate,"Senate Appropriations Committee on Criminal and Civil Justice",8,0,0,1,9
1985349,1555059,2025-04-22,Senate,"Senate Fiscal Policy",15,3,0,1,19
1985410,1526409,2025-03-25,Senate,"Senate Criminal Justice",9,0,0,0,9
1985410,1545359,2025-04-10,Senate,"Senate Appropriations Committee on Criminal and Civil Justice",8,0,0,1,9
1985410,1551127,2025-04-17,Senate,"Senate Fiscal Policy",17,0,0,2,19
1985410,1556485,2025-04-24,Senate,"Senate: Third Reading RCS#12",37,0,0,1,38
1985410,1562435,2025-04-30,House,"House: Third Reading RCS#360",113,0,6,0,119
1985442,1518861,2025-03-17,Senate,"Senate Education Pre-K - 12",9,0,0,0,9
1985442,1533204,2025-04-01,Senate,"Senate Criminal Justice",9,0,0,0,9
1985442,1540762,2025-04-08,Senate,"Senate Rules",24,0,0,1,25
1985442,1549907,2025-04-16,Senate,"Senate: Third Reading RCS#3",36,0,1,1,38
1985442,1559809,2025-04-29,House,"House: Third Reading RCS#296",115,0,4,0,119
1985481,1526429,2025-03-25,Senate,"Senate Criminal Justice",9,0,0,0,9
1985481,1545449,2025-04-10,Senate,"Senate Appropriations Committee on Criminal and Civil Justice",8,0,0,1,9
1985481,1551238,2025-04-17,Senate,"Senate Fiscal Policy",17,0,0,2,19
1985481,1556577,2025-04-24,Senate,"Senate: Third Reading RCS#13",36,0,1,1,38
1985481,1560332,2025-04-29,House,"House: Third Reading RCS#317",114,0,5,0,119
1985490,1521242,2025-03-17,Senate,"Senate Education Postsecondary",7,0,0,0,7
1985490,1527422,2025-03-26,Senate,"Senate Appropriations Committee on Health and Human Services",10,0,0,0,10
1985490,1534331,2025-04-02,Senate,"Senate Fiscal Policy",18,0,0,1,19
1985540,1525943,2025-03-25,House,"House Economic Infrastructure Subcommittee",15,1,0,2,18
1985540,1553638,2025-04-22,House,"House Commerce Committee",25,0,0,2,27
1985563,1520848,2025-03-18,Senate,"Senate Military and Veterans Affairs, Space, and Domestic Security",5,0,0,1,6
1985598,1526735,2025-03-25,Senate,"Senate Judiciary",11,0,0,0,11
1985598,1532786,2025-04-01,Senate,"Senate Criminal Justice",8,0,0,1,9
1985598,1541196,2025-04-08,Senate,"Senate Rules",24,0,0,1,25
1985598,1548406,2025-04-15,Senate,"Senate: Third Reading RCS#4",36,0,0,2,38
1985598,1561245,2025-04-29,House,"House: Third Reading RCS#306",115,0,4,0,119
1985601,1529169,2025-03-27,House,"House Education Administration Subcommittee",13,4,0,1,18
1985601,1539864,2025-04-08,House,"House PreK-12 Budget Subcommittee",13,2,0,0,15
1985601,1551050,2025-04-17,House,"House Education & Employment Committee",13,5,0,5,23
1985601,1554982,2025-04-23,House,"House: Third Reading RCS#157",86,27,6,0,119
1985603,1520603,2025-03-18,Senate,"Senate Criminal Justice",9,0,0,0,9
1985603,1545981,2025-04-10,Senate,"Senate Appropriations Committee on Criminal and Civil Justice",8,0,0,1,9
1985603,1550697,2025-04-16,Senate,"Senate Rules",22,0,0,3,25
1985621,1521006,2025-03-19,House,"House Education Administration Subcommittee",16,0,0,2,18
1985621,1545333,2025-04-10,House,"House Housing, Agriculture & Tourism Subcommittee",17,0,0,1,18
1985626,1523144,2025-03-20,House,"House Insurance & Banking Subcommittee",15,0,0,3,18
1985637,1514614,2025-03-11,Senate,"Senate Education Pre-K - 12",9,0,0,0,9
1985637,1526668,2025-03-24,Senate,"Senate Appropriations Committee on Pre-K - 12 Education",8,0,0,2,10
1985637,1534207,2025-04-02,Senate,"Senate Fiscal Policy",15,0,0,4,19
1985637,1542258,2025-04-09,Senate,"Senate: Third Reading RCS#58",36,0,0,2,38
1985637,1562136,2025-04-30,House,"House: Third Reading RCS#358",110,0,9,0,119
1985637,1563528,2025-05-01,Senate,"Senate: Third Reading RCS#11",37,0,1,0,38
1985664,1533563,2025-03-31,Senate,"Senate Banking and Insurance",10,0,0,0,10
1985682,1520473,2025-03-18,House,"House Student Academic Success Subcommittee",15,2,0,1,18
1985682,1520931,2025-03-18,House,"House Student Academic Success Subcommittee",15,2,0,1,18
1985682,1524069,2025-03-18,House,"House Student Academic Success Subcommittee",15,2,0,1,18
1985682,1532933,2025-04-01,House,"House PreK-12 Budget Subcommittee",12,1,0,2,15
1985682,1551417,2025-04-17,House,"House Education & Employment Committee",17,4,0,2,23
1985682,1555389,2025-04-23,House,"House: Third Reading RCS#158",86,27,6,0,119
1985682,1563589,2025-05-01,Senate,"Senate: Third Reading RCS#4",38,0,0,0,38
1985682,1564700,2025-05-02,House,"House: Third Reading RCS#414",100,0,19,0,119
1985682,1564701,2025-05-02,Senate,"Senate: Third Reading RCS#19",30,0,5,3,38
1985684,1532485,2025-04-01,Senate,"Senate Criminal Justice",9,0,0,0,9
1985684,1549490,2025-04-15,Senate,"Senate Appropriations Committee on Criminal and Civil Justice",9,0,0,0,9
1985684,1555273,2025-04-22,Senate,"Senate Fiscal Policy",19,0,0,0,19
1985703,1528856,2025-03-27,House,"House Ways & Means Committee",14,4,0,1,19
1985703,1534226,2025-04-01,House,"House Housing, Agriculture & Tourism Subcommittee",9,4,0,5,18
1985703,1554061,2025-04-22,House,"House Commerce Committee",19,6,0,2,27
1985703,1558008,2025-04-25,House,"House: Third Reading RCS#249",79,28,12,0,119
1985708,1535398,2025-04-02,House,"House Education Administration Subcommittee",16,0,0,2,18
1985708,1540691,2025-04-08,House,"House Education & Employment Committee",17,0,0,5,22
1985708,1557057,2025-04-24,House,"House: Third Reading RCS#203",111,0,8,0,119
1985708,1559142,2025-04-28,Senate,"Senate: Third Reading RCS#20",35,0,0,3,38
1985708,1562507,2025-04-30,House,"House: Third Reading RCS#368",113,0,6,0,119
1985713,1532720,2025-04-01,Senate,"Senate Criminal Justice",9,0,0,0,9
1985713,1549521,2025-04-15,Senate,"Senate Appropriations Committee on Criminal and Civil Justice",9,0,0,0,9
1985713,1553089,2025-04-21,Senate,"Senate Rules",23,0,0,2,25
1985717,1531060,2025-03-31,Senate,"Senate Education Postsecondary",5,0,0,2,7
1985717,1545990,2025-04-10,Senate,"Senate Appropriations Committee on Higher Education",7,0,0,1,8
1985717,1554002,2025-04-22,Senate,"Senate Fiscal Policy",19,0,0,0,19
1985733,1514820,2025-03-11,Senate,"Senate Education Pre-K - 12",7,2,0,0,9
1985733,1526137,2025-03-24,Senate,"Senate Appropriations Committee on Pre-K - 12 Education",7,1,0,2,10
1985733,1534562,2025-04-02,Senate,"Senate Fiscal Policy",15,0,0,4,19
1985733,1541896,2025-04-09,Senate,"Senate: Third Reading RCS#59",34,2,0,2,38
1985751,1529341,2025-03-27,House,"House Ways & Means Committee",14,4,0,1,19
1985751,1534163,2025-04-01,House,"House Housing, Agriculture & Tourism Subcommittee",9,4,0,5,18
1985751,1554078,2025-04-22,House,"House Commerce Committee",18,6,0,3,27
1985751,1557992,2025-04-25,House,"House: Third Reading RCS#248",80,28,11,0,119
1985766,1522071,2025-03-19,House,"House Careers & Workforce Subcommittee",18,0,0,0,18
1986343,1522207,2025-03-19,Senate,"Senate Transportation",9,0,0,0,9
1986356,1523116,2025-03-20,House,"House Health Professions & Programs Subcommittee",18,0,0,0,18
1986356,1531252,2025-03-31,House,"House Health & Human Services Committee",19,7,0,1,27
1986356,1542388,2025-04-09,House,"House: Third Reading RCS#86",69,37,13,0,119
1986371,1526288,2025-03-25,Senate,"Senate Community Affairs",7,1,0,0,8
1986371,1548379,2025-04-15,Senate,"Senate Finance and Tax",5,0,0,1,6
1986428,1518663,2025-03-17,Senate,"Senate Commerce and Tourism",6,3,0,0,9
1986428,1528001,2025-03-26,Senate,"Senate Rules",20,4,0,1,25
1986439,1526844,2025-03-25,House,"House Natural Resources & Disasters Subcommittee",16,0,0,2,18
1986439,1532107,2025-04-01,House,"House Criminal Justice Subcommittee",15,0,0,3,18
1986439,1551382,2025-04-17,House,"House State Affairs Committee",22,0,0,4,26
1986443,1526324,2025-03-25,Senate,"Senate Education Pre-K - 12",9,0,0,0,9
1986443,1549531,2025-04-15,Senate,"Senate Appropriations Committee on Pre-K - 12 Education",8,0,0,1,9
1986443,1553118,2025-04-21,Senate,"Senate Rules",22,0,0,3,25
1986443,1557033,2025-04-24,Senate,"Senate: Third Reading RCS#35",37,0,0,1,38
1986443,1562327,2025-04-30,House,"House: Third Reading RCS#356",113,0,6,0,119
1986539,1528572,2025-03-27,House,"House Health Professions & Programs Subcommittee",16,0,0,2,18
1986539,1548601,2025-04-15,House,"House Health & Human Services Committee",22,0,0,4,26
1986539,1555660,2025-04-23,House,"House: Third Reading RCS#191",114,1,4,0,119
1986539,1562500,2025-04-30,Senate,"Senate: Third Reading RCS#48",37,0,0,1,38
1986539,1564549,2025-05-02,House,"House: Third Reading RCS#405",113,0,6,0,119
1986578,1515663,2025-03-12,House,"House Agriculture & Natural Resources Budget Subcommittee",14,0,0,1,15
1986578,1523414,2025-03-20,House,"House Budget Committee",27,0,0,3,30
1986578,1536012,2025-04-03,House,"House: Third Reading RCS#52",108,0,11,0,119
1986578,1542640,2025-04-09,Senate,"Senate: Third Reading RCS#11",37,0,0,1,38
1986594,1522151,2025-03-19,House,"House Education Administration Subcommittee",15,0,0,3,18
1986594,1540687,2025-04-08,House,"House Education & Employment Committee",15,0,0,7,22
1986594,1549714,2025-04-16,House,"House: Third Reading RCS#99",104,8,7,0,119
1986613,1520928,2025-03-18,Senate,"Senate Military and Veterans Affairs, Space, and Domestic Security",5,0,0,1,6
1986613,1546047,2025-04-10,Senate,"Senate Appropriations Committee on Pre-K - 12 Education",8,0,0,1,9
1986613,1556118,2025-04-22,Senate,"Senate Fiscal Policy",19,0,0,0,19
1986613,1559572,2025-04-28,Senate,"Senate: Third Reading RCS#15",36,0,0,2,38
1986621,1522011,2025-03-19,House,"House Criminal Justice Subcommittee",13,2,0,3,18
1986621,1533698,2025-04-01,House,"House Justice Budget Subcommittee",9,3,0,3,15
1986621,1539445,2025-04-08,House,"House Judiciary Committee",15,3,0,4,22
1986692,1535389,2025-04-02,House,"House Education Administration Subcommittee",13,4,0,1,18
1986692,1540005,2025-04-08,House,"House Education & Employment Committee",13,4,0,5,22
1986700,1533983,2025-04-01,Senate,"Senate Health Policy",10,0,0,0,10
1986700,1544264,2025-04-10,Senate,"Senate Appropriations Committee on Health and Human Services",8,0,0,2,10
1986700,1553781,2025-04-22,Senate,"Senate Fiscal Policy",17,0,0,2,19
1986700,1557064,2025-04-24,Senate,"Senate: Third Reading RCS#36",37,0,0,1,38
1986700,1562365,2025-04-30,House,"House: Third Reading RCS#353",112,0,7,0,119
1986709,1520562,2025-03-18,House,"House Student Academic Success Subcommittee",15,0,0,3,18
1986709,1521127,2025-03-18,House,"House Student Academic Success Subcommittee",15,0,0,3,18
1986709,1524112,2025-03-18,House,"House Student Academic Success Subcommittee",15,0,0,3,18
1986709,1529053,2025-03-27,House,"House Budget Committee",25,0,0,5,30
1986709,1534964,2025-04-02,House,"House Education & Employment Committee",17,0,0,5,22
1986709,1549533,2025-04-16,House,"House: Third Reading RCS#93",117,0,2,0,119
1986870,1533049,2025-04-01,Senate,"Senate Governmental Oversight and Accountability",5,2,0,0,7
1986883,1520781,2025-03-18,Senate,"Senate Military and Veterans Affairs, Space, and Domestic Security",5,0,0,1,6
1986883,1527661,2025-03-26,Senate,"Senate Appropriations Committee on Transportation, Tourism, and Economic Development",14,0,0,1,15
1986883,1535218,2025-04-02,Senate,"Senate Fiscal Policy",18,0,0,1,19
1986883,1543176,2025-04-09,Senate,"Senate: Third Reading RCS#60",36,0,0,2,38
1986883,1560620,2025-04-29,House,"House: Third Reading RCS#279",115,0,4,0,119
1986891,1526157,2025-03-25,Senate,"Senate Community Affairs",7,1,0,0,8
1986891,1548503,2025-04-15,Senate,"Senate Finance and Tax",5,0,0,1,6
1986936,1534050,2025-04-01,Senate,"Senate Health Policy",10,0,0,0,10
1986936,1548449,2025-04-15,Senate,"Senate Appropriations Committee on Health and Human Services",10,0,0,0,10
1986936,1555170,2025-04-22,Senate,"Senate Fiscal Policy",18,0,0,1,19
1986949,1531272,2025-03-31,Senate,"Senate Education Pre-K - 12",9,0,0,0,9
1986949,1545621,2025-04-10,Senate,"Senate Appropriations Committee on Pre-K - 12 Education",8,0,0,1,9
1986949,1551019,2025-04-17,Senate,"Senate Fiscal Policy",16,0,0,3,19
1986968,1513663,2025-03-11,House,"House Government Operations Subcommittee",14,3,0,1,18
1986968,1522543,2025-03-20,House,"House State Affairs Committee",17,8,0,1,26
1986968,1549934,2025-04-16,House,"House: Third Reading RCS#143",82,32,5,0,119
1987003,1521991,2025-03-19,House,"House Intergovernmental Affairs Subcommittee",16,0,0,2,18
1987003,1529166,2025-03-27,House,"House Ways & Means Committee",18,0,0,1,19
1987003,1535222,2025-04-02,House,"House State Affairs Committee",24,0,0,2,26
1987003,1549974,2025-04-16,House,"House: Third Reading RCS#123",115,0,4,0,119
1987003,1562018,2025-04-30,Senate,"Senate: Third Reading RCS#31",36,0,1,1,38
1987058,1532806,2025-04-01,House,"House Natural Resources & Disasters Subcommittee",16,0,0,2,18
1987091,1521682,2025-03-19,House,"House Health Care Facilities & Systems Subcommittee",17,0,0,1,18
1987091,1531140,2025-03-31,House,"House Health & Human Services Committee",25,0,0,2,27
1987091,1549803,2025-04-16,House,"House: Third Reading RCS#142",115,0,4,0,119
1987091,1555397,2025-04-23,Senate,"Senate: Third Reading RCS#26",37,0,1,0,38
1987125,1528949,2025-03-27,House,"House Ways & Means Committee",18,0,0,1,19
1987125,1542934,2025-04-09,House,"House Intergovernmental Affairs Subcommittee",17,0,0,1,18
1987146,1533889,2025-04-01,Senate,"Senate Regulated Industries",8,0,0,0,8
1987146,1548533,2025-04-15,Senate,"Senate Appropriations Committee on Agriculture, Environment, and General Government",12,0,0,0,12
1987146,1554063,2025-04-22,Senate,"Senate Fiscal Policy",19,0,0,0,19
1987146,1556688,2025-04-24,Senate,"Senate: Third Reading RCS#34",37,0,0,1,38
1987146,1562103,2025-04-30,House,"House: Third Reading RCS#344",112,0,7,0,119
1987196,1528092,2025-03-26,House,"House Intergovernmental Affairs Subcommittee",13,0,0,6,19
1987196,1533055,2025-04-01,House,"House Government Operations Subcommittee",16,0,0,3,19
1987196,1539724,2025-04-08,House,"House State Affairs Committee",21,0,0,5,26
1987196,1556987,2025-04-24,House,"House: Third Reading RCS#226",114,0,5,0,119
1987196,1562301,2025-04-30,Senate,"Senate: Third Reading RCS#32",36,0,1,1,38
1987215,1522146,2025-03-19,House,"House Criminal Justice Subcommittee",15,0,0,3,18
1987215,1525997,2025-03-25,House,"House Justice Budget Subcommittee",14,0,0,1,15
1987215,1534513,2025-04-02,House,"House Judiciary Committee",19,0,0,3,22
1987215,1549793,2025-04-16,House,"House: Third Reading RCS#132",114,0,5,0,119
1987215,1556928,2025-04-24,Senate,"Senate: Third Reading RCS#11",37,0,0,1,38
1987221,1541859,2025-04-09,House,"House Intergovernmental Affairs Subcommittee",16,0,0,2,18
1987221,1551738,2025-04-17,House,"House State Affairs Committee",21,0,0,5,26
1987221,1557706,2025-04-24,House,"House: Third Reading RCS#228",114,0,5,0,119
1987221,1562639,2025-04-30,Senate,"Senate: Third Reading RCS#30",36,0,1,1,38
1987236,1527499,2025-03-26,House,"House Criminal Justice Subcommittee",18,0,0,0,18
1987236,1540773,2025-04-08,House,"House Budget Committee",29,0,0,1,30
1987236,1551094,2025-04-17,House,"House Judiciary Committee",20,0,0,2,22
1987236,1558211,2025-04-25,House,"House: Third Reading RCS#257",111,0,8,0,119
1987236,1560460,2025-04-29,Senate,"Senate: Third Reading RCS#30",37,0,1,0,38
1987239,1527479,2025-03-26,House,"House Industries & Professional Activities Subcommittee",8,4,0,6,18
1987239,1543429,2025-04-10,House,"House Civil Justice & Claims Subcommittee",11,4,0,3,18
1987239,1553777,2025-04-22,House,"House Commerce Committee",19,6,0,2,27
1987250,1526165,2025-03-25,Senate,"Senate Environment and Natural Resources",8,0,0,1,9
1987250,1548239,2025-04-15,Senate,"Senate Appropriations Committee on Agriculture, Environment, and General Government",12,0,0,0,12
1987250,1553091,2025-04-21,Senate,"Senate Rules",23,0,0,2,25
1987276,1532091,2025-04-01,House,"House Criminal Justice Subcommittee",16,0,0,2,18
1987276,1548050,2025-04-15,House,"House Information Technology Budget & Policy Subcommittee",15,0,0,3,18
1987276,1551098,2025-04-17,House,"House Judiciary Committee",20,0,0,2,22
1987276,1557103,2025-04-24,House,"House: Third Reading RCS#242",113,0,6,0,119
1987276,1559788,2025-04-29,Senate,"Senate: Third Reading RCS#15",37,0,1,0,38
1987323,1545494,2025-04-10,House,"House Health Professions & Programs Subcommittee",13,4,0,1,18
1987323,1553450,2025-04-22,House,"House Health & Human Services Committee",18,4,0,5,27
1987331,1521786,2025-03-19,House,"House Intergovernmental Affairs Subcommittee",16,0,0,2,18
1987331,1535605,2025-04-03,House,"House Civil Justice & Claims Subcommittee",14,0,0,5,19
1987348,1521061,2025-03-19,House,"House Education Administration Subcommittee",15,1,0,2,18
1987348,1526769,2025-03-25,House,"House PreK-12 Budget Subcommittee",13,0,0,2,15
1987348,1534803,2025-04-02,House,"House Education & Employment Committee",18,0,0,4,22
1987348,1549731,2025-04-16,House,"House: Third Reading RCS#94",116,0,3,0,119
1987388,1529459,2025-03-27,House,"House Health Care Facilities & Systems Subcommittee",16,0,0,2,18
1987388,1540372,2025-04-08,House,"House Budget Committee",25,0,0,5,30
1987416,1532779,2025-04-01,House,"House Human Services Subcommittee",17,0,0,1,18
1987471,1533071,2025-04-01,House,"House Human Services Subcommittee",17,0,0,1,18
1987557,1521247,2025-03-18,Senate,"Senate Health Policy",9,0,0,1,10
1987557,1533094,2025-04-01,Senate,"Senate Criminal Justice",9,0,0,0,9
1987557,1540554,2025-04-08,Senate,"Senate Rules",24,0,0,1,25
1987557,1549735,2025-04-16,Senate,"Senate: Third Reading RCS#16",36,0,1,1,38
1987557,1560038,2025-04-29,House,"House: Third Reading RCS#290",115,0,4,0,119
1987557,1563489,2025-05-01,Senate,"Senate: Third Reading RCS#12",37,0,1,0,38
1987565,1526127,2025-03-25,Senate,"Senate Banking and Insurance",9,0,0,1,10
1987565,1548202,2025-04-15,Senate,"Senate Appropriations Committee on Health and Human Services",10,0,0,0,10
1987565,1555321,2025-04-22,Senate,"Senate Fiscal Policy",18,0,0,1,19
1987578,1527221,2025-03-25,Senate,"Senate Health Policy",7,3,0,0,10
1987578,1544471,2025-04-10,Senate,"Senate Appropriations Committee on Health and Human Services",8,0,0,2,10
1987578,1552740,2025-04-21,Senate,"Senate Rules",22,1,0,2,25
1987597,1505668,2025-03-04,Senate,"Senate Children, Families, and Elder Affairs",7,0,0,0,7
1987597,1516828,2025-03-13,Senate,"Senate Fiscal Policy",18,0,0,1,19
1987597,1521059,2025-03-19,Senate,"Senate: Third Reading RCS#14",39,0,0,0,39
1987597,1562617,2025-04-30,House,"House: Third Reading RCS#381",113,0,6,0,119
1987597,1563827,2025-05-01,Senate,"Senate: Third Reading RCS#18",37,0,1,0,38
1987597,1564675,2025-05-02,House,"House: Third Reading RCS#418",98,0,21,0,119
1987620,1513713,2025-03-11,Senate,"Senate Health Policy",10,0,0,0,10
1987620,1520020,2025-03-18,Senate,"Senate Finance and Tax",4,0,0,2,6
1987620,1534280,2025-04-02,Senate,"Senate Appropriations",17,0,0,1,18
1987620,1542241,2025-04-09,Senate,"Senate: Third Reading RCS#29",37,0,0,1,38
1987633,1543341,2025-04-10,House,"House Civil Justice & Claims Subcommittee",14,0,0,4,18
1987633,1551729,2025-04-17,House,"House Judiciary Committee",20,0,0,2,22
1987633,1558221,2025-04-25,House,"House: Third Reading RCS#265",108,0,11,0,119
1987641,1526610,2025-03-25,Senate,"Senate Judiciary",9,2,0,0,11
1987641,1531716,2025-03-31,Senate,"Senate Community Affairs",7,1,0,0,8
1987641,1553551,2025-04-21,Senate,"Senate Rules",21,2,0,2,25
1987641,1556511,2025-04-24,Senate,"Senate: Third Reading RCS#32",35,2,0,1,38
1987641,1559686,2025-04-29,House,"House: Third Reading RCS#274",108,0,11,0,119
1987648,1523250,2025-03-20,House,"House Insurance & Banking Subcommittee",15,1,0,2,18
1987648,1531674,2025-03-31,House,"House Commerce Committee",16,3,0,7,26
1987665,1534243,2025-04-01,Senate,"Senate Health Policy",7,3,0,0,10
1987665,1543976,2025-04-10,Senate,"Senate Appropriations Committee on Health and Human Services",5,3,0,2,10
1987665,1553208,2025-04-21,Senate,"Senate Rules",15,8,0,2,25
1987672,1523032,2025-03-20,House,"House Health Professions & Programs Subcommittee",18,0,0,0,18
1987672,1542139,2025-04-09,House,"House Health Care Budget Subcommittee",13,0,0,2,15
1987672,1553429,2025-04-22,House,"House Health & Human Services Committee",23,0,0,4,27
1987672,1558239,2025-04-25,House,"House: Third Reading RCS#262",110,0,9,0,119
1987672,1559017,2025-04-28,Senate,"Senate: Third Reading RCS#5",36,0,0,2,38
1987680,1535700,2025-04-03,House,"House Health Professions & Programs Subcommittee",16,0,0,2,18
1987680,1551241,2025-04-17,House,"House State Affairs Committee",17,4,0,5,26
1987683,1522326,2025-03-20,House,"House Education & Employment Committee",19,0,0,3,22
1987683,1531137,2025-03-31,House,"House Health & Human Services Committee",24,0,0,3,27
1987683,1540562,2025-04-08,House,"House Budget Committee",29,0,0,1,30
1987683,1551056,2025-04-17,House,"House Judiciary Committee",20,0,0,2,22
1987696,1526248,2025-03-25,Senate,"Senate Children, Families, and Elder Affairs",5,0,0,2,7
1987696,1544052,2025-04-10,Senate,"Senate Appropriations Committee on Health and Human Services",8,0,0,2,10
1987696,1551410,2025-04-17,Senate,"Senate Fiscal Policy",16,0,0,3,19
1987696,1556936,2025-04-24,Senate,"Senate: Third Reading RCS#37",37,0,0,1,38
1987696,1556937,2025-04-24,Senate,"Senate: Third Reading RCS#38",37,0,0,1,38
1987696,1560119,2025-04-29,House,"House: Third Reading RCS#291",116,0,3,0,119
1987696,1564610,2025-05-02,Senate,"Senate: Third Reading RCS#11",34,3,0,1,38
1987715,1526267,2025-03-25,House,"House Government Operations Subcommittee",10,7,0,1,18
1987715,1537242,2025-03-25,House,"House Government Operations Subcommittee",10,7,0,1,18
1987729,1513979,2025-03-10,Senate,"Senate Education Postsecondary",5,0,0,2,7
1987729,1532243,2025-03-24,Senate,"Senate Appropriations Committee on Higher Education",6,2,0,0,8
1987729,1534519,2025-04-02,Senate,"Senate Fiscal Policy",17,1,0,1,19
1987737,1517064,2025-03-11,Senate,"Senate Community Affairs",7,0,0,1,8
1987737,1534255,2025-04-02,Senate,"Senate Appropriations",17,0,0,1,18
1987737,1541440,2025-04-09,Senate,"Senate: Third Reading RCS#28",37,0,0,1,38
1987737,1560052,2025-04-29,House,"House: Third Reading RCS#312",115,1,3,0,119
1987737,1564611,2025-05-02,Senate,"Senate: Third Reading RCS#8",34,1,2,1,38
1987737,1564612,2025-05-02,House,"House: Third Reading RCS#411",106,0,13,0,119
1987748,1526038,2025-03-25,House,"House Economic Infrastructure Subcommittee",14,1,0,3,18
1987748,1534178,2025-04-02,House,"House Transportation & Economic Development Budget Subcommittee",10,4,0,1,15
1987748,1549667,2025-04-15,House,"House Commerce Committee",21,3,0,2,26
1987752,1512609,2025-03-11,House,"House Education Administration Subcommittee",16,0,0,2,18
1987752,1521713,2025-03-19,House,"House Criminal Justice Subcommittee",17,0,0,1,18
1987752,1532993,2025-04-01,House,"House PreK-12 Budget Subcommittee",11,0,0,4,15
1987752,1551065,2025-04-17,House,"House Education & Employment Committee",20,0,0,3,23
1987763,1520913,2025-03-17,Senate,"Senate Banking and Insurance",7,0,0,3,10
1987763,1543769,2025-04-10,Senate,"Senate Appropriations Committee on Agriculture, Environment, and General Government",11,0,0,1,12
1987763,1551341,2025-04-17,Senate,"Senate Fiscal Policy",14,3,0,2,19
1987792,1514021,2025-03-11,Senate,"Senate Education Pre-K - 12",9,0,0,0,9
1987792,1527922,2025-03-24,Senate,"Senate Appropriations Committee on Pre-K - 12 Education",8,0,0,2,10
1987792,1541256,2025-04-08,Senate,"Senate Fiscal Policy",18,1,0,0,19
1987803,1526308,2025-03-25,Senate,"Senate Criminal Justice",5,2,0,2,9
1987803,1549572,2025-04-15,Senate,"Senate Appropriations Committee on Criminal and Civil Justice",6,2,0,1,9
1987803,1553844,2025-04-22,Senate,"Senate Fiscal Policy",14,4,0,1,19
1987811,1532869,2025-04-01,House,"House Government Operations Subcommittee",10,4,0,5,19
1987815,1516854,2025-03-12,Senate,"Senate Children, Families, and Elder Affairs",7,0,0,0,7
1987815,1529807,2025-03-26,Senate,"Senate Appropriations Committee on Health and Human Services",10,0,0,0,10
1987815,1534287,2025-04-02,Senate,"Senate Fiscal Policy",16,1,0,2,19
1987815,1542304,2025-04-09,Senate,"Senate: Third Reading RCS#61",36,0,0,2,38
1987823,1533438,2025-04-01,House,"House Government Operations Subcommittee",12,5,0,2,19
1987823,1538221,2025-04-01,House,"House Government Operations Subcommittee",12,5,0,2,19
1988079,1527375,2025-03-25,Senate,"Senate Health Policy",6,1,0,3,10
1988079,1533946,2025-04-01,Senate,"Senate Judiciary",8,3,0,0,11
1988079,1539750,2025-04-08,Senate,"Senate Rules",22,2,0,1,25
1988101,1526673,2025-03-25,Senate,"Senate Transportation",8,0,0,1,9
1988101,1532590,2025-04-01,Senate,"Senate Criminal Justice",9,0,0,0,9
1988101,1541033,2025-04-08,Senate,"Senate Rules",24,0,0,1,25
1988108,1520964,2025-03-19,Senate,"Senate Judiciary",11,0,0,0,11
1988108,1545316,2025-04-10,Senate,"Senate Appropriations Committee on Criminal and Civil Justice",8,0,0,1,9
1988108,1550077,2025-04-16,Senate,"Senate Rules",22,0,0,3,25
1988120,1525793,2025-03-24,House,"House Commerce Committee",24,0,0,2,26
1988120,1553624,2025-04-22,House,"House Health & Human Services Committee",17,6,0,4,27
1988120,1558111,2025-04-25,House,"House: Third Reading RCS#253",78,28,13,0,119
1988120,1563609,2025-05-01,Senate,"Senate: Third Reading RCS#20",36,0,2,0,38
1988120,1564706,2025-05-02,House,"House: Third Reading RCS#416",99,0,20,0,119
1988120,1564707,2025-05-02,Senate,"Senate: Third Reading RCS#22",26,5,4,3,38
1988158,1520895,2025-03-17,Senate,"Senate Banking and Insurance",7,0,0,3,10
1988190,1516436,2025-03-12,House,"House Intergovernmental Affairs Subcommittee",16,0,0,2,18
1988190,1523406,2025-03-20,House,"House State Affairs Committee",24,0,0,2,26
1988190,1536318,2025-04-03,House,"House: Third Reading RCS#50",107,1,11,0,119
1988190,1563296,2025-04-30,Senate,"Senate: Third Reading RCS#35",36,0,1,1,38
1988199,1523042,2025-03-20,House,"House Civil Justice & Claims Subcommittee",17,0,0,1,18
1988205,1521753,2025-03-19,House,"House Intergovernmental Affairs Subcommittee",17,0,0,1,18
1988205,1527362,2025-03-26,House,"House Criminal Justice Subcommittee",17,0,0,1,18
1988205,1534938,2025-04-02,House,"House State Affairs Committee",25,0,0,1,26
1988205,1557026,2025-04-24,House,"House: Third Reading RCS#229",115,0,4,0,119
1988205,1561904,2025-04-30,Senate,"Senate: Third Reading RCS#37",36,0,1,1,38
1988212,1533873,2025-03-31,Senate,"Senate Community Affairs",8,0,0,0,8
1988212,1543749,2025-04-10,Senate,"Senate Appropriations Committee on Transportation, Tourism, and Economic Development",13,0,0,2,15
1988213,1526481,2025-03-25,Senate,"Senate Criminal Justice",9,0,0,0,9
1988227,1520430,2025-03-18,Senate,"Senate Criminal Justice",9,0,0,0,9
1988227,1545413,2025-04-10,Senate,"Senate Appropriations Committee on Criminal and Civil Justice",8,0,0,1,9
1988227,1551193,2025-04-17,Senate,"Senate Fiscal Policy",17,0,0,2,19
1988246,1519987,2025-03-18,Senate,"Senate Governmental Oversight and Accountability",6,2,0,0,8
1988251,1527245,2025-03-25,Senate,"Senate Transportation",7,0,0,2,9
1988251,1547128,2025-04-10,Senate,"Senate Appropriations Committee on Transportation, Tourism, and Economic Development",14,0,0,1,15
1988251,1552063,2025-04-17,Senate,"Senate Appropriations",16,0,0,2,18
1988251,1555122,2025-04-23,Senate,"Senate: Third Reading RCS#22",37,0,1,0,38
1988251,1559794,2025-04-29,House,"House: Third Reading RCS#276",103,7,9,0,119
1988251,1562478,2025-04-30,Senate,"Senate: Third Reading RCS#58",37,0,0,1,38
1988264,1520241,2025-03-18,Senate,"Senate Criminal Justice",9,0,0,0,9
1988264,1533246,2025-04-01,Senate,"Senate Governmental Oversight and Accountability",7,0,0,0,7
1988264,1539899,2025-04-08,Senate,"Senate Rules",24,0,0,1,25
1988264,1555074,2025-04-23,Senate,"Senate: Third Reading RCS#25",37,0,1,0,38
1988264,1560259,2025-04-29,House,"House: Third Reading RCS#333",114,0,5,0,119
1988278,1526374,2025-03-25,House,"House Human Services Subcommittee",17,0,0,1,18
1988278,1541613,2025-04-09,House,"House Health Care Budget Subcommittee",13,0,0,2,15
1988278,1553698,2025-04-22,House,"House Health & Human Services Committee",22,0,0,5,27
1988285,1520904,2025-03-19,Senate,"Senate Judiciary",10,1,0,0,11
1988285,1545319,2025-04-10,Senate,"Senate Appropriations Committee on Criminal and Civil Justice",8,0,0,1,9
1988285,1550147,2025-04-16,Senate,"Senate Rules",23,0,0,2,25
1988285,1555313,2025-04-23,Senate,"Senate: Third Reading RCS#23",35,2,1,0,38
1988285,1560015,2025-04-29,House,"House: Third Reading RCS#299",115,0,4,0,119
1988299,1518637,2025-03-17,Senate,"Senate Commerce and Tourism",9,0,0,0,9
1988299,1533879,2025-04-01,Senate,"Senate Judiciary",11,0,0,0,11
1988299,1541030,2025-04-08,Senate,"Senate Rules",24,0,0,1,25
1988302,1531308,2025-03-31,Senate,"Senate Education Pre-K - 12",8,1,0,0,9
1988302,1549520,2025-04-15,Senate,"Senate Appropriations Committee on Pre-K - 12 Education",7,1,0,1,9
1988316,1526762,2025-03-25,Senate,"Senate Regulated Industries",8,0,0,1,9
1988328,1522049,2025-03-19,House,"House Intergovernmental Affairs Subcommittee",17,0,0,1,18
1988328,1526861,2025-03-25,House,"House Government Operations Subcommittee",17,0,0,1,18
1988328,1535385,2025-04-02,House,"House State Affairs Committee",25,0,0,1,26
1988328,1537509,2025-03-25,House,"House Government Operations Subcommittee",17,0,0,1,18
1988328,1557693,2025-04-24,House,"House: Third Reading RCS#224",114,0,5,0,119
1988328,1562520,2025-04-30,Senate,"Senate: Third Reading RCS#36",36,0,1,1,38
1988334,1541856,2025-04-09,House,"House Intergovernmental Affairs Subcommittee",17,0,0,1,18
1988334,1551727,2025-04-17,House,"House State Affairs Committee",22,0,0,4,26
1988334,1557380,2025-04-24,House,"House: Third Reading RCS#227",115,0,4,0,119
1988334,1562347,2025-04-30,Senate,"Senate: Third Reading RCS#33",36,0,1,1,38
1988342,1531388,2025-03-31,Senate,"Senate Education Pre-K - 12",7,2,0,0,9
1988342,1545695,2025-04-10,Senate,"Senate Appropriations Committee on Pre-K - 12 Education",8,0,0,1,9
1988342,1550329,2025-04-16,Senate,"Senate Rules",22,1,0,2,25
1988351,1528607,2025-03-25,Senate,"Senate Community Affairs",5,3,0,0,8
1988351,1548293,2025-04-15,Senate,"Senate Finance and Tax",5,0,0,1,6
1988351,1553815,2025-04-22,Senate,"Senate Appropriations",11,6,0,1,18
1988355,1531891,2025-03-31,Senate,"Senate Commerce and Tourism",9,0,0,0,9
1988365,1533068,2025-03-31,Senate,"Senate Community Affairs",8,0,0,0,8
1988365,1550934,2025-04-17,Senate,"Senate Fiscal Policy",17,0,0,2,19
1988365,1553114,2025-04-21,Senate,"Senate Rules",23,0,0,2,25
1988409,1527765,2025-03-26,House,"House Intergovernmental Affairs Subcommittee",9,6,0,4,19
1988409,1541879,2025-04-09,House,"House Industries & Professional Activities Subcommittee",16,1,0,2,19
1988409,1551297,2025-04-17,House,"House State Affairs Committee",15,6,0,5,26
1988409,1557334,2025-04-24,House,"House: Third Reading RCS#230",92,16,11,0,119
1988409,1562400,2025-04-30,Senate,"Senate: Third Reading RCS#34",35,1,1,1,38
1988421,1543680,2025-04-10,House,"House Insurance & Banking Subcommittee",16,0,0,2,18
1988440,1520089,2025-03-18,Senate,"Senate Criminal Justice",6,3,0,0,9
1988453,1534198,2025-04-01,Senate,"Senate Transportation",9,0,0,0,9
1988453,1543296,2025-04-10,Senate,"Senate Appropriations Committee on Transportation, Tourism, and Economic Development",13,0,0,2,15
1988453,1549716,2025-04-16,Senate,"Senate Rules",23,0,0,2,25
1988466,1521331,2025-03-17,Senate,"Senate Banking and Insurance",7,0,0,3,10
1988472,1520425,2025-03-18,Senate,"Senate Governmental Oversight and Accountability",8,0,0,0,8
1988472,1534704,2025-04-02,Senate,"Senate Appropriations",18,0,0,0,18
1988472,1542162,2025-04-09,Senate,"Senate: Third Reading RCS#62",34,2,0,2,38
1988472,1559958,2025-04-29,House,"House: Third Reading RCS#308",111,3,5,0,119
1988494,1533716,2025-04-01,Senate,"Senate Criminal Justice",7,1,0,1,9
1988494,1549508,2025-04-15,Senate,"Senate Appropriations Committee on Criminal and Civil Justice",5,4,0,0,9
1988494,1555337,2025-04-22,Senate,"Senate Fiscal Policy",15,4,0,0,19
1988494,1559073,2025-04-28,Senate,"Senate: Third Reading RCS#24",27,11,0,0,38
1988494,1562140,2025-04-30,House,"House: Third Reading RCS#359",95,17,7,0,119
1988496,1527874,2025-03-26,House,"House Criminal Justice Subcommittee",17,1,0,0,18
1988496,1532843,2025-04-01,House,"House Justice Budget Subcommittee",11,1,0,3,15
1988496,1539681,2025-04-08,House,"House Judiciary Committee",21,1,0,0,22
1988496,1556979,2025-04-24,House,"House: Third Reading RCS#204",112,0,7,0,119
1988496,1562225,2025-04-30,Senate,"Senate: Third Reading RCS#46",37,0,0,1,38
1988496,1563919,2025-05-01,Senate,"Senate: Third Reading RCS#25",37,0,1,0,38
1988509,1535874,2025-04-03,House,"House Health Professions & Programs Subcommittee",14,0,0,4,18
1988509,1548865,2025-04-15,House,"House Health & Human Services Committee",21,0,0,5,26
1988509,1555415,2025-04-23,House,"House: Third Reading RCS#178",115,0,4,0,119
1988509,1556998,2025-04-24,Senate,"Senate: Third Reading RCS#46",37,0,0,1,38
1988515,1519134,2025-03-17,Senate,"Senate Education Pre-K - 12",8,0,0,1,9
1988515,1545588,2025-04-10,Senate,"Senate Appropriations Committee on Pre-K - 12 Education",8,0,0,1,9
1988515,1549745,2025-04-16,Senate,"Senate Rules",23,0,0,2,25
1988518,1522147,2025-03-19,House,"House Criminal Justice Subcommittee",15,0,0,3,18
1988518,1543745,2025-04-10,House,"House Government Operations Subcommittee",17,0,0,1,18
1988518,1551558,2025-04-17,House,"House Judiciary Committee",19,0,0,3,22
1988523,1520718,2025-03-19,Senate,"Senate Children, Families, and Elder Affairs",6,0,0,1,7
1988523,1544669,2025-04-10,Senate,"Senate Appropriations Committee on Health and Human Services",8,0,0,2,10
1988523,1550092,2025-04-16,Senate,"Senate Rules",23,0,0,2,25
1988538,1518563,2025-03-17,Senate,"Senate Commerce and Tourism",6,3,0,0,9
1988543,1534303,2025-04-01,House,"House Industries & Professional Activities Subcommittee",16,2,0,1,19
1988596,1541448,2025-04-09,House,"House Industries & Professional Activities Subcommittee",11,4,0,4,19
1988596,1548254,2025-04-15,House,"House State Administration Budget Subcommittee",12,3,0,0,15
1988598,1533919,2025-04-02,House,"House Ways & Means Committee",12,5,0,2,19
1988609,1535800,2025-04-03,House,"House Health Professions & Programs Subcommittee",15,0,0,3,18
1988609,1548748,2025-04-15,House,"House Health & Human Services Committee",23,0,0,3,26
1988613,1519933,2025-03-17,Senate,"Senate Community Affairs",5,3,0,0,8
1988622,1519549,2025-03-17,Senate,"Senate Community Affairs",8,0,0,0,8
1988622,1527095,2025-03-25,Senate,"Senate Transportation",8,0,0,1,9
1988659,1531038,2025-03-31,Senate,"Senate Education Postsecondary",5,0,0,2,7
1988659,1545720,2025-04-10,Senate,"Senate Appropriations Committee on Higher Education",7,0,0,1,8
1988659,1553607,2025-04-21,Senate,"Senate Rules",20,3,0,2,25
1988664,1529205,2025-03-27,House,"House Health Care Facilities & Systems Subcommittee",15,0,0,3,18
1988664,1548339,2025-04-15,House,"House Health Care Budget Subcommittee",15,0,0,0,15
1988684,1526798,2025-03-25,Senate,"Senate Governmental Oversight and Accountability",5,2,0,1,8
1988706,1520543,2025-03-18,Senate,"Senate Criminal Justice",8,1,0,0,9
1988709,1520000,2025-03-18,Senate,"Senate Criminal Justice",8,0,0,1,9
1988716,1534441,2025-04-01,House,"House Industries & Professional Activities Subcommittee",17,1,0,1,19
1988716,1540694,2025-04-08,House,"House Budget Committee",24,4,0,2,30
1988716,1549875,2025-04-15,House,"House Commerce Committee",17,9,0,0,26
1988716,1558339,2025-04-25,House,"House: Third Reading RCS#266",70,34,15,0,119
1988718,1526002,2025-03-25,Senate,"Senate Commerce and Tourism",8,1,0,0,9
1988733,1534717,2025-04-02,House,"House Education Administration Subcommittee",13,4,0,1,18
1988733,1551354,2025-04-17,House,"House Education & Employment Committee",14,5,0,4,23
1988733,1556756,2025-04-24,House,"House: Third Reading RCS#201",81,29,9,0,119
1988743,1534089,2025-04-01,Senate,"Senate Health Policy",10,0,0,0,10
1988743,1544621,2025-04-10,Senate,"Senate Appropriations Committee on Health and Human Services",7,1,0,2,10
1988743,1550957,2025-04-16,Senate,"Senate Rules",22,1,0,2,25
1988743,1555269,2025-04-23,Senate,"Senate: Third Reading RCS#17",37,0,1,0,38
1988743,1562024,2025-04-30,House,"House: Third Reading RCS#351",112,0,7,0,119
1988743,1563774,2025-05-01,Senate,"Senate: Third Reading RCS#8",37,0,1,0,38
1988761,1527694,2025-03-26,House,"House Criminal Justice Subcommittee",18,0,0,0,18
1988761,1534521,2025-04-02,House,"House Judiciary Committee",20,0,0,2,22
1988761,1550264,2025-04-16,House,"House: Third Reading RCS#117",115,0,4,0,119
1988761,1554996,2025-04-23,Senate,"Senate: Third Reading RCS#15",35,1,2,0,38
1988761,1562436,2025-04-30,House,"House: Third Reading RCS#367",112,0,7,0,119
1988768,1526030,2025-03-25,Senate,"Senate Environment and Natural Resources",8,0,0,1,9
1988775,1526438,2025-03-25,Senate,"Senate Regulated Industries",8,0,0,1,9
1988775,1548253,2025-04-15,Senate,"Senate Appropriations Committee on Agriculture, Environment, and General Government",12,0,0,0,12
1988775,1553529,2025-04-21,Senate,"Senate Rules",23,0,0,2,25
1988783,1520053,2025-03-18,Senate,"Senate Governmental Oversight and Accountability",6,2,0,0,8
1988799,1507521,2025-03-05,Senate,"Senate Appropriations Committee on Criminal and Civil Justice",9,0,0,0,9
1988799,1535250,2025-04-02,Senate,"Senate Appropriations",18,0,0,0,18
1988799,1542604,2025-04-09,Senate,"Senate: Third Reading RCS#14",37,0,0,1,38
1988803,1513876,2025-03-11,House,"House Health Care Facilities & Systems Subcommittee",18,0,0,0,18
1988803,1527304,2025-03-26,House,"House Health Care Budget Subcommittee",12,0,0,3,15
1988803,1548646,2025-04-15,House,"House Health & Human Services Committee",24,0,0,2,26
1988809,1521025,2025-03-17,Senate,"Senate Banking and Insurance",7,0,0,3,10
1988817,1526183,2025-03-25,House,"House Government Operations Subcommittee",16,0,0,2,18
1988817,1534842,2025-04-02,House,"House State Affairs Committee",23,2,0,1,26
1988817,1537239,2025-03-25,House,"House Government Operations Subcommittee",16,0,0,2,18
1988825,1533967,2025-04-01,Senate,"Senate Transportation",9,0,0,0,9
1988825,1549568,2025-04-15,Senate,"Senate Appropriations Committee on Criminal and Civil Justice",9,0,0,0,9
1988825,1553870,2025-04-22,Senate,"Senate Fiscal Policy",19,0,0,0,19
1988832,1532068,2025-04-01,House,"House Criminal Justice Subcommittee",16,0,0,2,18
1988832,1551373,2025-04-17,House,"House Judiciary Committee",18,0,0,4,22
1988832,1555388,2025-04-23,House,"House: Third Reading RCS#194",115,0,4,0,119
1988832,1560149,2025-04-29,Senate,"Senate: Third Reading RCS#12",37,0,1,0,38
1988840,1519036,2025-03-17,Senate,"Senate Agriculture",6,0,0,0,6
1988840,1528968,2025-03-27,Senate,"Senate Fiscal Policy",18,0,0,1,19
1988840,1542260,2025-04-09,Senate,"Senate: Third Reading RCS#35",37,0,0,1,38
1988857,1515225,2025-03-11,House,"House Government Operations Subcommittee",17,0,0,1,18
1988857,1539675,2025-04-08,House,"House State Affairs Committee",22,0,0,4,26
1988857,1549747,2025-04-16,House,"House: Third Reading RCS#105",111,1,7,0,119
1988857,1563859,2025-05-01,Senate,"Senate: Third Reading RCS#21",37,0,1,0,38
1988857,1564693,2025-05-02,House,"House: Third Reading RCS#422",97,1,21,0,119
1988863,1526298,2025-03-25,Senate,"Senate Governmental Oversight and Accountability",7,0,0,1,8
1988863,1548270,2025-04-15,Senate,"Senate Appropriations Committee on Agriculture, Environment, and General Government",12,0,0,0,12
1988863,1553244,2025-04-21,Senate,"Senate Rules",22,1,0,2,25
1988884,1519908,2025-03-18,House,"House Natural Resources & Disasters Subcommittee",17,0,0,1,18
1988884,1543626,2025-04-10,House,"House Transportation & Economic Development Budget Subcommittee",10,0,0,5,15
1988884,1551233,2025-04-17,House,"House State Affairs Committee",20,1,0,5,26
1988887,1529488,2025-03-27,House,"House Civil Justice & Claims Subcommittee",13,0,0,5,18
1988908,1527037,2025-03-25,Senate,"Senate Environment and Natural Resources",8,0,0,1,9
1988942,1534096,2025-03-31,Senate,"Senate Community Affairs",8,0,0,0,8
1988942,1541019,2025-04-08,Senate,"Senate Rules",24,0,0,1,25
1988942,1549955,2025-04-16,Senate,"Senate: Third Reading RCS#18",36,0,1,1,38
1988942,1559778,2025-04-29,House,"House: Third Reading RCS#285",109,3,7,0,119
1988942,1562455,2025-04-30,Senate,"Senate: Third Reading RCS#57",37,0,0,1,38
1988942,1563367,2025-05-01,House,"House: Third Reading RCS#392",105,0,14,0,119
1988947,1531489,2025-03-31,House,"House Health & Human Services Committee",19,7,0,1,27
1988947,1539373,2025-04-08,House,"House Judiciary Committee",16,5,0,1,22
1988947,1553926,2025-04-22,House,"House Education & Employment Committee",16,5,0,2,23
1988947,1558217,2025-04-25,House,"House: Third Reading RCS#263",80,28,11,0,119
1988954,1521090,2025-03-19,House,"House Education Administration Subcommittee",12,4,0,2,18
1988954,1533025,2025-04-01,House,"House Student Academic Success Subcommittee",12,5,0,1,18
1988954,1547356,2025-04-14,House,"House PreK-12 Budget Subcommittee",12,2,0,2,16
1988977,1516195,2025-03-12,House,"House Economic Infrastructure Subcommittee",14,4,0,0,18
1988977,1521737,2025-03-19,House,"House Intergovernmental Affairs Subcommittee",12,0,0,6,18
1988977,1549788,2025-04-15,House,"House Commerce Committee",21,2,0,3,26
1988977,1556948,2025-04-24,House,"House: Third Reading RCS#205",80,31,8,0,119
1988985,1523318,2025-03-20,House,"House Civil Justice & Claims Subcommittee",13,3,0,2,18
1988985,1534795,2025-04-02,House,"House Judiciary Committee",14,6,0,2,22
1988985,1542272,2025-04-09,House,"House: Third Reading RCS#79",79,32,8,0,119
1988993,1534276,2025-04-01,Senate,"Senate Health Policy",10,0,0,0,10
1988993,1543887,2025-04-10,Senate,"Senate Appropriations Committee on Health and Human Services",8,0,0,2,10
1988993,1551011,2025-04-17,Senate,"Senate Fiscal Policy",17,0,0,2,19
1988998,1521564,2025-03-19,House,"House Criminal Justice Subcommittee",16,0,0,2,18
1988998,1531000,2025-03-31,House,"House Economic Infrastructure Subcommittee",16,0,0,2,18
1988998,1539416,2025-04-08,House,"House Judiciary Committee",22,0,0,0,22
1988998,1549606,2025-04-16,House,"House: Third Reading RCS#118",116,0,3,0,119
1988998,1555178,2025-04-23,Senate,"Senate: Third Reading RCS#19",37,0,1,0,38
1989022,1536168,2025-04-03,House,"House Health Professions & Programs Subcommittee",16,0,0,2,18
1989022,1553384,2025-04-22,House,"House Health & Human Services Committee",22,0,0,5,27
1989039,1534118,2025-04-02,House,"House Health Care Facilities & Systems Subcommittee",17,0,0,1,18
1989039,1548595,2025-04-15,House,"House Health & Human Services Committee",21,0,0,5,26
1989046,1532958,2025-04-01,House,"House Student Academic Success Subcommittee",12,1,0,5,18
1989057,1527818,2025-03-26,House,"House Intergovernmental Affairs Subcommittee",14,1,0,4,19
1989057,1539646,2025-04-08,House,"House State Affairs Committee",22,0,0,4,26
1989057,1554957,2025-04-23,House,"House: Third Reading RCS#146",108,3,8,0,119
1989073,1527834,2025-03-26,House,"House Intergovernmental Affairs Subcommittee",11,3,0,5,19
1989073,1551375,2025-04-17,House,"House State Affairs Committee",20,2,0,4,26
1989073,1555003,2025-04-23,House,"House: Third Reading RCS#149",99,13,7,0,119
1989073,1562713,2025-04-30,Senate,"Senate: Third Reading RCS#53",24,13,0,1,38
1989073,1564019,2025-05-01,House,"House: Third Reading RCS#401",111,1,7,0,119
1989073,1564634,2025-05-02,Senate,"Senate: Third Reading RCS#9",26,10,1,1,38
1989079,1519001,2025-03-17,Senate,"Senate Environment and Natural Resources",5,3,0,1,9
1989079,1533205,2025-03-31,Senate,"Senate Community Affairs",5,3,0,0,8
1989079,1550258,2025-04-16,Senate,"Senate Rules",16,7,0,2,25
1989093,1517362,2025-03-13,House,"House Civil Justice & Claims Subcommittee",16,1,0,2,19
1989093,1523199,2025-03-20,House,"House Insurance & Banking Subcommittee",15,1,0,2,18
1989093,1524528,2025-03-13,House,"House Civil Justice & Claims Subcommittee",16,1,0,2,19
1989093,1524529,2025-03-20,House,"House Insurance & Banking Subcommittee",15,1,0,2,18
1989095,1529152,2025-03-27,House,"House Civil Justice & Claims Subcommittee",14,0,0,4,18
1989095,1540681,2025-04-08,House,"House Judiciary Committee",20,0,0,2,22
1989095,1549684,2025-04-16,House,"House: Third Reading RCS#116",114,0,5,0,119
1989095,1555166,2025-04-23,Senate,"Senate: Third Reading RCS#24",37,0,1,0,38
1989113,1529559,2025-03-27,House,"House Civil Justice & Claims Subcommittee",13,0,0,5,18
1989113,1533630,2025-04-01,House,"House Government Operations Subcommittee",14,0,0,5,19
1989113,1540670,2025-04-08,House,"House Judiciary Committee",18,0,0,4,22
1989117,1526505,2025-03-25,Senate,"Senate Criminal Justice",8,1,0,0,9
1989117,1534418,2025-04-01,Senate,"Senate Judiciary",11,0,0,0,11
1989117,1540448,2025-04-08,Senate,"Senate Rules",23,1,0,1,25
1989126,1529617,2025-03-27,House,"House Education Administration Subcommittee",17,0,0,1,18
1989126,1547133,2025-04-14,House,"House PreK-12 Budget Subcommittee",14,0,0,2,16
1989126,1551350,2025-04-17,House,"House Education & Employment Committee",21,0,0,2,23
1989126,1555180,2025-04-23,House,"House: Third Reading RCS#164",115,0,4,0,119
1989126,1557181,2025-04-24,Senate,"Senate: Third Reading RCS#44",37,0,0,1,38
1989126,1562465,2025-04-30,House,"House: Third Reading RCS#376",113,0,6,0,119
1989126,1563741,2025-05-01,Senate,"Senate: Third Reading RCS#10",37,0,1,0,38
1989143,1520451,2025-03-18,Senate,"Senate Criminal Justice",9,0,0,0,9
1989143,1549486,2025-04-15,Senate,"Senate Appropriations Committee on Criminal and Civil Justice",9,0,0,0,9
1989143,1554297,2025-04-22,Senate,"Senate Fiscal Policy",19,0,0,0,19
1989147,1532112,2025-04-01,House,"House Intergovernmental Affairs Subcommittee",16,0,0,2,18
1989175,1527317,2025-03-25,Senate,"Senate Transportation",8,0,0,1,9
1989175,1531945,2025-03-31,Senate,"Senate Commerce and Tourism",9,0,0,0,9
1989175,1550117,2025-04-16,Senate,"Senate Rules",23,0,0,2,25
1989181,1517258,2025-03-13,House,"House Health Professions & Programs Subcommittee",15,0,0,3,18
1989181,1527368,2025-03-26,House,"House Health Care Budget Subcommittee",12,0,0,3,15
1989181,1538282,2025-04-07,House,"House Health & Human Services Committee",24,0,0,2,26
1989181,1549773,2025-04-16,House,"House: Third Reading RCS#136",116,0,3,0,119
1989207,1520938,2025-03-18,Senate,"Senate Health Policy",9,0,0,1,10
1989207,1544092,2025-04-10,Senate,"Senate Appropriations Committee on Health and Human Services",8,0,0,2,10
1989207,1550269,2025-04-16,Senate,"Senate Rules",21,0,0,4,25
1989207,1555022,2025-04-23,Senate,"Senate: Third Reading RCS#16",37,0,1,0,38
1989207,1562308,2025-04-30,House,"House: Third Reading RCS#352",112,0,7,0,119
1989220,1523331,2025-03-20,House,"House Insurance & Banking Subcommittee",14,0,0,4,18
1989220,1531578,2025-03-31,House,"House Commerce Committee",21,0,0,5,26
1989220,1549608,2025-04-16,House,"House: Third Reading RCS#110",116,0,3,0,119
1989220,1562551,2025-04-30,Senate,"Senate: Third Reading RCS#51",27,10,0,1,38
1989220,1564574,2025-05-02,House,"House: Third Reading RCS#406",114,0,5,0,119
1989220,1564575,2025-05-02,Senate,"Senate: Third Reading RCS#12",36,1,0,1,38
1989225,1528886,2025-03-27,House,"House Health Professions & Programs Subcommittee",17,0,0,1,18
1989225,1542087,2025-04-09,House,"House Health Care Budget Subcommittee",13,0,0,2,15
1989225,1548616,2025-04-15,House,"House Health & Human Services Committee",21,0,0,5,26
1989225,1555661,2025-04-23,House,"House: Third Reading RCS#189",115,0,4,0,119
1989225,1560454,2025-04-29,Senate,"Senate: Third Reading RCS#26",38,0,0,0,38
1989225,1562487,2025-04-30,House,"House: Third Reading RCS#372",112,0,7,0,119
1989232,1528729,2025-03-27,House,"House Civil Justice & Claims Subcommittee",14,0,0,4,18
1989232,1532777,2025-04-01,House,"House Natural Resources & Disasters Subcommittee",17,0,0,1,18
1989232,1539778,2025-04-08,House,"House Judiciary Committee",18,0,0,4,22
1989234,1520087,2025-03-18,House,"House Human Services Subcommittee",17,0,0,1,18
1989234,1531143,2025-03-31,House,"House Health & Human Services Committee",25,0,0,2,27
1989234,1542133,2025-04-09,House,"House: Third Reading RCS#87",110,0,9,0,119
1989234,1555334,2025-04-23,Senate,"Senate: Third Reading RCS#18",38,0,0,0,38
1989234,1562241,2025-04-30,House,"House: Third Reading RCS#373",111,0,8,0,119
1990100,1516468,2025-03-12,House,"House Intergovernmental Affairs Subcommittee",16,0,0,2,18
1990100,1521630,2025-03-19,House,"House Industries & Professional Activities Subcommittee",14,0,0,4,18
1990100,1528422,2025-03-26,House,"House State Affairs Committee",22,0,0,5,27
1990100,1536739,2025-04-03,House,"House: Third Reading RCS#49",107,0,12,0,119
1990100,1563303,2025-04-30,Senate,"Senate: Third Reading RCS#29",35,1,1,1,38
1990952,1527336,2025-03-25,Senate,"Senate Health Policy",8,2,0,0,10
1990952,1543907,2025-04-10,Senate,"Senate Appropriations Committee on Health and Human Services",5,3,0,2,10
1990952,1555402,2025-04-22,Senate,"Senate Fiscal Policy",18,0,0,1,19
1992688,1512497,2025-03-10,Senate,"Senate Ethics and Elections",6,3,0,0,9
1992688,1541355,2025-04-08,Senate,"Senate Fiscal Policy",14,5,0,0,19
1994035,1513913,2025-03-11,Senate,"Senate Health Policy",9,1,0,0,10
1994035,1532969,2025-04-01,Senate,"Senate Governmental Oversight and Accountability",7,0,0,0,7
1994035,1540541,2025-04-08,Senate,"Senate Rules",24,0,0,1,25
1994035,1548752,2025-04-15,Senate,"Senate: Third Reading RCS#13",36,0,0,2,38
1994035,1560280,2025-04-29,House,"House: Third Reading RCS#335",115,0,4,0,119
1994534,1532198,2025-04-01,House,"House Intergovernmental Affairs Subcommittee",13,2,0,3,18
1994534,1540747,2025-04-08,House,"House Ways & Means Committee",12,4,0,3,19
1994534,1553849,2025-04-22,House,"House State Affairs Committee",19,6,0,3,28
2000044,1515871,2025-03-12,Senate,"Senate: Third Reading RCS#3",38,0,0,1,39
2006287,1519991,2025-03-18,Senate,"Senate Governmental Oversight and Accountability",8,0,0,0,8
2006287,1534611,2025-04-02,Senate,"Senate Appropriations",18,0,0,0,18
2006287,1541343,2025-04-09,Senate,"Senate: Third Reading RCS#8",37,0,0,1,38
2006287,1541885,2025-04-09,House,"House: Third Reading RCS#66",112,0,7,0,119
2006597,1520381,2025-03-18,Senate,"Senate Governmental Oversight and Accountability",8,0,0,0,8
2006597,1527649,2025-03-26,Senate,"Senate Rules",21,3,0,1,25
2006597,1535675,2025-04-03,Senate,"Senate: Third Reading RCS#2",37,0,0,1,38
2006597,1560075,2025-04-29,House,"House: Third Reading RCS#336",116,0,3,0,119
2008946,1522438,2025-03-20,Senate,"Senate Appropriations",18,0,0,1,19
2008946,1529074,2025-03-27,Senate,"Senate Fiscal Policy",18,0,0,1,19
2008946,1541536,2025-04-09,Senate,"Senate: Third Reading RCS#9",37,0,0,1,38
2009168,1522295,2025-03-20,Senate,"Senate Appropriations",18,0,0,1,19
2009168,1541743,2025-04-09,Senate,"Senate: Third Reading RCS#10",36,0,1,1,38
2010901,1526153,2025-03-25,House,"House Economic Infrastructure Subcommittee",15,0,0,3,18
2010901,1535122,2025-04-02,House,"House State Affairs Committee",22,0,0,4,26
2010970,1528173,2025-03-26,House,"House State Affairs Committee",22,0,0,5,27
2011040,1543551,2025-04-10,House,"House Insurance & Banking Subcommittee",18,0,0,0,18
2011040,1551141,2025-04-17,House,"House State Affairs Committee",22,0,0,4,26
2011825,1527319,2025-03-25,Senate,"Senate Health Policy",10,0,0,0,10
2011825,1534652,2025-04-02,Senate,"Senate Appropriations",18,0,0,0,18
2011825,1542045,2025-04-09,Senate,"Senate: Third Reading RCS#22",37,0,0,1,38
2012623,1529398,2025-03-26,Senate,"Senate Appropriations Committee on Pre-K - 12 Education",8,1,0,1,10
2012623,1534324,2025-04-02,Senate,"Senate Appropriations",18,0,0,0,18
2012623,1541468,2025-04-09,Senate,"Senate: Third Reading RCS#15",35,2,0,1,38
2012623,1542327,2025-04-09,House,"House: Third Reading RCS#67",80,27,12,0,119
2014649,1534177,2025-04-02,House,"House Budget Committee",27,0,0,3,30
2014773,1534251,2025-04-02,House,"House Budget Committee",22,6,0,2,30
2015237,1534422,2025-04-02,House,"House Budget Committee",27,0,0,3,30
2015245,1535546,2025-04-02,House,"House State Affairs Committee",25,0,0,1,26
2016018,1534353,2025-04-02,House,"House Budget Committee",23,5,0,2,30
2016018,1541847,2025-04-09,House,"House: Third Reading RCS#58",82,26,11,0,119
2016018,1552161,2025-04-17,Senate,"Senate Appropriations",17,0,0,1,18
2016043,1535356,2025-04-02,House,"House Budget Committee",28,0,0,2,30
2016043,1541852,2025-04-09,House,"House: Third Reading RCS#61",111,0,8,0,119
2016043,1552053,2025-04-17,Senate,"Senate Appropriations",17,0,0,1,18
2016065,1534497,2025-04-02,House,"House Budget Committee",26,0,0,4,30
2016065,1541628,2025-04-09,House,"House: Third Reading RCS#60",111,0,8,0,119
2016065,1552034,2025-04-17,Senate,"Senate Appropriations",17,0,0,1,18
2016312,1535609,2025-04-02,Senate,"Senate Appropriations",18,0,0,0,18
2016312,1541658,2025-04-09,Senate,"Senate: Third Reading RCS#5",37,0,0,1,38
2016312,1541659,2025-04-09,House,"House: Third Reading RCS#64",98,6,15,0,119
2016351,1534346,2025-04-02,Senate,"Senate Appropriations",18,0,0,0,18
2016351,1541610,2025-04-09,Senate,"Senate: Third Reading RCS#13",37,0,0,1,38
2016351,1543184,2025-04-09,House,"House: Third Reading RCS#69",111,0,8,0,119
2016388,1534538,2025-04-02,Senate,"Senate Appropriations",18,0,0,0,18
2016388,1541796,2025-04-09,Senate,"Senate: Third Reading RCS#7",37,0,0,1,38
2016388,1541797,2025-04-09,House,"House: Third Reading RCS#70",111,0,8,0,119
2016424,1534469,2025-04-02,Senate,"Senate Appropriations",18,0,0,0,18
2016424,1541739,2025-04-09,Senate,"Senate: Third Reading RCS#18",37,0,0,1,38
2016424,1541740,2025-04-09,House,"House: Third Reading RCS#68",111,0,8,0,119
2016463,1535311,2025-04-02,Senate,"Senate Appropriations",18,0,0,0,18
2016463,1541593,2025-04-09,Senate,"Senate: Third Reading RCS#16",33,3,1,1,38
2016502,1534242,2025-04-02,Senate,"Senate Appropriations",18,0,0,0,18
2016502,1541409,2025-04-09,Senate,"Senate: Third Reading RCS#12",37,0,0,1,38
2016502,1541410,2025-04-09,House,"House: Third Reading RCS#56",97,12,10,0,119
2016539,1534616,2025-04-02,Senate,"Senate Appropriations",18,0,0,0,18
2016539,1541874,2025-04-09,Senate,"Senate: Third Reading RCS#17",37,0,0,1,38
2016571,1534686,2025-04-02,Senate,"Senate Appropriations",18,0,0,0,18
2016571,1541395,2025-04-09,Senate,"Senate: Third Reading RCS#6",37,0,0,1,38
2016571,1542172,2025-04-09,House,"House: Third Reading RCS#65",104,5,10,0,119
2018625,1541780,2025-04-09,House,"House: Third Reading RCS#63",112,0,7,0,119
2019272,1541930,2025-04-09,House,"House: Third Reading RCS#59",109,0,10,0,119
2019272,1552051,2025-04-17,Senate,"Senate Appropriations",17,0,0,1,18
2019290,1549693,2025-04-16,House,"House Budget Committee",29,0,0,1,30
2019290,1554393,2025-04-22,House,"House Commerce Committee",25,0,0,2,27
2019303,1542583,2025-04-09,House,"House: Third Reading RCS#57",108,0,11,0,119
2019303,1552052,2025-04-17,Senate,"Senate Appropriations",17,0,0,1,18
2019362,1541583,2025-04-09,House,"House: Third Reading RCS#62",112,0,7,0,119
2019362,1552039,2025-04-17,Senate,"Senate Appropriations",17,0,0,1,18
2020763,1549549,2025-04-16,House,"House Budget Committee",29,0,0,1,30
2020763,1553817,2025-04-22,House,"House Commerce Committee",24,0,0,3,27
2021234,1544389,2025-04-10,Senate,"Senate Appropriations Committee on Health and Human Services",8,0,0,2,10
2021234,1553655,2025-04-22,Senate,"Senate Appropriations",17,0,0,1,18
2023010,1548372,2025-04-15,Senate,"Senate Finance and Tax",3,1,0,2,6
2024348,1553706,2025-04-22,House,"House Budget Committee",20,8,0,2,30
2024348,1557937,2025-04-25,House,"House: Third Reading RCS#246",78,29,12,0,119
