bill_id,roll_call_id,date,chamber,description,yea,nay,nv,absent,total
1893467,1474945,2025-01-27,House,"House Health & Human Services Committee Action (DP)",10,2,0,0,12
1893467,1478840,2025-02-03,House,"House Rules Committee Action (C&P)",8,0,0,0,8
1893467,1487664,2025-02-12,House,"House - Committee of the Whole (DPA)",0,0,0,0,0
1893467,1491236,2025-02-17,House,"House - Third Reading",36,23,1,0,60
1893467,1521422,2025-03-19,Senate,"Senate Health and Human Services Committee Action (DPA/SE)",4,3,0,0,7
1893467,1524736,2025-03-24,Senate,"Senate Rules Committee Action (PFC)",0,0,0,0,0
1893467,1535828,2025-04-03,Senate,"Senate - Committee of the Whole (DPA)",0,0,0,0,0
1893467,1539509,2025-04-08,Senate,"Senate - Third Reading",19,9,2,0,30
1893467,1558925,2025-04-28,House,"House - Concurrence",0,0,0,0,0
1893467,1558926,2025-04-28,House,"House - Third Reading",50,5,5,0,60
1893472,1494574,2025-02-19,Senate,"Senate Judiciary and Elections Committee Action (DP)",4,3,0,0,7
1893472,1497537,2025-02-24,Senate,"Senate Rules Committee Action (PFC)",0,0,0,0,0
1893472,1518529,2025-03-17,Senate,"Senate - Committee of the Whole (DPA)",0,0,0,0,0
1893472,1518530,2025-03-17,Senate,"Senate - Third Reading",0,0,0,0,0
1893472,1528151,2025-03-26,House,"House Federalism, Military Affairs & Elections Committee Action (DP)",4,2,0,1,7
1893472,1531441,2025-03-31,House,"House Rules Committee Action (C&P)",7,0,0,1,8
1893472,1534450,2025-04-02,House,"House - Committee of the Whole (DP)",0,0,0,0,0
1893478,1476502,2025-01-29,Senate,"Senate Education Committee Action (DP)",4,2,1,0,7
1893478,1478797,2025-02-03,Senate,"Senate Rules Committee Action (PFC)",4,3,0,0,7
1893478,1484793,2025-02-10,Senate,"Senate - Committee of the Whole (DP)",0,0,0,0,0
1893478,1486522,2025-02-11,Senate,"Senate - Third Reading",17,9,4,0,30
1893478,1516552,2025-03-12,House,"House Government Committee Action (W/D)",0,0,0,0,0
1893478,1526701,2025-03-25,House,"House Regulatory Oversight Committee Action (DP)",3,2,0,0,5
1893478,1545826,2025-01-29,Senate,"Senate Education-Archived and Renamed Education and Transportation as of 04/01/2025 Committee Action (DP)",4,2,1,0,7
1893478,1547280,2025-04-14,House,"House Rules Committee Action (C&P)",8,0,0,0,8
1893478,1552535,2025-04-21,House,"House - Committee of the Whole (DP)",0,0,0,0,0
1893478,1563691,2025-05-01,House,"House - Third Reading",31,27,2,0,60
1893484,1476510,2025-01-29,Senate,"Senate Education Committee Action (DP)",4,2,1,0,7
1893484,1478795,2025-02-03,Senate,"Senate Rules Committee Action (PFC)",4,3,0,0,7
1893484,1495005,2025-02-20,Senate,"Senate - Committee of the Whole (DP)",0,0,0,0,0
1893484,1495006,2025-02-20,Senate,"Senate - Third Reading",17,12,1,0,30
1893484,1516562,2025-03-12,House,"House Government Committee Action (W/D)",0,0,0,0,0
1893484,1526616,2025-03-25,House,"House Regulatory Oversight Committee Action (DP)",3,2,0,0,5
1893484,1545888,2025-01-29,Senate,"Senate Education-Archived and Renamed Education and Transportation as of 04/01/2025 Committee Action (DP)",4,2,1,0,7
1893484,1547274,2025-04-14,House,"House Rules Committee Action (C&P)",5,3,0,0,8
1893484,1552693,2025-04-21,House,"House - Committee of the Whole (DP)",0,0,0,0,0
1893484,1563639,2025-05-01,House,"House - Third Reading",31,27,2,0,60
1895803,1479069,2025-02-03,Senate,"Senate Finance Committee Action (DP)",5,1,1,0,7
1895803,1485005,2025-02-10,Senate,"Senate Rules Committee Action (PFC)",0,0,0,0,0
1895803,1501182,2025-02-27,Senate,"Senate - Committee of the Whole (DPA)",0,0,0,0,0
1895803,1518931,2025-03-17,Senate,"Senate - Third Reading",24,1,4,0,29
1895809,1472818,2025-01-21,Senate,"Senate Appropriations Committee Action (DP)",9,0,1,0,10
1895809,1475083,2025-01-27,Senate,"Senate Rules Committee Action (PFC)",0,0,0,0,0
1895809,1479049,2025-02-03,Senate,"Senate - Third Reading",26,4,0,0,30
1895809,1514481,2025-03-11,House,"House Natural Resources, Energy & Water Committee Action (DP)",8,1,0,1,10
1895809,1524880,2025-03-24,House,"House Rules Committee Action (C&P)",8,0,0,0,8
1895809,1547460,2025-04-14,House,"House - Third Reading",52,4,4,0,60
1895816,1473064,2025-01-22,Senate,"Senate Regulatory Affairs and Government Efficiency Committee Action (HELD)",0,0,0,0,0
1895821,1495178,2025-02-19,Senate,"Senate Judiciary and Elections Committee Action (DPA)",6,1,0,0,7
1895821,1498247,2025-02-24,Senate,"Senate Rules Committee Action (PFC)",0,0,0,0,0
1895821,1501567,2025-02-27,Senate,"Senate - Committee of the Whole (DPA)",0,0,0,0,0
1895821,1503348,2025-03-03,Senate,"Senate - Third Reading",29,0,1,0,30
1895821,1521460,2025-03-19,House,"House Judiciary Committee Action (DP)",9,0,0,0,9
1895821,1524919,2025-03-24,House,"House Rules Committee Action (C&P)",8,0,0,0,8
1895821,1549523,2025-04-15,House,"House - Third Reading",52,0,8,0,60
1896125,1476703,2025-01-29,Senate,"Senate Public Safety Committee Action (DPA)",6,1,0,0,7
1896125,1492659,2025-02-18,Senate,"Senate Appropriations Committee Action (DPA)",6,3,1,0,10
1896125,1497553,2025-02-24,Senate,"Senate Rules Committee Action (PFC)",0,0,0,0,0
1896125,1500367,2025-02-26,Senate,"Senate - Committee of the Whole (DPA)",0,0,0,0,0
1896125,1501665,2025-02-27,Senate,"Senate - Third Reading",18,11,1,0,30
1896125,1509709,2025-03-10,House,"House Public Safety & Law Enforcement Committee Action (DP)",7,2,5,1,15
1896223,1471783,2025-01-15,Senate,"Senate Judiciary and Elections Committee Action (DPA)",4,3,0,0,7
1896223,1474783,2025-01-27,Senate,"Senate Rules Committee Action (PFC)",0,0,0,0,0
1896223,1487739,2025-02-12,Senate,"Senate - Committee of the Whole (RETAINED)",0,0,0,0,0
1896223,1489140,2025-02-13,Senate,"Senate - Committee of the Whole (DPA)",0,0,0,0,0
1896223,1489141,2025-02-13,Senate,"Motion Senator Ortiz to exclude the Rogers flr amend and include the Fernandez flr amend",10,16,4,0,30
1896223,1489497,2025-02-13,Senate,"Senate - Senator Ortiz to exclude the Rogers flr amend and include the Fernandez flr amend",10,16,4,0,30
1896601,1471794,2025-01-15,Senate,"Senate Government Committee Action (DP)",4,3,0,0,7
1896601,1474773,2025-01-27,Senate,"Senate Rules Committee Action (PFC)",0,0,0,0,0
1896601,1476284,2025-01-29,Senate,"Senate - Committee of the Whole (DP)",0,0,0,0,0
1896601,1478881,2025-02-03,Senate,"Senate - Third Reading",17,12,1,0,30
1896601,1506012,2025-03-05,House,"House Government Committee Action (W/D)",0,0,0,0,0
1896601,1520953,2025-03-19,House,"House Judiciary Committee Action (DPA/SE)",5,2,1,1,9
1896601,1524838,2025-03-24,House,"House Rules Committee Action (C&P)",8,0,0,0,8
1896601,1527740,2025-03-26,House,"House - Committee of the Whole (DPA)",0,0,0,0,0
1896601,1530904,2025-03-31,House,"House - Third Reading",26,30,4,0,60
1896973,1476717,2025-01-29,Senate,"Senate Judiciary and Elections Committee Action (DP)",4,3,0,0,7
1896973,1478873,2025-02-03,Senate,"Senate Rules Committee Action (PFC)",0,0,0,0,0
1896973,1487721,2025-02-12,Senate,"Senate - Committee of the Whole (DP)",0,0,0,0,0
1896973,1501577,2025-02-27,Senate,"Senate - Third Reading",17,11,2,0,30
1896973,1515751,2025-03-12,House,"House Judiciary Committee Action (DP)",6,3,0,0,9
1896973,1518787,2025-03-17,House,"House Rules Committee Action (C&P)",8,0,0,0,8
1896973,1527893,2025-03-26,House,"House - Committee of the Whole (DP)",0,0,0,0,0
1896973,1527894,2025-03-26,House,"House - Representative Marquez  to include the Marquez floor amendment",19,32,9,0,60
1896973,1563544,2025-05-01,House,"House - Third Reading",31,27,2,0,60
1896978,1482441,2025-02-05,Senate,"Senate Public Safety Committee Action (DP)",4,3,0,0,7
1896978,1485085,2025-02-10,Senate,"Senate Rules Committee Action (PFC)",0,0,0,0,0
1896978,1495081,2025-02-20,Senate,"Senate - Committee of the Whole (DP)",0,0,0,0,0
1896978,1495082,2025-02-20,Senate,"Senate - Third Reading",17,12,1,0,30
1896982,1471735,2025-01-15,Senate,"Senate Government Committee Action (DP)",4,2,1,0,7
1896982,1474775,2025-01-27,Senate,"Senate Rules Committee Action (PFC)",0,0,0,0,0
1896982,1476298,2025-01-29,Senate,"Senate - Committee of the Whole (DP)",0,0,0,0,0
1896982,1478726,2025-02-03,Senate,"Senate - Third Reading",17,12,1,0,30
1896986,1474975,2025-01-27,Senate,"Senate Finance Committee Action (DP)",5,2,0,0,7
1896986,1478847,2025-02-03,Senate,"Senate Rules Committee Action (PFC)",0,0,0,0,0
1896986,1487611,2025-02-12,Senate,"Senate - Third Reading",18,10,2,0,30
1896996,1476621,2025-01-29,Senate,"Senate Judiciary and Elections Committee Action (DP)",7,0,0,0,7
1896996,1478855,2025-02-03,Senate,"Senate Rules Committee Action (PFC)",0,0,0,0,0
1896996,1487718,2025-02-12,Senate,"Senate - Third Reading",28,0,2,0,30
1896996,1527250,2025-03-26,House,"House Judiciary Committee Action (DP)",7,0,0,2,9
1896996,1532467,2025-04-01,House,"House Rules Committee Action (C&P)",7,0,0,1,8
1896996,1538312,2025-04-07,House,"House - Committee of the Whole (DP)",0,0,0,0,0
1896996,1548540,2025-04-15,House,"Motion Motion by Representative Carbone that pursuant to House Rule 12(P), SB1022 be calendared for an Additional Committee of the Whole for purposes of further amending. Motion passed v/v.",0,0,0,0,0
1896996,1548541,2025-04-15,House,"House - Committee of the Whole (DPA)",0,0,0,0,0
1896996,1551203,2025-04-17,House,"House - Third Reading",32,23,5,0,60
1896996,1560111,2025-04-29,Senate,"Senate - Concurrence",0,0,0,0,0
1896996,1560112,2025-04-29,Senate,"Senate - Third Reading",27,0,3,0,30
1897002,1482444,2025-02-05,Senate,"Senate Public Safety Committee Action (HELD)",0,0,0,0,0
1897002,1488613,2025-02-12,Senate,"Senate Public Safety Committee Action (DP)",4,3,0,0,7
1897002,1490891,2025-02-17,Senate,"Senate Rules Committee Action (PFC)",0,0,0,0,0
1897002,1500271,2025-02-26,Senate,"Senate - Committee of the Whole (DP)",0,0,0,0,0
1897002,1506202,2025-03-05,Senate,"Senate - Third Reading",16,13,1,0,30
1897002,1521449,2025-03-19,House,"House Transportation & Infrastructure Committee Action (DP)",4,1,1,1,7
1897005,1475012,2025-01-27,Senate,"Senate Finance Committee Action (DP)",5,2,0,0,7
1897005,1478799,2025-02-03,Senate,"Senate Rules Committee Action (PFC)",0,0,0,0,0
1897005,1487578,2025-02-12,Senate,"Senate - Committee of the Whole (DP)",0,0,0,0,0
1897005,1501504,2025-02-27,Senate,"Senate - Third Reading",17,11,2,0,30
1897005,1520427,2025-03-18,House,"House Commerce Committee Action (DP)",6,4,0,0,10
1897005,1524859,2025-03-24,House,"House Rules Committee Action (C&P)",8,0,0,0,8
1897005,1532750,2025-04-01,House,"House - Committee of the Whole (DP)",0,0,0,0,0
1897005,1559094,2025-04-28,House,"House - Third Reading",31,25,4,0,60
1897014,1471834,2025-01-15,Senate,"Senate Education Committee Action (DP)",7,0,0,0,7
1897014,1475611,2025-01-28,Senate,"Senate Appropriations Committee Action (DP)",9,0,1,0,10
1897014,1478889,2025-02-03,Senate,"Senate Rules Committee Action (PFC)",0,0,0,0,0
1897014,1487947,2025-02-12,Senate,"Senate - Third Reading",28,0,2,0,30
1897014,1504830,2025-03-04,House,"House Education Committee Action (DP)",9,1,1,1,12
1897014,1516704,2025-03-12,House,"House Appropriations Committee Action (DP)",16,0,0,2,18
1897014,1519246,2025-03-17,House,"House Rules Committee Action (C&P)",8,0,0,0,8
1897014,1546179,2025-01-15,Senate,"Senate Education-Archived and Renamed Education and Transportation as of 04/01/2025 Committee Action (DP)",7,0,0,0,7
1897014,1549562,2025-04-15,House,"House - Third Reading",52,0,8,0,60
1897018,1482379,2025-02-05,Senate,"Senate Public Safety Committee Action (DP)",4,3,0,0,7
1897018,1484949,2025-02-10,Senate,"Senate Rules Committee Action (PFC)",0,0,0,0,0
1897018,1495100,2025-02-20,Senate,"Senate - Committee of the Whole (DP)",0,0,0,0,0
1897018,1495101,2025-02-20,Senate,"Senate - Third Reading",16,13,1,0,30
1897018,1516421,2025-03-12,House,"House Transportation & Infrastructure Committee Action (DP)",4,1,1,1,7
1897018,1518941,2025-03-17,House,"House Rules Committee Action (C&P)",8,0,0,0,8
1897018,1547532,2025-04-14,House,"House - Committee of the Whole (DP)",0,0,0,0,0
1897029,1474978,2025-01-27,Senate,"Senate Finance Committee Action (DP)",4,3,0,0,7
1897029,1478826,2025-02-03,Senate,"Senate Rules Committee Action (PFC)",0,0,0,0,0
1897029,1487552,2025-02-12,Senate,"Senate - Committee of the Whole (DP)",0,0,0,0,0
1897029,1501485,2025-02-27,Senate,"Senate - Third Reading",17,11,2,0,30
1897029,1526737,2025-03-25,House,"House Commerce Committee Action (DP)",6,4,0,0,10
1897029,1531377,2025-03-31,House,"House Rules Committee Action (C&P)",7,0,0,1,8
1897029,1534400,2025-04-02,House,"House - Committee of the Whole (DP)",0,0,0,0,0
1897029,1565012,2025-05-05,House,"House - Third Reading",29,28,3,0,60
1897029,1565013,2025-05-05,House,"House - Reconsider Third Reading",0,0,0,0,0
1897029,1565014,2025-05-05,House,"House - Third Reading",31,26,3,0,60
1897033,1476737,2025-01-29,Senate,"Senate Judiciary and Elections Committee Action (DP)",4,3,0,0,7
1897033,1478835,2025-02-03,Senate,"Senate Rules Committee Action (PFC)",0,0,0,0,0
1897033,1487755,2025-02-12,Senate,"Senate - Committee of the Whole (DP)",0,0,0,0,0
1897033,1501563,2025-02-27,Senate,"Senate - Third Reading",17,11,2,0,30
1897033,1515854,2025-03-12,House,"House Judiciary Committee Action (DP)",6,3,0,0,9
1897033,1518438,2025-03-17,House,"House Rules Committee Action (C&P)",8,0,0,0,8
1897033,1527513,2025-03-26,House,"House - Committee of the Whole (DP)",0,0,0,0,0
1897033,1563579,2025-05-01,House,"House - Third Reading",31,25,4,0,60
1897039,1474995,2025-01-27,Senate,"Senate Finance Committee Action (DPA)",5,2,0,0,7
1897039,1478815,2025-02-03,Senate,"Senate Rules Committee Action (PFC)",0,0,0,0,0
1897039,1487663,2025-02-12,Senate,"Senate - Committee of the Whole (DPA)",0,0,0,0,0
1897039,1501534,2025-02-27,Senate,"Senate - Third Reading",17,11,2,0,30
1897044,1499396,2025-02-25,Senate,"Senate Appropriations Committee Action (DP)",9,0,1,0,10
1897048,1476671,2025-01-29,Senate,"Senate Public Safety Committee Action (DP)",4,2,1,0,7
1897048,1478804,2025-02-03,Senate,"Senate Rules Committee Action (PFC)",0,0,0,0,0
1897048,1487720,2025-02-12,Senate,"Senate - Committee of the Whole (RETAINED)",0,0,0,0,0
1897048,1495007,2025-02-20,Senate,"Senate - Committee of the Whole (DPA)",0,0,0,0,0
1897048,1495008,2025-02-20,Senate,"Senate - Third Reading",17,12,1,0,30
1897048,1528045,2025-03-26,House,"House Science & Technology Committee Action (DPA)",4,3,0,2,9
1897048,1532454,2025-04-01,House,"House Rules Committee Action (C&P)",7,0,0,1,8
1897048,1536106,2025-04-03,House,"House - Committee of the Whole (DPA)",0,0,0,0,0
1897048,1543523,2025-04-10,House,"House - Third Reading",32,26,2,0,60
1897048,1548368,2025-04-15,Senate,"Senate - Concurrence",0,0,0,0,0
1897048,1548946,2025-04-15,Senate,"Senate - Third Reading",17,13,0,0,30
1897049,1488608,2025-02-12,Senate,"Senate Public Safety Committee Action (DPA)",4,2,1,0,7
1897049,1490993,2025-02-17,Senate,"Senate Rules Committee Action (PFC)",0,0,0,0,0
1897049,1499186,2025-02-25,Senate,"Senate - Committee of the Whole (DPA)",0,0,0,0,0
1897049,1507306,2025-03-06,Senate,"Senate - Third Reading",15,9,6,0,30
1897160,1473232,2025-01-22,Senate,"Senate Education Committee Action (DP)",4,3,0,0,7
1897160,1474765,2025-01-27,Senate,"Senate Rules Committee Action (PFC)",0,0,0,0,0
1897160,1509550,2025-03-10,Senate,"Senate - Third Reading",13,13,4,0,30
1897160,1545700,2025-01-22,Senate,"Senate Education-Archived and Renamed Education and Transportation as of 04/01/2025 Committee Action (DP)",4,3,0,0,7
1897232,1473031,2025-01-22,House,"House Government Committee Action (DP)",7,0,0,0,7
1897232,1474801,2025-01-27,House,"House Rules Committee Action (C&P)",8,0,0,0,8
1897232,1479699,2025-02-04,House,"House - Committee of the Whole (DPA)",0,0,0,0,0
1897232,1483107,2025-02-06,House,"House - Third Reading",55,3,2,0,60
1897250,1476582,2025-01-29,House,"House Federalism, Military Affairs & Elections Committee Action (DP)",5,0,2,0,7
1897250,1478781,2025-02-03,House,"House Rules Committee Action (C&P)",8,0,0,0,8
1897250,1487586,2025-02-12,House,"House - Third Reading",32,27,1,0,60
1897250,1507027,2025-03-05,Senate,"Senate Judiciary and Elections Committee Action (DP)",4,3,0,0,7
1897250,1518774,2025-03-17,Senate,"Senate Rules Committee Action (PFC)",0,0,0,0,0
1897250,1535775,2025-04-03,Senate,"Senate - Committee of the Whole (DP)",0,0,0,0,0
1897250,1539490,2025-04-08,Senate,"Senate - Third Reading",17,11,2,0,30
1897271,1473224,2025-01-22,House,"House Federalism, Military Affairs & Elections Committee Action (DP)",5,2,0,0,7
1897271,1474802,2025-01-27,House,"House Rules Committee Action (C&P)",8,0,0,0,8
1897271,1482136,2025-02-05,House,"House - Committee of the Whole (DP)",0,0,0,0,0
1897271,1483092,2025-02-06,House,"House - Third Reading",37,19,4,0,60
1897271,1507026,2025-03-05,Senate,"Senate Judiciary and Elections Committee Action (DP)",4,3,0,0,7
1897271,1518829,2025-03-17,Senate,"Senate Rules Committee Action (PFC)",0,0,0,0,0
1897271,1536006,2025-04-03,Senate,"Senate - Committee of the Whole (DP)",0,0,0,0,0
1897271,1543990,2025-04-10,Senate,"Senate - Third Reading",16,12,2,0,30
1897282,1488957,2025-02-13,House,"House Commerce Committee Action (W/D)",0,0,0,0,0
1897282,1493887,2025-02-19,House,"House Federalism, Military Affairs & Elections Committee Action (DP)",4,3,0,0,7
1897303,1473222,2025-01-22,House,"House Federalism, Military Affairs & Elections Committee Action (DP)",5,2,0,0,7
1897303,1474805,2025-01-27,House,"House Rules Committee Action (C&P)",8,0,0,0,8
1897303,1482129,2025-02-05,House,"House - Committee of the Whole (DP)",0,0,0,0,0
1897303,1483044,2025-02-06,House,"House - Third Reading",34,23,3,0,60
1897303,1507215,2025-03-05,Senate,"Senate Judiciary and Elections Committee Action (DP)",5,2,0,0,7
1897303,1518865,2025-03-17,Senate,"Senate Rules Committee Action (PFC)",0,0,0,0,0
1897303,1535793,2025-04-03,Senate,"Senate - Committee of the Whole (DP)",0,0,0,0,0
1897303,1543723,2025-04-10,Senate,"Senate - Third Reading",17,12,1,0,30
1897313,1476516,2025-01-29,House,"House Federalism, Military Affairs & Elections Committee Action (HELD)",0,0,0,0,0
1897313,1493932,2025-02-19,House,"House Federalism, Military Affairs & Elections Committee Action (DPA)",4,3,0,0,7
1897313,1497266,2025-02-24,House,"House Rules Committee Action (C&P)",7,0,0,1,8
1897313,1498734,2025-02-25,House,"House - Committee of the Whole (RET ON CAL)",0,0,0,0,0
1897313,1499948,2025-02-26,House,"House - Committee of the Whole (DPA)",0,0,0,0,0
1897313,1503460,2025-03-03,House,"House - Third Reading",32,26,2,0,60
1897313,1528596,2025-03-26,Senate,"Senate Judiciary and Elections Committee Action (DP)",4,3,0,0,7
1897319,1476891,2025-01-29,House,"House Transportation & Infrastructure Committee Action (DP)",7,0,0,0,7
1897319,1497434,2025-02-24,House,"House Rules Committee Action (C&P)",7,0,0,1,8
1897319,1500915,2025-02-26,House,"House - Third Reading",46,12,2,0,60
1897319,1506907,2025-03-05,Senate,"Senate Public Safety Committee Action (DP)",6,0,1,0,7
1897319,1518587,2025-03-17,Senate,"Senate Rules Committee Action (PFC)",0,0,0,0,0
1897319,1550126,2025-04-16,Senate,"Senate - Third Reading",29,0,1,0,30
1897399,1476616,2025-01-29,Senate,"Senate Judiciary and Elections Committee Action (DPA)",7,0,0,0,7
1897399,1478836,2025-02-03,Senate,"Senate Rules Committee Action (PFC)",0,0,0,0,0
1897399,1518645,2025-03-17,Senate,"Senate - Committee of the Whole (DPA)",0,0,0,0,0
1897399,1518646,2025-03-17,Senate,"Senate - Third Reading",12,15,2,0,29
1897407,1482301,2025-02-05,Senate,"Senate Judiciary and Elections Committee Action (DP)",7,0,0,0,7
1897407,1485117,2025-02-10,Senate,"Senate Rules Committee Action (PFC)",0,0,0,0,0
1897407,1501624,2025-02-27,Senate,"Senate - Third Reading",27,1,2,0,30
1897407,1527264,2025-03-26,House,"House Judiciary Committee Action (DP)",7,0,0,2,9
1897407,1531293,2025-03-31,House,"House Appropriations Committee Action (DPA)",18,0,0,0,18
1897407,1534800,2025-04-01,House,"House Rules Committee Action (C&P)",7,0,0,1,8
1897407,1538683,2025-04-07,House,"House - Committee of the Whole (DPA)",0,0,0,0,0
1897407,1543476,2025-04-10,House,"House - Third Reading",58,0,2,0,60
1897407,1548388,2025-04-15,Senate,"Senate - Concurrence",0,0,0,0,0
1897407,1548948,2025-04-15,Senate,"Senate - Third Reading",27,3,0,0,30
1897415,1486824,2025-02-11,Senate,"Senate Natural Resources Committee Action (DP)",4,2,2,0,8
1897415,1490912,2025-02-17,Senate,"Senate Rules Committee Action (PFC)",0,0,0,0,0
1897415,1518950,2025-03-17,Senate,"Senate - Committee of the Whole (DP)",0,0,0,0,0
1897415,1518951,2025-03-17,Senate,"Senate - Third Reading",20,6,3,0,29
1897415,1527767,2025-03-26,House,"House Government Committee Action (DP)",7,0,0,0,7
1897415,1547338,2025-04-14,House,"House Rules Committee Action (HELD)",0,0,0,0,0
1897423,1486867,2025-02-11,Senate,"Senate Natural Resources Committee Action (DPA)",4,2,2,0,8
1897423,1490949,2025-02-17,Senate,"Senate Rules Committee Action (PFC)",0,0,0,0,0
1897423,1518656,2025-03-17,Senate,"Senate - Committee of the Whole (DPA)",0,0,0,0,0
1897423,1518657,2025-03-17,Senate,"Senate - Third Reading",20,7,2,0,29
1897423,1527688,2025-03-26,House,"House Government Committee Action (DP)",6,1,0,0,7
1897423,1547334,2025-04-14,House,"House Rules Committee Action (HELD)",0,0,0,0,0
1897429,1472803,2025-01-21,Senate,"Senate Appropriations Committee Action (DP)",8,1,1,0,10
1897429,1474776,2025-01-27,Senate,"Senate Rules Committee Action (PFC)",0,0,0,0,0
1897429,1504796,2025-03-04,Senate,"Senate - Committee of the Whole (RETAINED)",0,0,0,0,0
1897429,1507890,2025-03-06,Senate,"Senate - Committee of the Whole (DPA)",0,0,0,0,0
1897429,1509549,2025-03-10,Senate,"Senate - Third Reading",25,2,3,0,30
1897434,1476558,2025-01-29,Senate,"Senate Judiciary and Elections Committee Action (DP)",7,0,0,0,7
1897434,1478737,2025-02-03,Senate,"Senate Rules Committee Action (PFC)",0,0,0,0,0
1897434,1487435,2025-02-12,Senate,"Senate - Third Reading",19,9,2,0,30
1897434,1509753,2025-03-10,House,"House Land, Agriculture & Rural Affairs Committee Action (DP)",5,2,1,1,9
1897434,1518911,2025-03-17,House,"House Rules Committee Action (C&P)",8,0,0,0,8
1897434,1548805,2025-04-15,House,"House - Committee of the Whole (DP)",0,0,0,0,0
1897434,1567347,2025-05-07,House,"House - Third Reading",34,22,4,0,60
1898621,1480686,2025-02-05,Senate,"Senate Government Committee Action (DPA)",4,3,0,0,7
1898621,1485022,2025-02-10,Senate,"Senate Rules Committee Action (PFC)",0,0,0,0,0
1898621,1495131,2025-02-20,Senate,"Senate - Committee of the Whole (DPA)",0,0,0,0,0
1898621,1495132,2025-02-20,Senate,"Senate - Third Reading",17,12,1,0,30
1898621,1521599,2025-03-19,House,"House Federalism, Military Affairs & Elections Committee Action (DP)",4,2,0,1,7
1898621,1524779,2025-03-24,House,"House Rules Committee Action (C&P)",8,0,0,0,8
1898621,1551309,2025-04-17,House,"Motion Motion by Representative Carbone that pursuant to House Rule 12(P), SB1036 be calendared for an Additional Committee of the Whole for purposes of further amending. Motion passed v/v.",0,0,0,0,0
1898621,1551310,2025-04-17,House,"House - Committee of the Whole (DPA)",0,0,0,0,0
1898621,1563724,2025-05-01,House,"House - Third Reading",31,27,2,0,60
1898621,1567368,2025-05-07,Senate,"Senate - Concurrence",0,0,0,0,0
1898621,1567369,2025-05-07,Senate,"Senate - Third Reading",17,9,4,0,30
1900110,1473331,2025-01-22,Senate,"Senate Regulatory Affairs and Government Efficiency Committee Action (DPA)",7,0,0,0,7
1900110,1475192,2025-01-27,Senate,"Senate Rules Committee Action (PFC)",0,0,0,0,0
1900110,1485151,2025-02-10,Senate,"Senate - Committee of the Whole (DPA)",0,0,0,0,0
1900110,1486190,2025-02-11,Senate,"Senate - Third Reading",26,0,4,0,30
1900110,1520460,2025-03-18,House,"House Regulatory Oversight Committee Action (DP)",5,0,0,0,5
1901125,1476625,2025-01-29,Senate,"Senate Judiciary and Elections Committee Action (HELD)",0,0,0,0,0
1901125,1494593,2025-02-19,Senate,"Senate Judiciary and Elections Committee Action (DP)",4,3,0,0,7
1901125,1497569,2025-02-24,Senate,"Senate Rules Committee Action (PFC)",0,0,0,0,0
1901125,1507684,2025-03-06,Senate,"Senate - Committee of the Whole (DP)",0,0,0,0,0
1901125,1509168,2025-03-10,Senate,"Senate - Third Reading",16,11,3,0,30
1901125,1527286,2025-03-26,House,"House Judiciary Committee Action (FAILED)",4,4,0,1,9
1901262,1489216,2025-02-13,House,"House Health & Human Services Committee Action (DP)",7,5,0,0,12
1901262,1497277,2025-02-24,House,"House Rules Committee Action (C&P)",7,0,0,1,8
1901262,1499958,2025-02-26,House,"House - Third Reading",32,27,1,0,60
1901262,1515767,2025-03-12,Senate,"Senate Health and Human Services Committee Action (DP)",3,2,2,0,7
1901262,1518750,2025-03-17,Senate,"Senate Rules Committee Action (PFC)",0,0,0,0,0
1901262,1532649,2025-04-01,Senate,"Senate - Third Reading",17,12,1,0,30
1901319,1479079,2025-02-03,House,"House Public Safety & Law Enforcement Committee Action (DP)",15,0,0,0,15
1901319,1485003,2025-02-10,House,"House Rules Committee Action (C&P)",8,0,0,0,8
1901319,1488667,2025-02-13,House,"House - Third Reading",50,0,10,0,60
1901319,1503713,2025-03-03,Senate,"Senate Finance Committee Action (DP)",6,0,1,0,7
1901319,1518917,2025-03-17,Senate,"Senate Rules Committee Action (PFC)",0,0,0,0,0
1901319,1534364,2025-04-02,Senate,"Senate - Third Reading",27,3,0,0,30
1901379,1480638,2025-02-05,House,"House Ways & Means Committee Action (DP)",8,0,0,1,9
1901379,1485006,2025-02-10,House,"House Rules Committee Action (C&P)",8,0,0,0,8
1901379,1488670,2025-02-13,House,"House - Third Reading",49,2,9,0,60
1901379,1503784,2025-03-03,Senate,"Senate Finance Committee Action (DP)",6,1,0,0,7
1901379,1518746,2025-03-17,Senate,"Senate Rules Committee Action (PFC)",0,0,0,0,0
1901441,1497971,2025-02-24,House,"House Appropriations Committee Action (DP)",14,2,1,1,18
1901441,1500857,2025-02-25,House,"House Rules Committee Action (C&P)",7,0,0,1,8
1901441,1504973,2025-03-04,House,"House - Third Reading",43,15,2,0,60
1901551,1473176,2025-01-22,House,"House Federalism, Military Affairs & Elections Committee Action (DP)",4,3,0,0,7
1901551,1474814,2025-01-27,House,"House Rules Committee Action (C&P)",8,0,0,0,8
1901551,1486183,2025-02-11,House,"House - Third Reading",32,26,2,0,60
1901551,1507015,2025-03-05,Senate,"Senate Judiciary and Elections Committee Action (DP)",4,3,0,0,7
1901551,1518871,2025-03-17,Senate,"Senate Rules Committee Action (PFC)",0,0,0,0,0
1901551,1551112,2025-04-17,Senate,"Senate - Committee of the Whole (DP)",0,0,0,0,0
1901551,1560518,2025-04-29,Senate,"Senate - Third Reading",17,12,1,0,30
1901646,1473186,2025-01-22,House,"House Federalism, Military Affairs & Elections Committee Action (DP)",4,3,0,0,7
1901646,1478812,2025-02-03,House,"House Rules Committee Action (C&P)",8,0,0,0,8
1901646,1486515,2025-02-11,House,"House - Third Reading",32,26,2,0,60
1901646,1507031,2025-03-05,Senate,"Senate Judiciary and Elections Committee Action (DP)",4,3,0,0,7
1902390,1476628,2025-01-29,Senate,"Senate Judiciary and Elections Committee Action (DP)",6,0,1,0,7
1902390,1478865,2025-02-03,Senate,"Senate Rules Committee Action (PFC)",0,0,0,0,0
1902390,1487691,2025-02-12,Senate,"Senate - Third Reading",28,0,2,0,30
1902390,1506529,2025-03-05,House,"House Federalism, Military Affairs & Elections Committee Action (DP)",7,0,0,0,7
1902390,1509311,2025-03-10,House,"House Rules Committee Action (C&P)",6,0,0,2,8
1902390,1517128,2025-03-13,House,"House - Committee of the Whole (DP)",0,0,0,0,0
1902390,1520336,2025-03-18,House,"House - Third Reading",58,0,2,0,60
1902513,1471802,2025-01-15,Senate,"Senate Government Committee Action (DPA)",6,0,1,0,7
1902513,1474951,2025-01-27,Senate,"Senate Rules Committee Action (PFC)",0,0,0,0,0
1902513,1488535,2025-02-12,Senate,"Senate - Committee of the Whole (DPA)",0,0,0,0,0
1902513,1501865,2025-02-27,Senate,"Senate - Third Reading",28,0,2,0,30
1902513,1515709,2025-03-12,House,"House Government Committee Action (DP)",7,0,0,0,7
1902513,1518512,2025-03-17,House,"House Rules Committee Action (C&P)",0,0,0,0,0
1902513,1524917,2025-03-24,House,"House - Third Reading",54,2,4,0,60
1902654,1492658,2025-02-18,House,"House Education Committee Action (DP)",10,0,1,1,12
1902654,1498564,2025-02-25,House,"House Rules Committee Action (C&P)",7,0,0,1,8
1902792,1472696,2025-01-21,House,"House Education Committee Action (DP)",7,3,0,2,12
1902792,1473976,2025-01-22,House,"House Appropriations Committee Action (DP)",10,7,0,1,18
1902792,1474790,2025-01-27,House,"House Rules Committee Action (C&P)",8,0,0,0,8
1902792,1478863,2025-02-03,House,"House - Committee of the Whole (DP)",0,0,0,0,0
1902792,1486559,2025-02-11,House,"House - Third Reading",33,25,2,0,60
1902792,1506477,2025-03-05,Senate,"Senate Education Committee Action (DP)",4,3,0,0,7
1902792,1514267,2025-03-11,Senate,"Senate Appropriations Committee Action (DP)",7,3,0,0,10
1902792,1545824,2025-03-05,Senate,"Senate Education-Archived and Renamed Education and Transportation as of 04/01/2025 Committee Action (DP)",4,3,0,0,7
1902934,1473239,2025-01-22,Senate,"Senate Education Committee Action (DP)",7,0,0,0,7
1902934,1474772,2025-01-27,Senate,"Senate Rules Committee Action (PFC)",0,0,0,0,0
1902934,1478757,2025-02-03,Senate,"Senate - Third Reading",29,1,0,0,30
1902934,1506562,2025-03-05,House,"House Federalism, Military Affairs & Elections Committee Action (DP)",7,0,0,0,7
1902934,1545791,2025-01-22,Senate,"Senate Education-Archived and Renamed Education and Transportation as of 04/01/2025 Committee Action (DP)",7,0,0,0,7
1902934,1547357,2025-04-14,House,"House Rules Committee Action (C&P)",8,0,0,0,8
1903067,1472830,2025-01-21,House,"House Education Committee Action (DPA)",10,0,0,2,12
1903067,1474122,2025-01-22,House,"House Appropriations Committee Action (DPA)",11,5,1,1,18
1903067,1474767,2025-01-27,House,"House Rules Committee Action (C&P)",8,0,0,0,8
1903067,1478764,2025-02-03,House,"House - Committee of the Whole (DPA)",0,0,0,0,0
1903067,1494894,2025-02-20,House,"Motion Motion by Representative Carbone that pursuant to House Rule 12(P), HB2020 be calendared for an Additional Committee of the Whole for purposes of further amending. Motion passed v/v.",0,0,0,0,0
1903067,1494895,2025-02-20,House,"House - Committee of the Whole (DPA)",0,0,0,0,0
1903067,1498842,2025-02-25,House,"House - Third Reading",45,13,2,0,60
1903067,1516245,2025-03-12,Senate,"Senate Education Committee Action (FAILED)",3,3,1,0,7
1903067,1522302,2025-03-19,Senate,"Senate Education Committee Action (DP)",5,2,0,0,7
1903067,1526652,2025-03-25,Senate,"Senate Appropriations Committee Action (DP)",4,2,4,0,10
1903067,1545751,2025-03-19,Senate,"Senate Education-Archived and Renamed Education and Transportation as of 04/01/2025 Committee Action (DP)",5,2,0,0,7
1903196,1494949,2025-02-20,Senate,"Senate Finance Committee Action (W/D)",0,0,0,0,0
1903196,1499360,2025-02-25,Senate,"Senate Appropriations Committee Action (DP)",10,0,0,0,10
1903196,1503527,2025-03-03,Senate,"Senate Rules Committee Action (PFC)",0,0,0,0,0
1903196,1507451,2025-03-06,Senate,"Senate - Committee of the Whole (RETAINED)",0,0,0,0,0
1903196,1509271,2025-03-10,Senate,"Senate - Committee of the Whole (DPA)",0,0,0,0,0
1903196,1517133,2025-03-13,Senate,"Senate - Third Reading",22,5,3,0,30
1903196,1531233,2025-03-31,House,"House Appropriations Committee Action (DP)",14,3,1,0,18
1903326,1472839,2025-01-21,House,"House Education Committee Action (DPA)",10,0,0,2,12
1903326,1474796,2025-01-27,House,"House Rules Committee Action (C&P)",8,0,0,0,8
1903326,1478884,2025-02-03,House,"House - Committee of the Whole (DPA)",0,0,0,0,0
1903326,1483103,2025-02-06,House,"House - Third Reading",52,7,1,0,60
1903326,1528063,2025-03-26,Senate,"Senate Education Committee Action (DP)",7,0,0,0,7
1903326,1531241,2025-03-31,Senate,"Senate Rules Committee Action (PFC)",0,0,0,0,0
1903326,1545616,2025-03-26,Senate,"Senate Education-Archived and Renamed Education and Transportation as of 04/01/2025 Committee Action (DP)",7,0,0,0,7
1903326,1551075,2025-04-17,Senate,"Senate - Committee of the Whole (DP)",0,0,0,0,0
1903326,1559924,2025-04-29,Senate,"Senate - Third Reading",28,1,1,0,30
1904306,1479056,2025-02-03,House,"House Health & Human Services Committee Action (DPA/SE)",11,1,0,0,12
1904306,1484998,2025-02-10,House,"House Rules Committee Action (C&P)",8,0,0,0,8
1904306,1492360,2025-02-18,House,"House - Committee of the Whole (DPA)",0,0,0,0,0
1904306,1495097,2025-02-20,House,"House - Third Reading",57,1,2,0,60
1904306,1505729,2025-03-05,Senate,"Senate Health and Human Services Committee Action (DP)",5,0,2,0,7
1904306,1518754,2025-03-17,Senate,"Senate Rules Committee Action (PFC)",0,0,0,0,0
1904306,1526480,2025-03-25,Senate,"Senate - Third Reading",25,0,4,0,29
1904350,1476313,2025-01-29,House,"House Federalism, Military Affairs & Elections Committee Action (DPA)",6,0,1,0,7
1904350,1478226,2025-01-29,House,"House Federalism, Military Affairs & Elections Committee Action (DPA ON RECON)",6,0,1,0,7
1904350,1478848,2025-02-03,House,"House Rules Committee Action (C&P)",8,0,0,0,8
1904350,1484762,2025-02-10,House,"House - Committee of the Whole (DPA)",0,0,0,0,0
1904350,1486484,2025-02-11,House,"House - Third Reading",58,0,2,0,60
1904350,1528574,2025-03-26,Senate,"Senate Judiciary and Elections Committee Action (HELD)",0,0,0,0,0
1904402,1473056,2025-01-22,House,"House Government Committee Action (DP)",7,0,0,0,7
1904402,1478944,2025-02-03,House,"House Rules Committee Action (C&P)",8,0,0,0,8
1904402,1489485,2025-02-13,House,"House - Third Reading",52,0,8,0,60
1904450,1474963,2025-01-27,House,"House Health & Human Services Committee Action (DP)",10,2,0,0,12
1904450,1518767,2025-03-17,House,"House Rules Committee Action (C&P)",8,0,0,0,8
1904450,1521372,2025-03-19,House,"House - Committee of the Whole (DPA)",0,0,0,0,0
1904450,1522531,2025-03-20,House,"House - Third Reading",39,15,6,0,60
1904598,1472941,2025-01-22,House,"House Judiciary Committee Action (DP)",8,0,0,1,9
1904598,1484915,2025-02-10,House,"House Rules Committee Action (C&P)",8,0,0,0,8
1904598,1488663,2025-02-13,House,"House - Third Reading",52,0,8,0,60
1904646,1485468,2025-02-10,House,"House Health & Human Services Committee Action (DP)",11,0,0,1,12
1904646,1490955,2025-02-17,House,"House Rules Committee Action (C&P)",7,0,0,1,8
1904646,1494789,2025-02-20,House,"House - Third Reading",58,0,2,0,60
1904646,1505896,2025-03-05,Senate,"Senate Regulatory Affairs and Government Efficiency Committee Action (DPA)",6,0,1,0,7
1904646,1518900,2025-03-17,Senate,"Senate Rules Committee Action (PFC)",0,0,0,0,0
1904646,1536130,2025-04-03,Senate,"Senate - Committee of the Whole (DPA)",0,0,0,0,0
1904646,1539909,2025-04-08,Senate,"Senate - Third Reading",28,0,2,0,30
1904646,1560000,2025-04-29,House,"House - Concurrence",0,0,0,0,0
1904646,1560001,2025-04-29,House,"House - Third Reading",51,2,7,0,60
1904692,1471601,2025-01-14,House,"House Education Committee Action (DPA)",7,5,0,0,12
1904692,1473001,2025-01-22,House,"House Judiciary Committee Action (DP)",6,3,0,0,9
1904692,1474819,2025-01-27,House,"House Rules Committee Action (C&P)",8,0,0,0,8
1904692,1477276,2025-01-30,House,"House - Committee of the Whole (DPA)",0,0,0,0,0
1904692,1478900,2025-02-03,House,"House - Third Reading",33,26,1,0,60
1904692,1507000,2025-03-05,Senate,"Senate Judiciary and Elections Committee Action (DP)",4,3,0,0,7
1904741,1471602,2025-01-14,House,"House Education Committee Action (HELD)",0,0,0,0,0
1904741,1492668,2025-02-18,House,"House Education Committee Action (DPA/SE)",11,0,0,1,12
1904741,1497243,2025-02-24,House,"House Rules Committee Action (C&P)",7,0,0,1,8
1904741,1501405,2025-02-27,House,"House - Committee of the Whole (DPA)",0,0,0,0,0
1904741,1503450,2025-03-03,House,"House - Third Reading",46,12,2,0,60
1904741,1528013,2025-03-26,Senate,"Senate Education Committee Action (DP)",5,0,2,0,7
1904741,1531226,2025-03-31,Senate,"Senate Rules Committee Action (PFC)",0,0,0,0,0
1904741,1545573,2025-03-26,Senate,"Senate Education-Archived and Renamed Education and Transportation as of 04/01/2025 Committee Action (DP)",5,0,2,0,7
1905319,1493927,2025-02-19,House,"House Federalism, Military Affairs & Elections Committee Action (DPA/SE)",4,3,0,0,7
1905319,1497276,2025-02-24,House,"House Rules Committee Action (C&P)",7,0,0,1,8
1905319,1498758,2025-02-25,House,"House - Committee of the Whole (DPA)",0,0,0,0,0
1905319,1500478,2025-02-26,House,"House - Third Reading",35,24,1,0,60
1905439,1472713,2025-01-21,House,"House Commerce Committee Action (DP)",10,0,0,0,10
1905439,1474818,2025-01-27,House,"House Rules Committee Action (C&P)",8,0,0,0,8
1905439,1479682,2025-02-04,House,"House - Third Reading",59,0,1,0,60
1905439,1505882,2025-03-05,Senate,"Senate Regulatory Affairs and Government Efficiency Committee Action (DPA)",7,0,0,0,7
1905439,1518938,2025-03-17,Senate,"Senate Rules Committee Action (PFC)",0,0,0,0,0
1905439,1544545,2025-04-10,Senate,"Senate - Committee of the Whole (DPA)",0,0,0,0,0
1905439,1548469,2025-04-15,Senate,"Senate - Third Reading",30,0,0,0,30
1905439,1559146,2025-04-28,House,"House - Concurrence",0,0,0,0,0
1905439,1559147,2025-04-28,House,"House - Third Reading",55,0,5,0,60
1905478,1492655,2025-02-18,House,"House Regulatory Oversight Committee Action (DPA)",3,2,0,0,5
1905478,1497352,2025-02-24,House,"House Rules Committee Action (C&P)",7,0,0,1,8
1905478,1498849,2025-02-25,House,"House - Committee of the Whole (DPA)",0,0,0,0,0
1905478,1500010,2025-02-26,House,"House - Third Reading",17,42,1,0,60
1905478,1500527,2025-02-26,House,"House - Reconsider Third Reading",0,0,0,0,0
1905521,1473014,2025-01-22,House,"House Judiciary Committee Action (DP)",7,2,0,0,9
1905521,1503145,2025-03-03,House,"House Rules Committee Action (C&P)",8,0,0,0,8
1905521,1506201,2025-03-05,House,"House - Committee of the Whole (DP)",0,0,0,0,0
1905521,1509608,2025-03-10,House,"House - Third Reading",26,30,4,0,60
1905521,1509609,2025-03-10,House,"House - Reconsider Third Reading",0,0,0,0,0
1905521,1515973,2025-03-12,House,"Motion Motion by Representative Carbone that pursuant to House Rule 12(P), HB2043 be calendared for an Additional Committee of the Whole for purposes of further amending. Motion passed v/v.",0,0,0,0,0
1905521,1515974,2025-03-12,House,"House - Committee of the Whole (DPA)",0,0,0,0,0
1905521,1516918,2025-03-13,House,"House - Third Reading",45,11,4,0,60
1905562,1473185,2025-01-22,House,"House Federalism, Military Affairs & Elections Committee Action (DP)",7,0,0,0,7
1905562,1474787,2025-01-27,House,"House Rules Committee Action (C&P)",8,0,0,0,8
1905562,1479565,2025-02-04,House,"House - Third Reading",59,0,1,0,60
1905562,1507003,2025-03-05,Senate,"Senate Judiciary and Elections Committee Action (HELD)",0,0,0,0,0
1905562,1516223,2025-03-12,Senate,"Senate Judiciary and Elections Committee Action (DP)",7,0,0,0,7
1905562,1518868,2025-03-17,Senate,"Senate Rules Committee Action (PFC)",0,0,0,0,0
1905562,1532636,2025-04-01,Senate,"Senate - Third Reading",14,15,1,0,30
1905605,1473207,2025-01-22,House,"House Federalism, Military Affairs & Elections Committee Action (DP)",7,0,0,0,7
1905605,1474793,2025-01-27,House,"House Rules Committee Action (C&P)",8,0,0,0,8
1905605,1480863,2025-02-05,House,"House - Committee of the Whole (DP)",0,0,0,0,0
1905605,1483070,2025-02-06,House,"House - Third Reading",59,0,1,0,60
1905605,1507012,2025-03-05,Senate,"Senate Judiciary and Elections Committee Action (HELD)",0,0,0,0,0
1905605,1528600,2025-03-26,Senate,"Senate Judiciary and Elections Committee Action (DP)",4,2,1,0,7
1905605,1531265,2025-03-31,Senate,"Senate Rules Committee Action (PFC)",0,0,0,0,0
1905605,1551078,2025-04-17,Senate,"Senate - Committee of the Whole (DP)",0,0,0,0,0
1905605,1560413,2025-04-29,Senate,"Senate - Third Reading",17,12,1,0,30
1905685,1480680,2025-02-05,House,"House Ways & Means Committee Action (DP)",8,0,0,1,9
1905685,1484994,2025-02-10,House,"House Rules Committee Action (C&P)",8,0,0,0,8
1905685,1488655,2025-02-13,House,"House - Third Reading",53,0,7,0,60
1905685,1503870,2025-03-03,Senate,"Senate Finance Committee Action (DP)",7,0,0,0,7
1905685,1518879,2025-03-17,Senate,"Senate Rules Committee Action (PFC)",0,0,0,0,0
1905725,1493046,2025-02-19,House,"House Judiciary Committee Action (DPA/SE)",6,3,0,0,9
1905725,1497321,2025-02-24,House,"House Rules Committee Action (C&P)",7,0,0,1,8
1905725,1498783,2025-02-25,House,"House - Committee of the Whole (DPA)",0,0,0,0,0
1905725,1499982,2025-02-26,House,"House - Third Reading",32,27,1,0,60
1905766,1472711,2025-01-21,House,"House Commerce Committee Action (DP)",10,0,0,0,10
1905766,1474789,2025-01-27,House,"House Rules Committee Action (C&P)",8,0,0,0,8
1905766,1482173,2025-02-05,House,"House - Committee of the Whole (DPA)",0,0,0,0,0
1905766,1483101,2025-02-06,House,"House - Third Reading",48,11,1,0,60
1905766,1527612,2025-03-26,Senate,"Senate Regulatory Affairs and Government Efficiency Committee Action (DPA/SE)",7,0,0,0,7
1905766,1531301,2025-03-31,Senate,"Senate Rules Committee Action (PFC)",0,0,0,0,0
1905766,1551089,2025-04-17,Senate,"Senate - Committee of the Whole (RETAINED)",0,0,0,0,0
1905766,1555296,2025-04-23,Senate,"Senate - Committee of the Whole (DPA)",0,0,0,0,0
1905766,1562267,2025-04-30,Senate,"Senate - Committee of the Whole (RETAINED)",0,0,0,0,0
1905808,1480640,2025-02-05,House,"House Ways & Means Committee Action (DP)",8,0,0,1,9
1905808,1484860,2025-02-10,House,"House Rules Committee Action (C&P)",8,0,0,0,8
1905808,1488631,2025-02-13,House,"House - Third Reading",49,3,8,0,60
1905808,1503471,2025-03-03,Senate,"Senate Finance Committee Action (DP)",6,1,0,0,7
1905808,1518867,2025-03-17,Senate,"Senate Rules Committee Action (PFC)",0,0,0,0,0
1905849,1488107,2025-02-12,House,"House Federalism, Military Affairs & Elections Committee Action (DPA/SE)",4,3,0,0,7
1905849,1490882,2025-02-17,House,"House Rules Committee Action (C&P)",5,2,0,1,8
1905849,1494751,2025-02-20,House,"House - Committee of the Whole (DPA)",0,0,0,0,0
1905849,1499124,2025-02-25,House,"House - Third Reading",33,27,0,0,60
1905969,1480634,2025-02-05,House,"House Ways & Means Committee Action (DP)",7,1,0,1,9
1905969,1485021,2025-02-10,House,"House Rules Committee Action (C&P)",8,0,0,0,8
1905969,1491328,2025-02-17,House,"House - Third Reading",58,1,1,0,60
1905969,1503822,2025-03-03,Senate,"Senate Finance Committee Action (DP)",7,0,0,0,7
1905969,1518795,2025-03-17,Senate,"Senate Rules Committee Action (PFC)",0,0,0,0,0
1907323,1479905,2025-02-04,House,"House Regulatory Oversight Committee Action (DP)",3,2,0,0,5
1907323,1485119,2025-02-10,House,"House Rules Committee Action (C&P)",8,0,0,0,8
1907323,1493513,2025-02-19,House,"House - Committee of the Whole (DP)",0,0,0,0,0
1907323,1495159,2025-02-20,House,"House - Third Reading",31,27,2,0,60
1907344,1473054,2025-01-22,House,"House Government Committee Action (DP)",4,3,0,0,7
1907344,1498559,2025-02-25,House,"House Rules Committee Action (C&P)",5,2,0,1,8
1907344,1499961,2025-02-26,House,"House - Committee of the Whole (DP)",0,0,0,0,0
1907344,1506130,2025-03-05,House,"House - Third Reading",32,26,2,0,60
1907344,1521029,2025-03-19,Senate,"Senate Government Committee Action (DP)",4,3,0,0,7
1907344,1524765,2025-03-24,Senate,"Senate Rules Committee Action (PFC)",5,4,0,0,9
1907386,1480140,2025-02-04,House,"House Commerce Committee Action (DP)",10,0,0,0,10
1907386,1484897,2025-02-10,House,"House Rules Committee Action (C&P)",8,0,0,0,8
1907386,1489255,2025-02-13,House,"House - Third Reading",51,1,8,0,60
1907445,1486431,2025-02-11,House,"House Regulatory Oversight Committee Action (DP)",5,0,0,0,5
1907445,1490982,2025-02-17,House,"House Rules Committee Action (C&P)",7,0,0,1,8
1907445,1498461,2025-02-24,House,"House - Third Reading",59,0,1,0,60
1907445,1527826,2025-03-26,Senate,"Senate Health and Human Services Committee Action (DP)",6,1,0,0,7
1907445,1530927,2025-03-31,Senate,"Senate Rules Committee Action (PFC)",0,0,0,0,0
1907445,1551158,2025-04-17,Senate,"Senate - Committee of the Whole (DP)",0,0,0,0,0
1907445,1560141,2025-04-29,Senate,"Senate - Third Reading",12,17,1,0,30
1907445,1567320,2025-05-07,Senate,"Motion Senator Payne moved that a portion of Senate Rule 13-A be suspended for the purpose of reconsideration of House Bill 2052 beyond the time period allowed for reconsideration. Motion carried.",0,0,0,0,0
1907445,1567321,2025-05-07,Senate,"Senate - Reconsider Third Reading",0,0,0,0,0
1907445,1567322,2025-05-07,Senate,"Senate - Committee of the Whole (DPA)",0,0,0,0,0
1907445,1567323,2025-05-07,Senate,"Senate - Third Reading",13,13,4,0,30
1907463,1472723,2025-01-21,House,"House Commerce Committee Action (DP)",10,0,0,0,10
1907463,1474807,2025-01-27,House,"House Rules Committee Action (C&P)",8,0,0,0,8
1907463,1483094,2025-02-06,House,"House - Third Reading",59,0,1,0,60
1907463,1503809,2025-03-03,Senate,"Senate Finance Committee Action (HELD)",0,0,0,0,0
1907463,1526033,2025-03-24,Senate,"Senate Finance Committee Action (DPA)",6,1,0,0,7
1907463,1531116,2025-03-31,Senate,"Senate Rules Committee Action (PFC)",0,0,0,0,0
1907483,1473192,2025-01-22,House,"House Federalism, Military Affairs & Elections Committee Action (DP)",6,1,0,0,7
1907483,1474806,2025-01-27,House,"House Rules Committee Action (C&P)",8,0,0,0,8
1907483,1482216,2025-02-05,House,"House - Committee of the Whole (DP)",0,0,0,0,0
1907483,1483128,2025-02-06,House,"House - Third Reading",36,23,1,0,60
1907483,1507033,2025-03-05,Senate,"Senate Judiciary and Elections Committee Action (HELD)",0,0,0,0,0
1907483,1516284,2025-03-12,Senate,"Senate Judiciary and Elections Committee Action (DP)",4,3,0,0,7
1907483,1518802,2025-03-17,Senate,"Senate Rules Committee Action (PFC)",0,0,0,0,0
1907483,1551040,2025-04-17,Senate,"Senate - Committee of the Whole (DP)",0,0,0,0,0
1907483,1560422,2025-04-29,Senate,"Senate - Third Reading",17,12,1,0,30
1907502,1479732,2025-02-04,House,"House Commerce Committee Action (DP)",10,0,0,0,10
1907502,1485068,2025-02-10,House,"House Rules Committee Action (HELD)",0,0,0,0,0
1907502,1498560,2025-02-25,House,"House Rules Committee Action (C&P)",7,0,0,1,8
1907502,1505968,2025-03-05,House,"House - Committee of the Whole (DPA)",0,0,0,0,0
1907502,1509182,2025-03-10,House,"House - Third Reading",8,48,4,0,60
1907546,1473053,2025-01-22,House,"House Government Committee Action (DPA)",4,3,0,0,7
1907546,1474821,2025-01-27,House,"House Rules Committee Action (C&P)",5,3,0,0,8
1907546,1482229,2025-02-05,House,"House - Committee of the Whole (DPA)",0,0,0,0,0
1907546,1482230,2025-02-05,House,"House - Representative Contreras P  to show the bill failed to pass",25,31,4,0,60
1907546,1487729,2025-02-12,House,"House - Third Reading",32,27,1,0,60
1907546,1505787,2025-03-05,Senate,"Senate Government Committee Action (DP)",4,3,0,0,7
1907546,1518769,2025-03-17,Senate,"Senate Rules Committee Action (PFC)",5,4,0,0,9
1907546,1535883,2025-04-03,Senate,"Senate - Committee of the Whole (DP)",0,0,0,0,0
1907546,1535884,2025-04-03,Senate,"Motion Senator Kuby to show that HB 2062 failed to pass",12,17,1,0,30
1907546,1536471,2025-04-03,Senate,"Senate - Senator Kuby to show that HB 2062 failed to pass",12,17,1,0,30
1907546,1539608,2025-04-08,Senate,"Senate - Third Reading",17,11,2,0,30
1907564,1475708,2025-01-28,House,"House Regulatory Oversight Committee Action (DP)",3,2,0,0,5
1907586,1492122,2025-02-18,House,"House Natural Resources, Energy & Water Committee Action (DP)",5,4,1,0,10
1907586,1497320,2025-02-24,House,"House Rules Committee Action (C&P)",7,0,0,1,8
1907586,1498776,2025-02-25,House,"House - Committee of the Whole (DPA)",0,0,0,0,0
1907586,1500459,2025-02-26,House,"House - Third Reading",32,27,1,0,60
1907586,1527251,2025-03-25,Senate,"Senate Natural Resources Committee Action (HELD)",0,0,0,0,0
1907675,1473257,2025-01-22,House,"House Government Committee Action (DPA)",6,1,0,0,7
1907675,1475166,2025-01-27,House,"House Rules Committee Action (C&P)",8,0,0,0,8
1907675,1482725,2025-02-05,House,"House - Committee of the Whole (DPA)",0,0,0,0,0
1907675,1483039,2025-02-06,House,"House - Third Reading",41,18,1,0,60
1907703,1480179,2025-02-04,House,"House Commerce Committee Action (DP)",7,2,1,0,10
1907703,1485046,2025-02-10,House,"House Rules Committee Action (C&P)",8,0,0,0,8
1907703,1492395,2025-02-18,House,"House - Committee of the Whole (DP)",0,0,0,0,0
1907703,1499129,2025-02-25,House,"House - Third Reading",37,23,0,0,60
1907703,1520956,2025-03-19,Senate,"Senate Regulatory Affairs and Government Efficiency Committee Action (DPA/SE)",4,2,1,0,7
1907703,1524724,2025-03-24,Senate,"Senate Rules Committee Action (PFC)",0,0,0,0,0
1907703,1535934,2025-04-03,Senate,"Senate - Committee of the Whole (RETAINED)",0,0,0,0,0
1907703,1541685,2025-04-09,Senate,"Senate - Committee of the Whole (RETAINED)",0,0,0,0,0
1907703,1551340,2025-04-17,Senate,"Senate - Committee of the Whole (DPA)",0,0,0,0,0
1907703,1566351,2025-05-06,Senate,"Senate - Third Reading",21,7,2,0,30
1907703,1567278,2025-05-07,House,"House - Concurrence",0,0,0,0,0
1907703,1567279,2025-05-07,House,"House - Third Reading",39,19,2,0,60
1907720,1475674,2025-01-28,House,"House Regulatory Oversight Committee Action (DPA)",3,2,0,0,5
1907770,1485234,2025-02-10,House,"House Health & Human Services Committee Action (DPA)",10,2,0,0,12
1907770,1490917,2025-02-17,House,"House Rules Committee Action (C&P)",7,0,0,1,8
1907770,1494762,2025-02-20,House,"House - Committee of the Whole (DPA)",0,0,0,0,0
1907770,1499058,2025-02-25,House,"House - Third Reading",41,19,0,0,60
1907770,1515711,2025-03-12,Senate,"Senate Regulatory Affairs and Government Efficiency Committee Action (DP)",6,1,0,0,7
1907770,1518765,2025-03-17,Senate,"Senate Rules Committee Action (PFC)",0,0,0,0,0
1907770,1534578,2025-04-02,Senate,"Senate - Third Reading",29,1,0,0,30
1907789,1471441,2025-01-14,House,"House Education Committee Action (DPA)",8,4,0,0,12
1907789,1474817,2025-01-27,House,"House Rules Committee Action (C&P)",8,0,0,0,8
1907789,1477274,2025-01-30,House,"House - Committee of the Whole (DPA)",0,0,0,0,0
1907789,1478874,2025-02-03,House,"House - Third Reading",35,24,1,0,60
1907789,1506328,2025-03-05,Senate,"Senate Education Committee Action (DP)",4,3,0,0,7
1907789,1514260,2025-03-11,Senate,"Senate Appropriations Committee Action (DP)",6,4,0,0,10
1907789,1539773,2025-04-08,Senate,"Senate Rules Committee Action (PFC)",0,0,0,0,0
1907789,1545517,2025-03-05,Senate,"Senate Education-Archived and Renamed Education and Transportation as of 04/01/2025 Committee Action (DP)",4,3,0,0,7
1907789,1551035,2025-04-17,Senate,"Senate - Committee of the Whole (DP)",0,0,0,0,0
1907789,1551036,2025-04-17,Senate,"Senate - Senator Sundareshan to include Miranda flr amendment",11,14,5,0,30
1907789,1560390,2025-04-29,Senate,"Senate - Third Reading",17,12,1,0,30
1907813,1472710,2025-01-21,House,"House Education Committee Action (DP)",10,0,0,2,12
1907813,1474780,2025-01-27,House,"House Rules Committee Action (C&P)",8,0,0,0,8
1907813,1478814,2025-02-03,House,"House - Third Reading",59,0,1,0,60
1907856,1488068,2025-02-12,House,"House Federalism, Military Affairs & Elections Committee Action (DPA)",4,3,0,0,7
1907856,1490851,2025-02-17,House,"House Rules Committee Action (C&P)",5,2,0,1,8
1907856,1498628,2025-02-25,House,"House - Committee of the Whole (DPA)",0,0,0,0,0
1907856,1500249,2025-02-26,House,"House - Third Reading",32,27,1,0,60
1907856,1516274,2025-03-12,Senate,"Senate Judiciary and Elections Committee Action (DP)",4,3,0,0,7
1907856,1518884,2025-03-17,Senate,"Senate Rules Committee Action (PFC)",5,4,0,0,9
1907856,1535899,2025-04-03,Senate,"Senate - Committee of the Whole (DP)",0,0,0,0,0
1907856,1539579,2025-04-08,Senate,"Senate - Third Reading",17,11,2,0,30
1907882,1475706,2025-01-28,House,"House Education Committee Action (HELD)",0,0,0,0,0
1907882,1480086,2025-02-04,House,"House Education Committee Action (DP)",7,4,0,1,12
1907882,1485012,2025-02-10,House,"House Rules Committee Action (C&P)",8,0,0,0,8
1907882,1493475,2025-02-19,House,"House - Committee of the Whole (DP)",0,0,0,0,0
1907882,1499069,2025-02-25,House,"House - Third Reading",33,27,0,0,60
1907882,1528097,2025-03-26,Senate,"Senate Education Committee Action (DP)",4,2,1,0,7
1907882,1531191,2025-03-31,Senate,"Senate Rules Committee Action (PFC)",0,0,0,0,0
1907882,1541787,2025-04-09,Senate,"Senate - Committee of the Whole (DP)",0,0,0,0,0
1907882,1541788,2025-04-09,Senate,"Senate - Third Reading",17,13,0,0,30
1907882,1545500,2025-03-26,Senate,"Senate Education-Archived and Renamed Education and Transportation as of 04/01/2025 Committee Action (DP)",4,2,1,0,7
1907950,1471422,2025-01-14,House,"House Education Committee Action (DP)",12,0,0,0,12
1907950,1474887,2025-01-27,House,"House Rules Committee Action (C&P)",8,0,0,0,8
1907950,1478735,2025-02-03,House,"House - Third Reading",59,0,1,0,60
1907950,1528137,2025-03-26,Senate,"Senate Education Committee Action (DPA/SE)",4,3,0,0,7
1907950,1531014,2025-03-31,Senate,"Senate Rules Committee Action (PFC)",0,0,0,0,0
1907950,1545862,2025-03-26,Senate,"Senate Education-Archived and Renamed Education and Transportation as of 04/01/2025 Committee Action (DPA/SE)",4,3,0,0,7
1907950,1551281,2025-04-17,Senate,"Senate - Committee of the Whole (DPA)",0,0,0,0,0
1907950,1560249,2025-04-29,Senate,"Senate - Third Reading",17,12,1,0,30
1907950,1565634,2025-05-06,House,"House - Concurrence",0,0,0,0,0
1907950,1565635,2025-05-06,House,"House - Third Reading",32,23,5,0,60
1907996,1475671,2025-01-28,House,"House Education Committee Action (HELD)",0,0,0,0,0
1907996,1479783,2025-02-04,House,"House Education Committee Action (FAILED)",0,0,0,0,0
1907996,1492319,2025-02-18,House,"House Education Committee Action (DPA/SE)",7,4,1,0,12
1907996,1495519,2025-02-18,House,"House Education Committee Action (DPA/SE ON RECON)",7,4,1,0,12
1907996,1497289,2025-02-24,House,"House Rules Committee Action (C&P)",7,0,0,1,8
1907996,1498772,2025-02-25,House,"House - Committee of the Whole (DPA)",0,0,0,0,0
1907996,1499980,2025-02-26,House,"House - Third Reading",32,27,1,0,60
1907996,1528123,2025-03-26,Senate,"Senate Education Committee Action (DP)",4,2,1,0,7
1907996,1531276,2025-03-31,Senate,"Senate Rules Committee Action (PFC)",0,0,0,0,0
1907996,1541889,2025-04-09,Senate,"Senate - Committee of the Whole (DP)",0,0,0,0,0
1907996,1541890,2025-04-09,Senate,"Senate - Third Reading",17,13,0,0,30
1907996,1545543,2025-03-26,Senate,"Senate Education-Archived and Renamed Education and Transportation as of 04/01/2025 Committee Action (DP)",4,2,1,0,7
1908482,1480606,2025-02-05,House,"House Ways & Means Committee Action (DP)",8,0,0,1,9
1908482,1484981,2025-02-10,House,"House Rules Committee Action (C&P)",8,0,0,0,8
1908482,1488659,2025-02-13,House,"House - Third Reading",53,0,7,0,60
1908482,1503679,2025-03-03,Senate,"Senate Finance Committee Action (DP)",7,0,0,0,7
1908482,1518755,2025-03-17,Senate,"Senate Rules Committee Action (PFC)",0,0,0,0,0
1908720,1472714,2025-01-21,House,"House Commerce Committee Action (DPA)",10,0,0,0,10
1908720,1475169,2025-01-27,House,"House Rules Committee Action (C&P)",8,0,0,0,8
1908720,1479209,2025-02-03,House,"House - Committee of the Whole (DPA)",0,0,0,0,0
1908720,1483580,2025-02-06,House,"House - Third Reading",53,6,1,0,60
1908720,1509695,2025-03-10,Senate,"Senate Finance Committee Action (DPA)",6,1,0,0,7
1908720,1518793,2025-03-17,Senate,"Senate Rules Committee Action (PFC)",0,0,0,0,0
1908720,1535844,2025-04-03,Senate,"Senate - Committee of the Whole (DPA)",0,0,0,0,0
1908720,1542068,2025-04-09,Senate,"Senate - Third Reading",28,2,0,0,30
1908720,1559901,2025-04-29,House,"House - Concurrence",0,0,0,0,0
1908720,1559902,2025-04-29,House,"House - Third Reading",41,14,5,0,60
1909597,1472823,2025-01-21,Senate,"Senate Appropriations Committee Action (DP)",9,0,1,0,10
1909597,1474784,2025-01-27,Senate,"Senate Rules Committee Action (PFC)",0,0,0,0,0
1909597,1478912,2025-02-03,Senate,"Senate - Third Reading",30,0,0,0,30
1909597,1516378,2025-03-12,House,"House Appropriations Committee Action (DP)",15,0,0,3,18
1909597,1524930,2025-03-24,House,"House Rules Committee Action (C&P)",8,0,0,0,8
1909597,1548916,2025-04-15,House,"House - Third Reading",52,0,8,0,60
1909716,1473035,2025-01-22,House,"House Government Committee Action (DPA)",7,0,0,0,7
1909716,1474794,2025-01-27,House,"House Rules Committee Action (C&P)",8,0,0,0,8
1909716,1487672,2025-02-12,House,"House - Committee of the Whole (DPA)",0,0,0,0,0
1909716,1491257,2025-02-17,House,"House - Third Reading",56,3,1,0,60
1909716,1521530,2025-03-19,Senate,"Senate Judiciary and Elections Committee Action (DP)",7,0,0,0,7
1909716,1524712,2025-03-24,Senate,"Senate Rules Committee Action (PFC)",0,0,0,0,0
1909716,1544421,2025-04-10,Senate,"Senate - Third Reading",28,1,1,0,30
1909758,1480689,2025-02-05,House,"House Ways & Means Committee Action (DP)",8,0,0,1,9
1909758,1498558,2025-02-25,House,"House Rules Committee Action (C&P)",7,0,0,1,8
1909758,1499929,2025-02-26,House,"House - Committee of the Whole (RET ON CAL)",0,0,0,0,0
1909758,1503458,2025-03-03,House,"House - Committee of the Whole (DPA)",0,0,0,0,0
1909758,1506078,2025-03-05,House,"House - Third Reading",58,0,2,0,60
1909758,1519525,2025-03-17,Senate,"Senate Finance Committee Action (DP)",6,0,1,0,7
1909758,1524709,2025-03-24,Senate,"Senate Rules Committee Action (PFC)",0,0,0,0,0
1909758,1566064,2025-05-06,Senate,"Senate - Third Reading",25,3,2,0,30
1909797,1494564,2025-02-19,Senate,"Senate Judiciary and Elections Committee Action (DPA/SE)",7,0,0,0,7
1909797,1497593,2025-02-24,Senate,"Senate Rules Committee Action (PFC)",0,0,0,0,0
1909797,1501388,2025-02-27,Senate,"Senate - Committee of the Whole (DPA)",0,0,0,0,0
1909797,1503440,2025-03-03,Senate,"Senate - Third Reading",24,5,1,0,30
1909797,1520754,2025-03-19,House,"House Government Committee Action (DPA/SE)",6,1,0,0,7
1909797,1524831,2025-03-24,House,"House Rules Committee Action (C&P)",8,0,0,0,8
1909797,1534620,2025-04-02,House,"House - Committee of the Whole (DPA)",0,0,0,0,0
1909797,1567186,2025-05-07,House,"House - Third Reading",49,7,4,0,60
1910240,1474845,2025-01-27,House,"House Land, Agriculture & Rural Affairs Committee Action (DP)",8,0,0,1,9
1910240,1478765,2025-02-03,House,"House Rules Committee Action (C&P)",8,0,0,0,8
1910240,1488908,2025-02-13,House,"House - Third Reading",43,10,7,0,60
1910240,1521123,2025-03-19,Senate,"Senate Government Committee Action (W/D)",0,0,0,0,0
1910240,1527275,2025-03-25,Senate,"Senate Natural Resources Committee Action (DPA/SE)",4,3,1,0,8
1910240,1531250,2025-03-31,Senate,"Senate Rules Committee Action (PFC)",0,0,0,0,0
1910268,1475612,2025-01-28,House,"House Natural Resources, Energy & Water Committee Action (DP)",6,4,0,0,10
1910268,1478858,2025-02-03,House,"House Rules Committee Action (C&P)",8,0,0,0,8
1910268,1487595,2025-02-12,House,"House - Committee of the Whole (DP)",0,0,0,0,0
1910268,1491224,2025-02-17,House,"House - Third Reading",33,26,1,0,60
1910268,1504831,2025-03-04,Senate,"Senate Natural Resources Committee Action (DP)",5,2,1,0,8
1910268,1518851,2025-03-17,Senate,"Senate Rules Committee Action (PFC)",0,0,0,0,0
1910268,1536238,2025-04-03,Senate,"Senate - Committee of the Whole (DP)",0,0,0,0,0
1910268,1542035,2025-04-09,Senate,"Senate - Third Reading",17,13,0,0,30
1910297,1473057,2025-01-22,House,"House Ways & Means Committee Action (DPA)",5,3,0,1,9
1910297,1474839,2025-01-27,House,"House Rules Committee Action (C&P)",8,0,0,0,8
1910297,1477280,2025-01-30,House,"House - Committee of the Whole (DPA)",0,0,0,0,0
1910297,1484862,2025-02-10,House,"House - Third Reading",37,21,2,0,60
1910297,1503717,2025-03-03,Senate,"Senate Finance Committee Action (DP)",4,3,0,0,7
1910297,1514391,2025-03-11,Senate,"Senate Appropriations Committee Action (DP)",6,4,0,0,10
1910329,1476042,2025-01-28,House,"House Natural Resources, Energy & Water Committee Action (DP)",5,4,0,1,10
1910329,1478787,2025-02-03,House,"House Rules Committee Action (C&P)",8,0,0,0,8
1910329,1487581,2025-02-12,House,"House - Third Reading",32,27,1,0,60
1910329,1527262,2025-03-25,Senate,"Senate Natural Resources Committee Action (DP)",4,3,1,0,8
1910329,1531266,2025-03-31,Senate,"Senate Rules Committee Action (PFC)",0,0,0,0,0
1910329,1541936,2025-04-09,Senate,"Senate - Committee of the Whole (DP)",0,0,0,0,0
1910329,1541937,2025-04-09,Senate,"Senate - Third Reading",16,14,0,0,30
1910390,1474813,2025-01-27,House,"House Land, Agriculture & Rural Affairs Committee Action (DPA)",7,0,1,1,9
1910390,1478809,2025-02-03,House,"House Rules Committee Action (C&P)",8,0,0,0,8
1910390,1484857,2025-02-10,House,"House - Committee of the Whole (DPA)",0,0,0,0,0
1910390,1488992,2025-02-13,House,"House - Third Reading",42,11,7,0,60
1910390,1505886,2025-03-05,Senate,"Senate Regulatory Affairs and Government Efficiency Committee Action (DP)",4,3,0,0,7
1910390,1518790,2025-03-17,Senate,"Senate Rules Committee Action (PFC)",0,0,0,0,0
1910390,1535761,2025-04-03,Senate,"Senate - Committee of the Whole (DP)",0,0,0,0,0
1910390,1542178,2025-04-09,Senate,"Senate - Third Reading",16,14,0,0,30
1910420,1474843,2025-01-27,House,"House Land, Agriculture & Rural Affairs Committee Action (DP)",8,0,0,1,9
1910420,1478790,2025-02-03,House,"House Rules Committee Action (C&P)",8,0,0,0,8
1910420,1488858,2025-02-13,House,"House - Third Reading",52,1,7,0,60
1910420,1527581,2025-03-26,Senate,"Senate Government Committee Action (DP)",7,0,0,0,7
1910420,1531291,2025-03-31,Senate,"Senate Rules Committee Action (PFC)",0,0,0,0,0
1910420,1551077,2025-04-17,Senate,"Senate - Committee of the Whole (DPA)",0,0,0,0,0
1910420,1560536,2025-04-29,Senate,"Senate - Third Reading",18,11,1,0,30
1910420,1565972,2025-05-06,House,"House - Concurrence",0,0,0,0,0
1910420,1565973,2025-05-06,House,"House - Third Reading",34,21,5,0,60
1910455,1493007,2025-02-19,House,"House Ways & Means Committee Action (DP)",5,4,0,0,9
1910455,1497230,2025-02-24,House,"House Rules Committee Action (C&P)",7,0,0,1,8
1910455,1500434,2025-02-26,House,"House - Third Reading",32,27,1,0,60
1910455,1509669,2025-03-10,Senate,"Senate Finance Committee Action (DP)",4,3,0,0,7
1910484,1485427,2025-02-10,House,"House Land, Agriculture & Rural Affairs Committee Action (DP)",5,3,0,1,9
1910484,1490856,2025-02-17,House,"House Rules Committee Action (C&P)",7,0,0,1,8
1910484,1495121,2025-02-20,House,"House - Third Reading",36,22,2,0,60
1910484,1504811,2025-03-04,Senate,"Senate Natural Resources Committee Action (DP)",5,2,1,0,8
1910484,1518924,2025-03-17,Senate,"Senate Rules Committee Action (PFC)",0,0,0,0,0
1910484,1551103,2025-04-17,Senate,"Senate - Committee of the Whole (DP)",0,0,0,0,0
1910514,1475970,2025-01-28,House,"House Natural Resources, Energy & Water Committee Action (DP)",5,4,0,1,10
1910514,1479009,2025-02-03,House,"House Rules Committee Action (C&P)",8,0,0,0,8
1910514,1487074,2025-02-11,House,"House - Third Reading",32,26,2,0,60
1910514,1527242,2025-03-25,Senate,"Senate Natural Resources Committee Action (DP)",4,3,1,0,8
1910514,1531310,2025-03-31,Senate,"Senate Rules Committee Action (PFC)",0,0,0,0,0
1910514,1543085,2025-04-09,Senate,"Senate - Committee of the Whole (DP)",0,0,0,0,0
1910514,1543086,2025-04-09,Senate,"Senate - Third Reading",16,14,0,0,30
1910547,1486333,2025-02-11,House,"House Natural Resources, Energy & Water Committee Action (DPA)",6,4,0,0,10
1910547,1497825,2025-02-24,House,"House Appropriations Committee Action (DPA)",11,6,0,1,18
1910547,1499923,2025-02-26,House,"House - Committee of the Whole (DPA)",0,0,0,0,0
1910547,1500424,2025-02-25,House,"House Rules Committee Action (C&P)",7,0,0,1,8
1910547,1509194,2025-03-10,House,"House - Third Reading",31,25,4,0,60
1910547,1527263,2025-03-25,Senate,"Senate Natural Resources Committee Action (DP)",4,3,1,0,8
1910547,1532613,2025-04-01,Senate,"Senate Appropriations Committee Action (DP)",6,3,1,0,10
1910576,1474842,2025-01-27,House,"House Land, Agriculture & Rural Affairs Committee Action (DP)",4,3,0,2,9
1910576,1478838,2025-02-03,House,"House Rules Committee Action (C&P)",8,0,0,0,8
1910576,1487643,2025-02-12,House,"House - Third Reading",36,23,1,0,60
1910576,1505690,2025-03-05,Senate,"Senate Regulatory Affairs and Government Efficiency Committee Action (DP)",4,3,0,0,7
1910576,1518811,2025-03-17,Senate,"Senate Rules Committee Action (PFC)",0,0,0,0,0
1910576,1536187,2025-04-03,Senate,"Senate - Committee of the Whole (DP)",0,0,0,0,0
1910576,1542033,2025-04-09,Senate,"Senate - Third Reading",17,13,0,0,30
1910608,1474906,2025-01-27,House,"House Land, Agriculture & Rural Affairs Committee Action (DP)",8,0,0,1,9
1910608,1478819,2025-02-03,House,"House Rules Committee Action (C&P)",8,0,0,0,8
1910608,1488981,2025-02-13,House,"House - Third Reading",53,0,7,0,60
1910636,1475685,2025-01-28,House,"House Natural Resources, Energy & Water Committee Action (DPA)",6,4,0,0,10
1910636,1478859,2025-02-03,House,"House Rules Committee Action (C&P)",8,0,0,0,8
1910636,1487533,2025-02-12,House,"House - Committee of the Whole (DPA)",0,0,0,0,0
1910636,1491161,2025-02-17,House,"House - Third Reading",33,26,1,0,60
1910672,1476201,2025-01-29,Senate,"Senate Regulatory Affairs and Government Efficiency Committee Action (DP)",6,1,0,0,7
1910672,1478823,2025-02-03,Senate,"Senate Rules Committee Action (PFC)",0,0,0,0,0
1910672,1486572,2025-02-11,Senate,"Senate - Third Reading",26,0,4,0,30
1910672,1520367,2025-03-18,House,"House Regulatory Oversight Committee Action (DP)",5,0,0,0,5
1910672,1524842,2025-03-24,House,"House Rules Committee Action (C&P)",8,0,0,0,8
1910672,1548959,2025-04-15,House,"Motion Motion by Representative Carbone that pursuant to House Rule 12(P), SB1051 be calendared for an Additional Committee of the Whole for purposes of further amending. Motion passed v/v.",0,0,0,0,0
1910672,1548960,2025-04-15,House,"House - Committee of the Whole (RET ON CAL)",0,0,0,0,0
1910672,1551061,2025-04-17,House,"Motion Motion by Representative Carbone that pursuant to House Rule 12(P), SB1051 be calendared for an Additional Committee of the Whole for purposes of further amending. Motion passed v/v.",0,0,0,0,0
1910672,1551062,2025-04-17,House,"House - Committee of the Whole (DPA)",0,0,0,0,0
1910672,1561900,2025-04-30,House,"House - Third Reading",47,0,13,0,60
1910672,1565930,2025-05-06,Senate,"Senate - Concurrence",0,0,0,0,0
1910672,1565931,2025-05-06,Senate,"Senate - Third Reading",26,2,2,0,30
1910817,1474989,2025-01-27,Senate,"Senate Finance Committee Action (DPA)",4,3,0,0,7
1910817,1478841,2025-02-03,Senate,"Senate Rules Committee Action (PFC)",0,0,0,0,0
1910817,1489033,2025-02-13,Senate,"Senate - Committee of the Whole (DPA)",0,0,0,0,0
1910817,1500071,2025-02-26,Senate,"Senate - Third Reading",20,7,3,0,30
1910965,1476659,2025-01-29,Senate,"Senate Public Safety Committee Action (FAILED)",3,4,0,0,7
1911115,1492662,2025-02-18,House,"House Commerce Committee Action (HELD)",0,0,0,0,0
1911262,1479148,2025-02-03,Senate,"Senate Finance Committee Action (DPA)",4,3,0,0,7
1911262,1485095,2025-02-10,Senate,"Senate Rules Committee Action (PFC)",0,0,0,0,0
1911262,1499025,2025-02-25,Senate,"Senate - Committee of the Whole (DPA)",0,0,0,0,0
1911262,1499798,2025-02-26,Senate,"Senate - Third Reading",17,11,2,0,30
1911262,1521094,2025-03-19,House,"House Ways & Means Committee Action (DP)",5,4,0,0,9
1911262,1524830,2025-03-24,House,"House Rules Committee Action (C&P)",8,0,0,0,8
1911262,1527801,2025-03-26,House,"House - Committee of the Whole (DP)",0,0,0,0,0
1911262,1530894,2025-03-31,House,"House - Third Reading",31,25,4,0,60
1911410,1476197,2025-01-29,Senate,"Senate Health and Human Services Committee Action (DP)",4,3,0,0,7
1911410,1478813,2025-02-03,Senate,"Senate Rules Committee Action (PFC)",0,0,0,0,0
1911410,1501086,2025-02-27,Senate,"Senate - Committee of the Whole (DPA)",0,0,0,0,0
1911410,1503557,2025-03-03,Senate,"Senate - Third Reading",17,12,1,0,30
1911560,1482324,2025-02-05,Senate,"Senate Judiciary and Elections Committee Action (DP)",4,2,1,0,7
1911560,1485063,2025-02-10,Senate,"Senate Rules Committee Action (PFC)",0,0,0,0,0
1911560,1507553,2025-03-06,Senate,"Senate - Committee of the Whole (DPA)",0,0,0,0,0
1911560,1509540,2025-03-10,Senate,"Senate - Third Reading",17,10,3,0,30
1911560,1525134,2025-03-24,House,"House Public Safety & Law Enforcement Committee Action (DP)",7,6,1,1,15
1911560,1531399,2025-03-31,House,"House Rules Committee Action (C&P)",4,3,0,1,8
1911560,1541428,2025-04-09,House,"House - Committee of the Whole (DPA)",0,0,0,0,0
1911560,1566986,2025-05-07,House,"Motion Motion by Representative Carbone that pursuant to House Rule 12(P), SB1053 be calendared for an Additional Committee of the Whole for purposes of further amending. Motion passed v/v.",0,0,0,0,0
1911560,1567348,2025-05-07,House,"House - Committee of the Whole (DPA)",0,0,0,0,0
1911707,1476635,2025-01-29,Senate,"Senate Judiciary and Elections Committee Action (DP)",4,3,0,0,7
1911707,1478833,2025-02-03,Senate,"Senate Rules Committee Action (PFC)",0,0,0,0,0
1911707,1498901,2025-02-25,Senate,"Senate - Committee of the Whole (DP)",0,0,0,0,0
1911707,1500046,2025-02-26,Senate,"Senate - Third Reading",17,11,2,0,30
1911707,1516312,2025-03-12,House,"House Federalism, Military Affairs & Elections Committee Action (DP)",4,3,0,0,7
1911707,1518847,2025-03-17,House,"House Rules Committee Action (C&P)",8,0,0,0,8
1911707,1526577,2025-03-25,House,"House - Committee of the Whole (DP)",0,0,0,0,0
1911707,1564990,2025-05-05,House,"House - Third Reading",32,25,3,0,60
1911942,1474973,2025-01-27,Senate,"Senate Finance Committee Action (DP)",6,1,0,0,7
1911942,1478890,2025-02-03,Senate,"Senate Rules Committee Action (PFC)",0,0,0,0,0
1911942,1487735,2025-02-12,Senate,"Senate - Third Reading",22,6,2,0,30
1911942,1528168,2025-03-26,House,"House Ways & Means Committee Action (W/D)",0,0,0,0,0
1911942,1530370,2025-03-27,House,"House Land, Agriculture & Rural Affairs Committee Action (DPA/SE)",5,2,1,1,9
1912011,1494445,2025-02-19,House,"House Transportation & Infrastructure Committee Action (DPA/SE)",7,0,0,0,7
1912011,1498059,2025-02-24,House,"House Rules Committee Action (C&P)",7,0,0,1,8
1912011,1501646,2025-02-27,House,"House - Committee of the Whole (DPA)",0,0,0,0,0
1912011,1504410,2025-03-04,House,"House - Third Reading",35,23,2,0,60
1912046,1491242,2025-02-17,Senate,"Senate Judiciary and Elections Committee Action (W/D)",0,0,0,0,0
1912046,1493921,2025-02-19,Senate,"Senate Public Safety Committee Action (DPA/SE)",7,0,0,0,7
1912046,1497543,2025-02-24,Senate,"Senate Rules Committee Action (PFC)",0,0,0,0,0
1912046,1500334,2025-02-26,Senate,"Senate - Committee of the Whole (DPA)",0,0,0,0,0
1912046,1501692,2025-02-27,Senate,"Senate - Third Reading",22,7,1,0,30
1912046,1526707,2025-03-25,House,"House Commerce Committee Action (DPA/SE)",6,2,1,1,10
1912046,1547311,2025-04-14,House,"House Rules Committee Action (C&P)",8,0,0,0,8
1912079,1486854,2025-02-11,Senate,"Senate Appropriations Committee Action (DPA)",7,2,1,0,10
1912079,1491147,2025-02-17,Senate,"Senate Rules Committee Action (PFC)",0,0,0,0,0
1912079,1503189,2025-03-03,Senate,"Senate - Committee of the Whole (DPA)",0,0,0,0,0
1912079,1506151,2025-03-05,Senate,"Senate - Third Reading",22,7,1,0,30
1912079,1525116,2025-03-24,House,"House Public Safety & Law Enforcement Committee Action (DP)",8,3,3,1,15
1912079,1530985,2025-03-31,House,"House Appropriations Committee Action (DPA/SE)",10,7,1,0,18
1912114,1482732,2025-02-05,Senate,"Senate Public Safety Committee Action (HELD)",0,0,0,0,0
1912114,1493620,2025-02-19,Senate,"Senate Public Safety Committee Action (DPA)",7,0,0,0,7
1912114,1497777,2025-02-24,Senate,"Senate Rules Committee Action (PFC)",0,0,0,0,0
1912114,1500692,2025-02-26,Senate,"Senate - Committee of the Whole (DPA)",0,0,0,0,0
1912114,1501530,2025-02-27,Senate,"Senate - Third Reading",20,9,1,0,30
1912114,1511745,2025-03-10,House,"House Public Safety & Law Enforcement Committee Action (DP)",9,4,1,1,15
1912114,1518803,2025-03-17,House,"House Rules Committee Action (C&P)",8,0,0,0,8
1912114,1525100,2025-03-24,House,"House - Committee of the Whole (DP)",0,0,0,0,0
1912114,1527145,2025-03-25,House,"House - Third Reading",38,20,2,0,60
1912147,1476230,2025-01-29,House,"House Government Committee Action (DP)",4,3,0,0,7
1912147,1478754,2025-02-03,House,"House Rules Committee Action (C&P)",4,3,0,1,8
1912147,1487471,2025-02-12,House,"House - Committee of the Whole (DPA)",0,0,0,0,0
1912147,1492029,2025-02-18,House,"House - Third Reading",33,27,0,0,60
1912147,1509734,2025-03-10,Senate,"Senate Military Affairs and Border Security Committee Action (DPA)",4,2,1,0,7
1912147,1518814,2025-03-17,Senate,"Senate Rules Committee Action (PFC)",5,4,0,0,9
1912147,1536126,2025-04-03,Senate,"Senate - Committee of the Whole (DPA)",0,0,0,0,0
1912147,1536127,2025-04-03,Senate,"Senate - Senator Miranda to show that HB 2099 failed to pass",12,17,1,0,30
1912147,1541844,2025-04-09,Senate,"Senate - Third Reading",17,13,0,0,30
1912147,1558998,2025-04-28,House,"House - Concurrence",0,0,0,0,0
1912147,1558999,2025-04-28,House,"House - Third Reading",32,23,5,0,60
1912215,1476509,2025-01-29,Senate,"Senate Public Safety Committee Action (DPA)",7,0,0,0,7
1912215,1479239,2025-02-03,Senate,"Senate Rules Committee Action (PFC)",0,0,0,0,0
1912215,1489623,2025-02-13,Senate,"Senate - Committee of the Whole (DPA)",0,0,0,0,0
1912215,1500245,2025-02-26,Senate,"Senate - Third Reading",24,4,2,0,30
1912215,1528065,2025-03-26,House,"House Transportation & Infrastructure Committee Action (HELD)",0,0,0,0,0
1912250,1473004,2025-01-22,Senate,"Senate Regulatory Affairs and Government Efficiency Committee Action (DP)",6,1,0,0,7
1912250,1474762,2025-01-27,Senate,"Senate Rules Committee Action (PFC)",0,0,0,0,0
1912250,1476255,2025-01-29,Senate,"Senate - Committee of the Whole (DP)",0,0,0,0,0
1912250,1478739,2025-02-03,Senate,"Senate - Third Reading",26,4,0,0,30
1912250,1515752,2025-03-12,House,"House Judiciary Committee Action (DP)",6,2,0,1,9
1912250,1524875,2025-03-24,House,"House Rules Committee Action (C&P)",8,0,0,0,8
1912250,1548932,2025-04-15,House,"House - Third Reading",25,27,8,0,60
1912250,1548933,2025-04-15,House,"House - Reconsider Third Reading",0,0,0,0,0
1912250,1567164,2025-05-07,House,"House - Third Reading",35,23,2,0,60
1912351,1474929,2025-01-27,House,"House Public Safety & Law Enforcement Committee Action (DP)",14,0,1,0,15
1914858,1474987,2025-01-27,Senate,"Senate Federalism Committee Action (DPA)",4,3,0,0,7
1914858,1485035,2025-02-10,Senate,"Senate Rules Committee Action (PFC)",4,2,1,0,7
1914858,1497758,2025-02-24,Senate,"Senate - Committee of the Whole (DPA)",0,0,0,0,0
1914858,1497759,2025-02-24,Senate,"Senate - Third Reading",17,13,0,0,30
1914858,1518572,2025-03-17,House,"House Land, Agriculture & Rural Affairs Committee Action (DP)",6,2,0,1,9
1914858,1524845,2025-03-24,House,"House Rules Committee Action (C&P)",5,3,0,0,8
1914858,1532946,2025-04-01,House,"House - Committee of the Whole (DP)",0,0,0,0,0
1914858,1549110,2025-04-15,House,"House - Third Reading",31,21,8,0,60
1914894,1475644,2025-01-28,House,"House Natural Resources, Energy & Water Committee Action (DP)",10,0,0,0,10
1914894,1477601,2025-01-29,House,"House Appropriations Committee Action (DP)",14,0,0,4,18
1914894,1478806,2025-02-03,House,"House Rules Committee Action (C&P)",8,0,0,0,8
1914894,1487543,2025-02-12,House,"House - Committee of the Whole (DP)",0,0,0,0,0
1914894,1488901,2025-02-13,House,"House - Third Reading",53,0,7,0,60
1914894,1527277,2025-03-25,Senate,"Senate Natural Resources Committee Action (DPA)",6,0,2,0,8
1914894,1532624,2025-04-01,Senate,"Senate Appropriations Committee Action (DP)",9,0,1,0,10
1914928,1480409,2025-02-04,Senate,"Senate Appropriations Committee Action (DP)",6,3,1,0,10
1914928,1484988,2025-02-10,Senate,"Senate Rules Committee Action (PFC)",0,0,0,0,0
1914963,1476687,2025-01-29,Senate,"Senate Judiciary and Elections Committee Action (DP)",4,3,0,0,7
1914963,1478776,2025-02-03,Senate,"Senate Rules Committee Action (PFC)",0,0,0,0,0
1914963,1498759,2025-02-25,Senate,"Senate - Committee of the Whole (DP)",0,0,0,0,0
1914963,1499978,2025-02-26,Senate,"Senate - Third Reading",17,11,2,0,30
1914963,1521571,2025-03-19,House,"House Federalism, Military Affairs & Elections Committee Action (DP)",3,2,1,1,7
1914963,1532301,2025-04-01,House,"House Rules Committee Action (C&P)",7,0,0,1,8
1914963,1541794,2025-04-09,House,"House - Committee of the Whole (DP)",0,0,0,0,0
1914963,1564920,2025-05-05,House,"House - Third Reading",32,25,3,0,60
1914998,1474979,2025-01-27,Senate,"Senate Finance Committee Action (DP)",4,3,0,0,7
1914998,1478878,2025-02-03,Senate,"Senate Rules Committee Action (PFC)",4,3,0,0,7
1914998,1498942,2025-02-25,Senate,"Senate - Committee of the Whole (DPA)",0,0,0,0,0
1914998,1500121,2025-02-26,Senate,"Senate - Third Reading",17,11,2,0,30
1914998,1520294,2025-03-18,House,"House Commerce Committee Action (DP)",6,4,0,0,10
1915033,1494975,2025-02-20,Senate,"Senate Finance Committee Action (W/D)",0,0,0,0,0
1915033,1499387,2025-02-25,Senate,"Senate Appropriations Committee Action (DPA/SE)",7,3,0,0,10
1915033,1503563,2025-03-03,Senate,"Senate Rules Committee Action (PFC)",0,0,0,0,0
1915033,1507533,2025-03-06,Senate,"Senate - Committee of the Whole (DPA)",0,0,0,0,0
1915033,1509551,2025-03-10,Senate,"Senate - Third Reading",18,9,3,0,30
1915065,1492205,2025-02-18,House,"House Natural Resources, Energy & Water Committee Action (DPA/SE)",10,0,0,0,10
1915065,1497268,2025-02-24,House,"House Rules Committee Action (C&P)",7,0,0,1,8
1915065,1501386,2025-02-27,House,"House - Committee of the Whole (DPA)",0,0,0,0,0
1915065,1509275,2025-03-10,House,"House - Third Reading",44,12,4,0,60
1915101,1492057,2025-02-18,House,"House Natural Resources, Energy & Water Committee Action (DPA/SE)",10,0,0,0,10
1915101,1497291,2025-02-24,House,"House Rules Committee Action (C&P)",7,0,0,1,8
1915101,1501446,2025-02-27,House,"House - Committee of the Whole (DPA)",0,0,0,0,0
1915101,1509112,2025-03-10,House,"House - Third Reading",50,6,4,0,60
1915101,1527448,2025-03-25,Senate,"Senate Natural Resources Committee Action (DPA)",6,0,2,0,8
1915101,1531269,2025-03-31,Senate,"Senate Rules Committee Action (PFC)",0,0,0,0,0
1915101,1541828,2025-04-09,Senate,"Senate - Committee of the Whole (DPA)",0,0,0,0,0
1915101,1541829,2025-04-09,Senate,"Senate - Third Reading",29,1,0,0,30
1915101,1559749,2025-04-29,House,"House - Concurrence",0,0,0,0,0
1915101,1560292,2025-04-29,House,"House - Third Reading",43,12,5,0,60
1915135,1492115,2025-02-18,House,"House Natural Resources, Energy & Water Committee Action (DPA/SE)",10,0,0,0,10
1915135,1497287,2025-02-24,House,"House Rules Committee Action (C&P)",7,0,0,1,8
1915164,1482392,2025-02-05,Senate,"Senate Judiciary and Elections Committee Action (DPA)",4,3,0,0,7
1915164,1485105,2025-02-10,Senate,"Senate Rules Committee Action (PFC)",0,0,0,0,0
1915164,1501163,2025-02-27,Senate,"Senate - Committee of the Whole (DPA)",0,0,0,0,0
1915164,1503694,2025-03-03,Senate,"Senate - Third Reading",17,12,1,0,30
1915164,1521550,2025-03-19,House,"House Federalism, Military Affairs & Elections Committee Action (DISC/HELD)",5,1,0,1,7
1915164,1528102,2025-03-26,House,"House Federalism, Military Affairs & Elections Committee Action (DPA)",4,3,0,0,7
1915276,1482390,2025-02-05,House,"House Appropriations Committee Action (DP)",11,6,0,1,18
1915276,1490958,2025-02-17,House,"House Rules Committee Action (C&P)",7,0,0,1,8
1915276,1494823,2025-02-20,House,"House - Committee of the Whole (DP)",0,0,0,0,0
1915276,1498712,2025-02-25,House,"House - Third Reading",33,27,0,0,60
1915276,1520941,2025-03-19,Senate,"Senate Regulatory Affairs and Government Efficiency Committee Action (DP)",4,3,0,0,7
1915276,1539684,2025-04-08,Senate,"Senate Rules Committee Action (PFC)",0,0,0,0,0
1915276,1551024,2025-04-17,Senate,"Senate - Committee of the Whole (DP)",0,0,0,0,0
1915276,1560325,2025-04-29,Senate,"Senate - Third Reading",17,12,1,0,30
1915287,1475008,2025-01-27,Senate,"Senate Finance Committee Action (DP)",6,1,0,0,7
1915287,1478816,2025-02-03,Senate,"Senate Rules Committee Action (PFC)",0,0,0,0,0
1915287,1484794,2025-02-10,Senate,"Senate - Committee of the Whole (DP)",0,0,0,0,0
1915287,1486524,2025-02-11,Senate,"Senate - Third Reading",17,9,4,0,30
1915287,1505981,2025-03-05,House,"House Ways & Means Committee Action (DP)",5,4,0,0,9
1915298,1474976,2025-01-27,Senate,"Senate Finance Committee Action (DP)",6,0,1,0,7
1915298,1478910,2025-02-03,Senate,"Senate Rules Committee Action (PFC)",0,0,0,0,0
1915298,1489060,2025-02-13,Senate,"Senate - Committee of the Whole (RETAINED)",0,0,0,0,0
1915298,1498949,2025-02-25,Senate,"Senate - Committee of the Whole (DP)",0,0,0,0,0
1915298,1500086,2025-02-26,Senate,"Senate - Third Reading",17,12,1,0,30
1915298,1515793,2025-03-12,House,"House Ways & Means Committee Action (DP)",6,0,1,2,9
1915298,1518872,2025-03-17,House,"House Rules Committee Action (C&P)",8,0,0,0,8
1915298,1525019,2025-03-24,House,"House - Committee of the Whole (DP)",0,0,0,0,0
1915298,1526536,2025-03-25,House,"House - Third Reading",38,20,2,0,60
1915313,1485380,2025-02-10,House,"House Health & Human Services Committee Action (DISC/HELD)",0,0,0,0,0
1915313,1491593,2025-02-17,House,"House Health & Human Services Committee Action (DPA)",12,0,0,0,12
1915313,1497322,2025-02-24,House,"House Rules Committee Action (C&P)",7,0,0,1,8
1915313,1501076,2025-02-27,House,"House - Committee of the Whole (DPA)",0,0,0,0,0
1915313,1503555,2025-03-03,House,"House - Third Reading",54,4,2,0,60
1915337,1476245,2025-01-29,House,"House Judiciary Committee Action (DP)",9,0,0,0,9
1915337,1478807,2025-02-03,House,"House Rules Committee Action (C&P)",8,0,0,0,8
1915337,1484792,2025-02-10,House,"House - Third Reading",55,0,5,0,60
1915337,1507001,2025-03-05,Senate,"Senate Judiciary and Elections Committee Action (DP)",7,0,0,0,7
1915337,1518926,2025-03-17,Senate,"Senate Rules Committee Action (PFC)",0,0,0,0,0
1915337,1526541,2025-03-25,Senate,"Senate - Third Reading",25,0,4,0,29
1915349,1479084,2025-02-03,House,"House Health & Human Services Committee Action (DPA)",12,0,0,0,12
1915349,1485059,2025-02-10,House,"House Rules Committee Action (C&P)",8,0,0,0,8
1915349,1491305,2025-02-17,House,"House - Committee of the Whole (DPA)",0,0,0,0,0
1915349,1492354,2025-02-18,House,"House - Third Reading",60,0,0,0,60
1915375,1476119,2025-01-29,House,"House Judiciary Committee Action (DP)",6,2,1,0,9
1915375,1478849,2025-02-03,House,"House Rules Committee Action (C&P)",8,0,0,0,8
1915375,1486488,2025-02-11,House,"House - Committee of the Whole (DPA)",0,0,0,0,0
1915375,1487550,2025-02-12,House,"House - Third Reading",39,20,1,0,60
1915375,1507092,2025-03-05,Senate,"Senate Judiciary and Elections Committee Action (DP)",4,3,0,0,7
1915375,1518857,2025-03-17,Senate,"Senate Rules Committee Action (PFC)",0,0,0,0,0
1915375,1534405,2025-04-02,Senate,"Senate - Third Reading",17,13,0,0,30
1915384,1494483,2025-02-19,House,"House Transportation & Infrastructure Committee Action (DPA)",6,0,1,0,7
1915384,1497372,2025-02-24,House,"House Rules Committee Action (C&P)",7,0,0,1,8
1915384,1498721,2025-02-25,House,"House - Committee of the Whole (RET ON CAL)",0,0,0,0,0
1915384,1500001,2025-02-26,House,"House - Committee of the Whole (DPA)",0,0,0,0,0
1915384,1500002,2025-02-26,House,"House - Representative Austin to include the Austin flr amendment failed by RCV",26,31,3,0,60
1915384,1505508,2025-03-04,House,"House - Third Reading",34,24,2,0,60
1915384,1522074,2025-03-19,Senate,"Senate Public Safety Committee Action (DPA)",5,1,1,0,7
1915384,1525125,2025-03-24,Senate,"Senate Rules Committee Action (PFC)",0,0,0,0,0
1915384,1541587,2025-04-09,Senate,"Senate - Committee of the Whole (DPA)",0,0,0,0,0
1915384,1543181,2025-04-09,Senate,"Senate - Third Reading",27,3,0,0,30
1915384,1559257,2025-04-28,House,"House - Concurrence",0,0,0,0,0
1915384,1559258,2025-04-28,House,"House - Third Reading",32,23,5,0,60
1915401,1485414,2025-02-10,House,"House Land, Agriculture & Rural Affairs Committee Action (DP)",6,1,0,2,9
1915401,1490916,2025-02-17,House,"House Rules Committee Action (C&P)",7,0,0,1,8
1915401,1494747,2025-02-20,House,"House - Third Reading",34,24,2,0,60
1915411,1485392,2025-02-10,House,"House Health & Human Services Committee Action (DP)",8,4,0,0,12
1915411,1490944,2025-02-17,House,"House Rules Committee Action (C&P)",7,0,0,1,8
1915411,1494773,2025-02-20,House,"House - Committee of the Whole (DP)",0,0,0,0,0
1915411,1498791,2025-02-25,House,"House - Third Reading",35,25,0,0,60
1915411,1515750,2025-03-12,Senate,"Senate Health and Human Services Committee Action (DP)",3,2,2,0,7
1915411,1518842,2025-03-17,Senate,"Senate Rules Committee Action (PFC)",0,0,0,0,0
1915411,1536019,2025-04-03,Senate,"Senate - Committee of the Whole (DP)",0,0,0,0,0
1915411,1541881,2025-04-09,Senate,"Senate - Third Reading",17,13,0,0,30
1915425,1486387,2025-02-11,House,"House Natural Resources, Energy & Water Committee Action (DP)",8,2,0,0,10
1915425,1490867,2025-02-17,House,"House Rules Committee Action (C&P)",7,0,0,1,8
1915425,1493561,2025-02-19,House,"House - Committee of the Whole (RET ON CAL)",0,0,0,0,0
1915425,1494701,2025-02-20,House,"House - Committee of the Whole (DPA)",0,0,0,0,0
1915425,1499126,2025-02-25,House,"House - Third Reading",56,4,0,0,60
1915425,1520377,2025-03-18,Senate,"Senate Natural Resources Committee Action (DP)",8,0,0,0,8
1915425,1524784,2025-03-24,Senate,"Senate Rules Committee Action (PFC)",0,0,0,0,0
1915425,1534567,2025-04-02,Senate,"Senate - Third Reading",30,0,0,0,30
1915437,1480658,2025-02-05,House,"House Ways & Means Committee Action (DP)",6,2,0,1,9
1915437,1484940,2025-02-10,House,"House Rules Committee Action (C&P)",8,0,0,0,8
1915437,1495031,2025-02-20,House,"House - Committee of the Whole (RET ON CAL)",0,0,0,0,0
1915437,1499782,2025-02-26,House,"House - Committee of the Whole (DP)",0,0,0,0,0
1915437,1503590,2025-03-03,House,"House - Third Reading",34,24,2,0,60
1915437,1519427,2025-03-17,Senate,"Senate Finance Committee Action (DPA)",6,1,0,0,7
1915437,1524731,2025-03-24,Senate,"Senate Rules Committee Action (PFC)",0,0,0,0,0
1915437,1541722,2025-04-09,Senate,"Senate - Committee of the Whole (DPA)",0,0,0,0,0
1915437,1542463,2025-04-09,Senate,"Senate - Third Reading",30,0,0,0,30
1915437,1563716,2025-05-01,House,"House - Concurrence",0,0,0,0,0
1915437,1563717,2025-05-01,House,"House - Third Reading",51,5,4,0,60
1915474,1479098,2025-02-03,House,"House Health & Human Services Committee Action (DP)",7,5,0,0,12
1915474,1484996,2025-02-10,House,"House Rules Committee Action (C&P)",8,0,0,0,8
1915474,1495087,2025-02-20,House,"House - Third Reading",38,20,2,0,60
1915474,1520997,2025-03-19,Senate,"Senate Health and Human Services Committee Action (DP)",4,3,0,0,7
1915474,1524746,2025-03-24,Senate,"Senate Rules Committee Action (PFC)",0,0,0,0,0
1915474,1551362,2025-04-17,Senate,"Senate - Committee of the Whole (DP)",0,0,0,0,0
1915474,1560222,2025-04-29,Senate,"Senate - Third Reading",18,11,1,0,30
1915490,1486380,2025-02-11,House,"House Natural Resources, Energy & Water Committee Action (DPA)",10,0,0,0,10
1915490,1490934,2025-02-17,House,"House Rules Committee Action (C&P)",7,0,0,1,8
1915490,1494782,2025-02-20,House,"House - Committee of the Whole (DPA)",0,0,0,0,0
1915490,1497887,2025-02-24,House,"House - Third Reading",59,0,1,0,60
1915490,1520345,2025-03-18,Senate,"Senate Natural Resources Committee Action (DP)",7,0,1,0,8
1915490,1524676,2025-03-24,Senate,"Senate Rules Committee Action (PFC)",0,0,0,0,0
1915490,1531846,2025-03-31,Senate,"Senate - Third Reading",28,0,2,0,30
1915528,1482394,2025-02-05,House,"House Appropriations Committee Action (DP)",11,6,0,1,18
1915528,1490862,2025-02-17,House,"House Rules Committee Action (C&P)",7,0,0,1,8
1915528,1494708,2025-02-20,House,"House - Committee of the Whole (DPA)",0,0,0,0,0
1915528,1499114,2025-02-25,House,"House - Third Reading",33,27,0,0,60
1915528,1520912,2025-03-19,Senate,"Senate Regulatory Affairs and Government Efficiency Committee Action (DP)",4,3,0,0,7
1915528,1539599,2025-04-08,Senate,"Senate Rules Committee Action (PFC)",0,0,0,0,0
1915528,1551364,2025-04-17,Senate,"Senate - Committee of the Whole (DP)",0,0,0,0,0
1915528,1560323,2025-04-29,Senate,"Senate - Third Reading",17,12,1,0,30
1915538,1476215,2025-01-29,House,"House Judiciary Committee Action (DPA)",6,3,0,0,9
1915538,1478895,2025-02-03,House,"House Rules Committee Action (C&P)",8,0,0,0,8
1915538,1486148,2025-02-11,House,"House - Committee of the Whole (DPA)",0,0,0,0,0
1915538,1487815,2025-02-12,House,"House - Third Reading",44,15,1,0,60
1915538,1507011,2025-03-05,Senate,"Senate Judiciary and Elections Committee Action (DP)",5,2,0,0,7
1915538,1518822,2025-03-17,Senate,"Senate Rules Committee Action (PFC)",5,4,0,0,9
1915538,1551381,2025-04-17,Senate,"Senate - Committee of the Whole (RETAINED)",0,0,0,0,0
1915538,1562242,2025-04-30,Senate,"Senate - Committee of the Whole (DPA)",0,0,0,0,0
1915538,1566539,2025-05-06,Senate,"Senate - Third Reading",18,10,2,0,30
1915538,1567431,2025-05-07,House,"House - Concurrence",0,0,0,0,0
1915538,1567432,2025-05-07,House,"House - Third Reading",35,23,2,0,60
1915564,1491424,2025-02-17,House,"House Health & Human Services Committee Action (DPA)",12,0,0,0,12
1915564,1497350,2025-02-24,House,"House Rules Committee Action (C&P)",7,0,0,1,8
1915564,1498908,2025-02-25,House,"House - Committee of the Whole (DPA)",0,0,0,0,0
1915564,1500608,2025-02-26,House,"House - Third Reading",58,0,2,0,60
1915564,1525164,2025-03-24,Senate,"Senate Health and Human Services Committee Action (W/D)",0,0,0,0,0
1915564,1528584,2025-03-26,Senate,"Senate Judiciary and Elections Committee Action (DPA/SE)",7,0,0,0,7
1915564,1531333,2025-03-31,Senate,"Senate Rules Committee Action (PFC)",0,0,0,0,0
1915564,1541442,2025-04-09,Senate,"Senate - Committee of the Whole (RETAINED)",0,0,0,0,0
1915564,1562075,2025-04-30,Senate,"Senate - Committee of the Whole (DPA)",0,0,0,0,0
1915564,1566326,2025-05-06,Senate,"Senate - Third Reading",27,1,2,0,30
1915564,1567242,2025-05-07,House,"House - Concurrence",0,0,0,0,0
1915564,1567243,2025-05-07,House,"House - Third Reading",57,0,3,0,60
1915592,1486827,2025-02-11,House,"House Commerce Committee Action (DPA)",10,0,0,0,10
1915592,1490913,2025-02-17,House,"House Rules Committee Action (C&P)",7,0,0,1,8
1915592,1494732,2025-02-20,House,"House - Committee of the Whole (DPA)",0,0,0,0,0
1915592,1497900,2025-02-24,House,"House - Third Reading",53,6,1,0,60
1915592,1509737,2025-03-10,Senate,"Senate Finance Committee Action (DP)",7,0,0,0,7
1915592,1518915,2025-03-17,Senate,"Senate Rules Committee Action (PFC)",0,0,0,0,0
1915592,1526564,2025-03-25,Senate,"Senate - Third Reading",25,0,4,0,29
1915603,1489284,2025-02-13,House,"House Health & Human Services Committee Action (DP)",11,1,0,0,12
1915603,1498553,2025-02-25,House,"House Rules Committee Action (C&P)",7,0,0,1,8
1915603,1501143,2025-02-27,House,"House - Third Reading",44,11,5,0,60
1915603,1525963,2025-03-24,Senate,"Senate Finance Committee Action (DPA/SE)",4,3,0,0,7
1915603,1531312,2025-03-31,Senate,"Senate Rules Committee Action (PFC)",0,0,0,0,0
1915603,1553877,2025-04-22,Senate,"Senate - Committee of the Whole (RETAINED)",0,0,0,0,0
1915618,1479062,2025-02-03,House,"House Health & Human Services Committee Action (DP)",7,5,0,0,12
1915618,1503533,2025-03-03,House,"House Rules Committee Action (C&P)",8,0,0,0,8
1915618,1509493,2025-03-10,House,"House - Third Reading",29,27,4,0,60
1915618,1509494,2025-03-10,House,"House - Reconsider Third Reading",0,0,0,0,0
1915618,1518545,2025-03-17,House,"House - Third Reading",29,29,2,0,60
1915665,1493462,2025-02-19,House,"House Government Committee Action (DP)",6,0,1,0,7
1915665,1497606,2025-02-24,House,"House Rules Committee Action (C&P)",7,0,0,1,8
1915665,1500644,2025-02-26,House,"House - Third Reading",57,0,3,0,60
1915665,1509268,2025-03-10,Senate,"Senate Military Affairs and Border Security Committee Action (DP)",6,0,1,0,7
1915665,1518590,2025-03-17,Senate,"Senate Rules Committee Action (PFC)",0,0,0,0,0
1915665,1562320,2025-04-30,Senate,"Senate - Committee of the Whole (DP)",0,0,0,0,0
1915665,1566854,2025-05-06,Senate,"Senate - Third Reading",28,0,2,0,30
1915693,1487409,2025-02-12,House,"House Government Committee Action (HELD)",0,0,0,0,0
1915706,1476615,2025-01-29,House,"House Federalism, Military Affairs & Elections Committee Action (DP)",7,0,0,0,7
1915706,1484971,2025-02-10,House,"House Rules Committee Action (C&P)",8,0,0,0,8
1915706,1488668,2025-02-13,House,"House - Third Reading",53,0,7,0,60
1915706,1528618,2025-03-26,Senate,"Senate Judiciary and Elections Committee Action (DPA/SE)",7,0,0,0,7
1915706,1531273,2025-03-31,Senate,"Senate Rules Committee Action (PFC)",0,0,0,0,0
1915706,1541920,2025-04-09,Senate,"Senate - Committee of the Whole (DPA)",0,0,0,0,0
1915706,1541921,2025-04-09,Senate,"Senate - Third Reading",30,0,0,0,30
1915706,1567049,2025-05-07,Senate,"Senate - Third Reading",26,0,4,0,30
1915706,1567506,2025-05-07,House,"House - Third Reading",56,2,2,0,60
1915718,1479037,2025-02-03,House,"House Health & Human Services Committee Action (DP)",12,0,0,0,12
1915718,1498550,2025-02-25,House,"House Rules Committee Action (C&P)",7,0,0,1,8
1915718,1499892,2025-02-26,House,"House - Committee of the Whole (DPA)",0,0,0,0,0
1915718,1501329,2025-02-27,House,"House - Third Reading",47,9,4,0,60
1915718,1515766,2025-03-12,Senate,"Senate Regulatory Affairs and Government Efficiency Committee Action (DPA)",7,0,0,0,7
1915729,1473308,2025-01-22,House,"House Government Committee Action (DPA)",4,3,0,0,7
1915729,1473309,2025-01-22,House,"House Government Committee Action (DPA ON RECON)",4,3,0,0,7
1915729,1474875,2025-01-27,House,"House Rules Committee Action (C&P)",5,3,0,0,8
1915729,1482223,2025-02-05,House,"House - Committee of the Whole (DPA)",0,0,0,0,0
1915729,1486599,2025-02-11,House,"House - Third Reading",34,24,2,0,60
1915729,1506019,2025-03-05,Senate,"Senate Government Committee Action (HELD)",0,0,0,0,0
1915729,1537343,2025-03-19,Senate,"Senate Government Committee Action (DISC/HELD)",0,0,0,0,0
1915744,1486359,2025-02-11,House,"House Commerce Committee Action (HELD)",0,0,0,0,0
1915744,1489494,2025-02-11,House,"House Commerce Committee Action (W/D)",0,0,0,0,0
1915744,1493559,2025-02-19,House,"House Transportation & Infrastructure Committee Action (DPA)",6,0,1,0,7
1915744,1498561,2025-02-25,House,"House Rules Committee Action (C&P)",7,0,0,1,8
1915744,1504773,2025-03-04,House,"House - Committee of the Whole (DPA)",0,0,0,0,0
1915755,1473059,2025-01-22,House,"House Judiciary Committee Action (DPA)",9,0,0,0,9
1915755,1474812,2025-01-27,House,"House Rules Committee Action (C&P)",8,0,0,0,8
1915755,1477257,2025-01-30,House,"House - Committee of the Whole (RET ON CAL)",0,0,0,0,0
1915755,1478904,2025-02-03,House,"House - Committee of the Whole (DPA)",0,0,0,0,0
1915755,1479689,2025-02-04,House,"House - Third Reading",59,0,1,0,60
1915755,1507228,2025-03-05,Senate,"Senate Judiciary and Elections Committee Action (DP)",7,0,0,0,7
1915755,1518809,2025-03-17,Senate,"Senate Rules Committee Action (PFC)",0,0,0,0,0
1915755,1526525,2025-03-25,Senate,"Senate - Third Reading",25,0,4,0,29
1915772,1488416,2025-02-12,House,"House Science & Technology Committee Action (DPA)",9,0,0,0,9
1915772,1491177,2025-02-17,House,"House Rules Committee Action (C&P)",7,0,0,1,8
1915772,1495154,2025-02-20,House,"House - Committee of the Whole (DPA)",0,0,0,0,0
1915772,1499356,2025-02-25,House,"House - Third Reading",60,0,0,0,60
1915772,1516220,2025-03-12,Senate,"Senate Regulatory Affairs and Government Efficiency Committee Action (DP)",5,1,1,0,7
1915772,1518622,2025-03-17,Senate,"Senate Rules Committee Action (PFC)",0,0,0,0,0
1915772,1533352,2025-04-01,Senate,"Senate - Third Reading",18,11,1,0,30
1915780,1479044,2025-02-03,House,"House Public Safety & Law Enforcement Committee Action (DP)",9,3,3,0,15
1915780,1484986,2025-02-10,House,"House Rules Committee Action (C&P)",8,0,0,0,8
1915780,1494928,2025-02-20,House,"House - Committee of the Whole (RET ON CAL)",0,0,0,0,0
1915780,1498984,2025-02-25,House,"House - Committee of the Whole (DPA)",0,0,0,0,0
1915793,1480173,2025-02-04,House,"House Commerce Committee Action (DPA)",10,0,0,0,10
1915793,1485181,2025-02-10,House,"House Rules Committee Action (C&P)",8,0,0,0,8
1915793,1491904,2025-02-18,House,"House - Committee of the Whole (DPA)",0,0,0,0,0
1915793,1494778,2025-02-20,House,"House - Third Reading",42,16,2,0,60
1915793,1505710,2025-03-05,Senate,"Senate Regulatory Affairs and Government Efficiency Committee Action (DP)",7,0,0,0,7
1915793,1518874,2025-03-17,Senate,"Senate Rules Committee Action (PFC)",0,0,0,0,0
1915793,1531353,2025-03-31,Senate,"Senate - Committee of the Whole (DP)",0,0,0,0,0
1915793,1531845,2025-03-31,Senate,"Senate - Third Reading",27,1,2,0,30
1915819,1474977,2025-01-27,Senate,"Senate Federalism Committee Action (DP)",4,3,0,0,7
1915831,1474961,2025-01-27,House,"House Health & Human Services Committee Action (DPA)",9,3,0,0,12
1915879,1476281,2025-01-29,House,"House Ways & Means Committee Action (DP)",6,3,0,0,9
1915879,1478869,2025-02-03,House,"House Rules Committee Action (C&P)",8,0,0,0,8
1915879,1484771,2025-02-10,House,"House - Committee of the Whole (DP)",0,0,0,0,0
1915879,1491215,2025-02-17,House,"House - Third Reading",33,26,1,0,60
1915991,1473216,2025-01-22,House,"House Federalism, Military Affairs & Elections Committee Action (DPA)",4,3,0,0,7
1915991,1474809,2025-01-27,House,"House Rules Committee Action (C&P)",8,0,0,0,8
1915991,1480853,2025-02-05,House,"House - Committee of the Whole (DPA)",0,0,0,0,0
1915991,1486520,2025-02-11,House,"House - Third Reading",32,26,2,0,60
1915991,1507016,2025-03-05,Senate,"Senate Judiciary and Elections Committee Action (DP)",4,3,0,0,7
1915991,1518773,2025-03-17,Senate,"Senate Rules Committee Action (PFC)",0,0,0,0,0
1915991,1541841,2025-04-09,Senate,"Senate - Committee of the Whole (DP)",0,0,0,0,0
1915991,1541842,2025-04-09,Senate,"Senate - Third Reading",17,13,0,0,30
1916042,1488423,2025-02-12,House,"House Transportation & Infrastructure Committee Action (DPA/SE)",7,0,0,0,7
1916042,1497731,2025-02-24,House,"House Rules Committee Action (C&P)",7,0,0,1,8
1916042,1498660,2025-02-25,House,"House - Committee of the Whole (DPA)",0,0,0,0,0
1916042,1500591,2025-02-26,House,"House - Third Reading",40,18,2,0,60
1916042,1516165,2025-03-12,Senate,"Senate Public Safety Committee Action (DP)",6,1,0,0,7
1916042,1518888,2025-03-17,Senate,"Senate Rules Committee Action (PFC)",0,0,0,0,0
1916042,1534253,2025-04-02,Senate,"Senate - Third Reading",30,0,0,0,30
1916086,1479701,2025-02-04,House,"House Education Committee Action (DPA)",10,0,1,1,12
1916086,1483320,2025-02-05,House,"House Regulatory Oversight Committee Action (W/D)",0,0,0,0,0
1916086,1490937,2025-02-17,House,"House Rules Committee Action (C&P)",7,0,0,1,8
1916086,1493624,2025-02-19,House,"House - Committee of the Whole (DPA)",0,0,0,0,0
1916086,1497912,2025-02-24,House,"House - Third Reading",59,0,1,0,60
1916086,1520940,2025-03-19,Senate,"Senate Health and Human Services Committee Action (DP)",7,0,0,0,7
1916086,1524730,2025-03-24,Senate,"Senate Rules Committee Action (PFC)",0,0,0,0,0
1916086,1539401,2025-04-08,Senate,"Senate - Committee of the Whole (DP)",0,0,0,0,0
1916086,1539402,2025-04-08,Senate,"Senate - Third Reading",28,0,2,0,30
1916133,1479040,2025-02-03,House,"House Health & Human Services Committee Action (FAILED)",6,6,0,0,12
1916133,1491439,2025-02-17,House,"House Health & Human Services Committee Action (DPA ON RECON)",7,5,0,0,12
1916133,1497312,2025-02-24,House,"House Rules Committee Action (C&P)",7,0,0,1,8
1916133,1498762,2025-02-25,House,"House - Committee of the Whole (DPA)",0,0,0,0,0
1916133,1500479,2025-02-26,House,"House - Third Reading",32,27,1,0,60
1916133,1505751,2025-02-17,House,"House Health & Human Services Committee Action (DPA)",7,5,0,0,12
1916133,1521075,2025-03-19,Senate,"Senate Health and Human Services Committee Action (DP)",4,3,0,0,7
1916133,1524804,2025-03-24,Senate,"Senate Rules Committee Action (PFC)",0,0,0,0,0
1916133,1539394,2025-04-08,Senate,"Senate - Committee of the Whole (DP)",0,0,0,0,0
1916133,1539395,2025-04-08,Senate,"Senate - Senator Sundareshan to include the Hatathlie floor amendment",11,17,2,0,30
1916133,1539396,2025-04-08,Senate,"Senate - Third Reading",17,11,2,0,30
1916420,1480788,2025-02-05,House,"House Government Committee Action (DP)",6,0,0,1,7
1916420,1499313,2025-02-25,House,"House Rules Committee Action (C&P)",7,0,0,1,8
1916465,1480532,2025-02-05,House,"House Government Committee Action (DP)",4,2,1,0,7
1916465,1485031,2025-02-10,House,"House Rules Committee Action (C&P)",8,0,0,0,8
1916465,1493448,2025-02-19,House,"House - Committee of the Whole (DP)",0,0,0,0,0
1916465,1503227,2025-03-03,House,"Motion Motion by Representative Carbone that pursuant to House Rule 12(P), HB2152 be calendared for an Additional Committee of the Whole for purposes of further amending. Motion passed v/v.",0,0,0,0,0
1916465,1503228,2025-03-03,House,"House - Committee of the Whole (DPA)",0,0,0,0,0
1916465,1504430,2025-03-04,House,"House - Third Reading",33,25,2,0,60
1916515,1493835,2025-02-19,House,"House Federalism, Military Affairs & Elections Committee Action (DP)",4,3,0,0,7
1916515,1497293,2025-02-24,House,"House Rules Committee Action (C&P)",4,3,0,1,8
1916515,1499959,2025-02-26,House,"House - Committee of the Whole (DP)",0,0,0,0,0
1916515,1503398,2025-03-03,House,"House - Third Reading",32,26,2,0,60
1916515,1528627,2025-03-26,Senate,"Senate Judiciary and Elections Committee Action (DP)",4,3,0,0,7
1916515,1539575,2025-04-08,Senate,"Senate Rules Committee Action (PFC)",4,3,2,0,9
1916515,1551303,2025-04-17,Senate,"Senate - Committee of the Whole (DP)",0,0,0,0,0
1916515,1560172,2025-04-29,Senate,"Senate - Third Reading",17,12,1,0,30
1916559,1476259,2025-01-29,House,"House Ways & Means Committee Action (DP)",5,3,1,0,9
1916559,1478830,2025-02-03,House,"House Rules Committee Action (C&P)",8,0,0,0,8
1916559,1487622,2025-02-12,House,"House - Third Reading",40,19,1,0,60
1916559,1503819,2025-03-03,Senate,"Senate Finance Committee Action (DP)",4,3,0,0,7
1917013,1476036,2025-01-28,House,"House Commerce Committee Action (DPA)",9,1,0,0,10
1917013,1498565,2025-02-25,House,"House Rules Committee Action (C&P)",7,0,0,1,8
1917013,1499926,2025-02-26,House,"House - Committee of the Whole (DPA)",0,0,0,0,0
1917013,1501362,2025-02-27,House,"House - Third Reading",55,1,4,0,60
1917013,1527522,2025-03-26,Senate,"Senate Regulatory Affairs and Government Efficiency Committee Action (DPA)",7,0,0,0,7
1917013,1530930,2025-03-31,Senate,"Senate Rules Committee Action (PFC)",0,0,0,0,0
1917013,1551132,2025-04-17,Senate,"Senate - Committee of the Whole (DPA)",0,0,0,0,0
1917013,1560542,2025-04-29,Senate,"Senate - Third Reading",29,0,1,0,30
1917013,1565823,2025-05-06,House,"House - Concurrence",0,0,0,0,0
1917013,1565824,2025-05-06,House,"House - Third Reading",53,0,7,0,60
1917064,1480091,2025-02-04,House,"House Commerce Committee Action (DPA)",10,0,0,0,10
1917064,1484980,2025-02-10,House,"House Rules Committee Action (C&P)",8,0,0,0,8
1917064,1491268,2025-02-17,House,"House - Committee of the Whole (DPA)",0,0,0,0,0
1917064,1495071,2025-02-20,House,"House - Third Reading",58,0,2,0,60
1917064,1519400,2025-03-17,Senate,"Senate Finance Committee Action (DPA/SE)",5,2,0,0,7
1917064,1524689,2025-03-24,Senate,"Senate Rules Committee Action (HELD)",0,0,0,0,0
1917064,1531219,2025-03-31,Senate,"Senate Rules Committee Action (PFC)",0,0,0,0,0
1917064,1551107,2025-04-17,Senate,"Senate - Committee of the Whole (DPA)",0,0,0,0,0
1917064,1560544,2025-04-29,Senate,"Senate - Third Reading",29,0,1,0,30
1917064,1566065,2025-05-06,House,"House - Concurrence",0,0,0,0,0
1917064,1566066,2025-05-06,House,"House - Third Reading",53,1,6,0,60
1917110,1475678,2025-01-28,House,"House Education Committee Action (DP)",8,4,0,0,12
1917159,1476941,2025-01-29,House,"House Appropriations Committee Action (DP)",17,0,0,1,18
1917159,1485650,2025-02-10,House,"House Rules Committee Action (C&P)",8,0,0,0,8
1917159,1488775,2025-02-13,House,"House - Third Reading",43,10,7,0,60
1917159,1515569,2025-03-11,Senate,"Senate Appropriations Committee Action (DP)",10,0,0,0,10
1917214,1487291,2025-02-12,House,"House Judiciary Committee Action (HELD)",0,0,0,0,0
1917269,1485332,2025-02-10,House,"House Health & Human Services Committee Action (DP)",11,1,0,0,12
1917321,1489239,2025-02-13,House,"House Health & Human Services Committee Action (DP)",11,1,0,0,12
1917321,1497330,2025-02-24,House,"House Rules Committee Action (C&P)",7,0,0,1,8
1917321,1500460,2025-02-26,House,"House - Third Reading",34,25,1,0,60
1917321,1500833,2025-02-26,House,"House - Reconsider Third Reading",0,0,0,0,0
1917321,1515735,2025-03-12,Senate,"Senate Health and Human Services Committee Action (DP)",6,0,1,0,7
1917321,1518797,2025-03-17,Senate,"Senate Rules Committee Action (PFC)",0,0,0,0,0
1917321,1526365,2025-03-25,Senate,"Senate - Third Reading",25,0,4,0,29
1917379,1486541,2025-02-11,House,"House Education Committee Action (DPA)",7,5,0,0,12
1917379,1490910,2025-02-17,House,"House Rules Committee Action (C&P)",7,0,0,1,8
1917379,1498643,2025-02-25,House,"House - Committee of the Whole (RET ON CAL)",0,0,0,0,0
1917379,1499844,2025-02-26,House,"House - Committee of the Whole (RET ON CAL)",0,0,0,0,0
1917379,1503235,2025-03-03,House,"House - Committee of the Whole (DPA)",0,0,0,0,0
1917379,1505925,2025-03-05,House,"House - Third Reading",32,26,2,0,60
1917379,1522314,2025-03-19,Senate,"Senate Education Committee Action (DP)",5,2,0,0,7
1917379,1526715,2025-03-25,Senate,"Senate Appropriations Committee Action (DP)",6,2,2,0,10
1917379,1531225,2025-03-31,Senate,"Senate Rules Committee Action (PFC)",0,0,0,0,0
1917379,1541851,2025-04-09,Senate,"Senate - Committee of the Whole (RETAINED)",0,0,0,0,0
1917379,1545507,2025-03-19,Senate,"Senate Education-Archived and Renamed Education and Transportation as of 04/01/2025 Committee Action (DP)",5,2,0,0,7
1917429,1475667,2025-01-28,House,"House Education Committee Action (DPA)",11,0,0,1,12
1917429,1478821,2025-02-03,House,"House Rules Committee Action (C&P)",8,0,0,0,8
1917429,1484795,2025-02-10,House,"House - Committee of the Whole (DPA)",0,0,0,0,0
1917429,1489007,2025-02-13,House,"House - Third Reading",53,0,7,0,60
1917429,1526628,2025-03-25,Senate,"Senate Education Committee Action (W/D)",0,0,0,0,0
1917429,1532852,2025-04-01,Senate,"Senate Appropriations Committee Action (DPA/SE)",9,1,0,0,10
1917429,1545877,2025-03-25,Senate,"Senate Education-Archived and Renamed Education and Transportation as of 04/01/2025 Committee Action (W/D)",0,0,0,0,0
1917484,1486554,2025-02-11,House,"House Education Committee Action (DPA)",7,4,1,0,12
1917484,1490873,2025-02-17,House,"House Rules Committee Action (PFC)",8,0,0,0,8
1917484,1493583,2025-02-17,House,"House Rules Committee Action (C&P)",7,0,0,1,8
1917484,1498635,2025-02-25,House,"House - Committee of the Whole (DPA)",0,0,0,0,0
1917484,1500273,2025-02-26,House,"House - Third Reading",58,1,1,0,60
1917484,1522643,2025-03-19,Senate,"Senate Education Committee Action (DP)",4,3,0,0,7
1917484,1524839,2025-03-24,Senate,"Senate Rules Committee Action (PFC)",0,0,0,0,0
1917484,1543988,2025-04-10,Senate,"Senate - Committee of the Whole (DP)",0,0,0,0,0
1917484,1545908,2025-03-19,Senate,"Senate Education-Archived and Renamed Education and Transportation as of 04/01/2025 Committee Action (DP)",4,3,0,0,7
1917484,1548811,2025-04-15,Senate,"Senate - Third Reading",17,13,0,0,30
1917539,1475789,2025-01-28,House,"House Education Committee Action (DP)",12,0,0,0,12
1917539,1478864,2025-02-03,House,"House Rules Committee Action (C&P)",8,0,0,0,8
1917539,1489028,2025-02-13,House,"House - Third Reading",53,0,7,0,60
1917539,1506304,2025-03-05,Senate,"Senate Education Committee Action (DP)",7,0,0,0,7
1917539,1518897,2025-03-17,Senate,"Senate Rules Committee Action (PFC)",0,0,0,0,0
1917539,1545879,2025-03-05,Senate,"Senate Education-Archived and Renamed Education and Transportation as of 04/01/2025 Committee Action (DP)",7,0,0,0,7
1917539,1566583,2025-05-06,Senate,"Senate - Third Reading",27,1,2,0,30
1917588,1479109,2025-02-03,House,"House Health & Human Services Committee Action (DPA/SE)",11,1,0,0,12
1917588,1485071,2025-02-10,House,"House Rules Committee Action (C&P)",8,0,0,0,8
1917588,1492425,2025-02-18,House,"House - Committee of the Whole (RET ON CAL)",0,0,0,0,0
1917588,1494675,2025-02-20,House,"House - Committee of the Whole (DPA)",0,0,0,0,0
1917588,1499132,2025-02-25,House,"House - Third Reading",27,33,0,0,60
1917588,1499133,2025-02-25,House,"House - Reconsider Third Reading",0,0,0,0,0
1917688,1472990,2025-01-22,Senate,"Senate Health and Human Services Committee Action (DP)",6,0,1,0,7
1917688,1475895,2025-01-28,Senate,"Senate Appropriations Committee Action (DP)",9,0,1,0,10
1917688,1478817,2025-02-03,Senate,"Senate Rules Committee Action (PFC)",0,0,0,0,0
1917688,1487613,2025-02-12,Senate,"Senate - Third Reading",25,3,2,0,30
1917688,1503829,2025-03-03,House,"House Health & Human Services Committee Action (DP)",12,0,0,0,12
1917688,1516326,2025-03-12,House,"House Appropriations Committee Action (DPA)",15,0,0,3,18
1917726,1476704,2025-01-29,Senate,"Senate Public Safety Committee Action (DP)",7,0,0,0,7
1917726,1478828,2025-02-03,Senate,"Senate Rules Committee Action (PFC)",0,0,0,0,0
1917726,1487530,2025-02-12,Senate,"Senate - Third Reading",24,4,2,0,30
1917726,1528376,2025-03-26,House,"House Transportation & Infrastructure Committee Action (DP)",6,0,0,1,7
1917726,1547289,2025-04-14,House,"House Rules Committee Action (C&P)",8,0,0,0,8
1917726,1565678,2025-05-06,House,"House - Third Reading",43,11,6,0,60
1917769,1474966,2025-01-27,House,"House Health & Human Services Committee Action (DPA)",12,0,0,0,12
1917769,1497269,2025-02-24,House,"House Rules Committee Action (C&P)",7,0,0,1,8
1917769,1498730,2025-02-25,House,"House - Committee of the Whole (DPA)",0,0,0,0,0
1917769,1500435,2025-02-26,House,"House - Third Reading",58,0,2,0,60
1917769,1515796,2025-03-12,Senate,"Senate Health and Human Services Committee Action (DP)",5,0,2,0,7
1917806,1489233,2025-02-13,House,"House Health & Human Services Committee Action (DISC/HELD)",0,0,0,0,0
1917890,1474981,2025-01-27,House,"House Health & Human Services Committee Action (DP)",11,1,0,0,12
1917890,1497259,2025-02-24,House,"House Rules Committee Action (C&P)",7,0,0,1,8
1917890,1499925,2025-02-26,House,"House - Committee of the Whole (DPA)",0,0,0,0,0
1917890,1501414,2025-02-27,House,"House - Third Reading",50,7,3,0,60
1917890,1515773,2025-03-12,Senate,"Senate Health and Human Services Committee Action (DP)",6,0,1,0,7
1917890,1518870,2025-03-17,Senate,"Senate Rules Committee Action (PFC)",0,0,0,0,0
1917890,1565958,2025-05-06,Senate,"Senate - Third Reading",27,1,2,0,30
1917923,1476552,2025-01-29,House,"House Federalism, Military Affairs & Elections Committee Action (DPA)",4,3,0,0,7
1917923,1478891,2025-02-03,House,"House Rules Committee Action (C&P)",8,0,0,0,8
1917923,1486558,2025-02-11,House,"House - Committee of the Whole (DPA)",0,0,0,0,0
1917923,1487654,2025-02-12,House,"House - Motion Motion by Representative Carbone that pursuant to House Rule 12(P), HCR2013 be calendared for an Additional Committee of the Whole for purposes of further amending. Motion passed v/v.",0,0,0,0,0
1917923,1487655,2025-02-12,House,"House - Committee of the Whole (DPA)",0,0,0,0,0
1917923,1491247,2025-02-17,House,"House - Third Reading",33,26,1,0,60
1917923,1507221,2025-03-05,Senate,"Senate Judiciary and Elections Committee Action (DP)",4,3,0,0,7
1918010,1480708,2025-02-05,Senate,"Senate Health and Human Services Committee Action (DPA)",6,0,1,0,7
1918010,1484991,2025-02-10,Senate,"Senate Rules Committee Action (PFC)",0,0,0,0,0
1918010,1503594,2025-03-03,Senate,"Senate - Committee of the Whole (DPA)",0,0,0,0,0
1918010,1506207,2025-03-05,Senate,"Senate - Third Reading",26,3,1,0,30
1918010,1519277,2025-03-17,House,"House Health & Human Services Committee Action (DP)",11,1,0,0,12
1918010,1547253,2025-04-14,House,"House Rules Committee Action (C&P)",8,0,0,0,8
1918010,1567207,2025-05-07,House,"House - Third Reading",48,10,2,0,60
1918049,1473244,2025-01-22,Senate,"Senate Regulatory Affairs and Government Efficiency Committee Action (DP)",6,1,0,0,7
1918049,1475085,2025-01-27,Senate,"Senate Rules Committee Action (PFC)",0,0,0,0,0
1918049,1476338,2025-01-29,Senate,"Senate - Committee of the Whole (DP)",0,0,0,0,0
1918049,1478760,2025-02-03,Senate,"Senate - Third Reading",20,10,0,0,30
1918049,1503828,2025-03-03,House,"House Health & Human Services Committee Action (DISC/HELD)",0,0,0,0,0
1918049,1525155,2025-03-24,House,"House Health & Human Services Committee Action (DP)",7,4,0,1,12
1918049,1531358,2025-03-31,House,"House Rules Committee Action (C&P)",7,0,0,1,8
1918049,1535754,2025-04-03,House,"House - Committee of the Whole (DP)",0,0,0,0,0
1918049,1548585,2025-04-15,House,"House - Third Reading",32,21,7,0,60
1918131,1488731,2025-02-12,House,"House Science & Technology Committee Action (W/D)",0,0,0,0,0
1918131,1497988,2025-02-24,House,"House Appropriations Committee Action (DPA)",14,1,2,1,18
1918131,1499927,2025-02-26,House,"House - Committee of the Whole (DPA)",0,0,0,0,0
1918131,1500906,2025-02-25,House,"House Rules Committee Action (C&P)",7,0,0,1,8
1918131,1501084,2025-02-27,House,"House - Third Reading",40,17,3,0,60
1918172,1493679,2025-02-19,Senate,"Senate Government Committee Action (DPA/SE)",4,3,0,0,7
1918172,1497599,2025-02-24,Senate,"Senate Rules Committee Action (PFC)",0,0,0,0,0
1918172,1501319,2025-02-27,Senate,"Senate - Committee of the Whole (DPA)",0,0,0,0,0
1918172,1507190,2025-03-06,Senate,"Senate - Third Reading",18,9,3,0,30
1918290,1479082,2025-02-03,House,"House Health & Human Services Committee Action (DP)",7,5,0,0,12
1918290,1503215,2025-03-03,House,"House Rules Committee Action (C&P)",8,0,0,0,8
1918290,1513684,2025-03-11,House,"House - Third Reading",34,23,3,0,60
1918331,1492619,2025-02-18,House,"House Education Committee Action (DPA/SE)",6,2,4,0,12
1918331,1498557,2025-02-25,House,"House Rules Committee Action (C&P)",7,0,0,1,8
1918371,1474930,2025-01-27,House,"House Health & Human Services Committee Action (DP)",12,0,0,0,12
1918371,1478834,2025-02-03,House,"House Rules Committee Action (C&P)",8,0,0,0,8
1918371,1484804,2025-02-10,House,"House - Committee of the Whole (DPA)",0,0,0,0,0
1918371,1488997,2025-02-13,House,"House - Third Reading",51,3,6,0,60
1918371,1521399,2025-03-19,Senate,"Senate Health and Human Services Committee Action (DP)",4,3,0,0,7
1918371,1531065,2025-03-31,Senate,"Senate Rules Committee Action (PFC)",5,4,0,0,9
1918371,1555503,2025-04-23,Senate,"Senate - Committee of the Whole (DPA)",0,0,0,0,0
1918371,1560217,2025-04-29,Senate,"Senate - Third Reading",28,1,1,0,30
1918371,1565557,2025-05-06,House,"House - Concurrence",0,0,0,0,0
1918371,1565558,2025-05-06,House,"House - Third Reading",53,1,6,0,60
1918481,1495395,2025-02-20,Senate,"Senate Regulatory Affairs and Government Efficiency Committee Action (DP)",4,3,0,0,7
1918481,1497514,2025-02-24,Senate,"Senate Rules Committee Action (PFC)",0,0,0,0,0
1918481,1500328,2025-02-26,Senate,"Senate - Committee of the Whole (DPA)",0,0,0,0,0
1918481,1501697,2025-02-27,Senate,"Senate - Third Reading",17,12,1,0,30
1918481,1519104,2025-03-17,House,"House Health & Human Services Committee Action (DP)",7,5,0,0,12
1918481,1524924,2025-03-24,House,"House Rules Committee Action (C&P)",8,0,0,0,8
1918481,1527838,2025-03-26,House,"House - Committee of the Whole (DPA)",0,0,0,0,0
1918481,1530896,2025-03-31,House,"House - Third Reading",31,25,4,0,60
1918481,1548590,2025-04-15,Senate,"Senate - Concurrence",0,0,0,0,0
1918481,1548591,2025-04-15,Senate,"Senate - Third Reading",17,13,0,0,30
1918499,1475194,2025-01-27,Senate,"Senate Finance Committee Action (DP)",4,3,0,0,7
1918499,1478805,2025-02-03,Senate,"Senate Rules Committee Action (PFC)",0,0,0,0,0
1918499,1491284,2025-02-03,Senate,"Senate Rules Committee Action (PFC)",0,0,0,0,0
1918499,1494622,2025-02-19,Senate,"Senate Education Committee Action (DPA/SE)",4,3,0,0,7
1918499,1497961,2025-02-24,Senate,"Senate Rules Committee Action (PFC)",0,0,0,0,0
1918499,1545637,2025-02-19,Senate,"Senate Education-Archived and Renamed Education and Transportation as of 04/01/2025 Committee Action (DPA/SE)",4,3,0,0,7
1918508,1475907,2025-01-28,Senate,"Senate Appropriations Committee Action (DP)",9,0,1,0,10
1918508,1478907,2025-02-03,Senate,"Senate Rules Committee Action (PFC)",0,0,0,0,0
1918508,1487467,2025-02-12,Senate,"Senate - Third Reading",27,1,2,0,30
1918519,1476888,2025-01-29,Senate,"Senate Public Safety Committee Action (DP)",7,0,0,0,7
1918519,1478768,2025-02-03,Senate,"Senate Rules Committee Action (PFC)",0,0,0,0,0
1918519,1487481,2025-02-12,Senate,"Senate - Third Reading",25,3,2,0,30
1918519,1516757,2025-03-12,House,"House Transportation & Infrastructure Committee Action (DP)",6,0,0,1,7
1918519,1547862,2025-04-14,House,"House Rules Committee Action (C&P)",8,0,0,0,8
1918519,1563120,2025-04-30,House,"House - Third Reading",38,11,11,0,60
1918530,1476960,2025-01-29,Senate,"Senate Public Safety Committee Action (DP)",4,3,0,0,7
1918530,1478803,2025-02-03,Senate,"Senate Rules Committee Action (PFC)",0,0,0,0,0
1918530,1507714,2025-03-06,Senate,"Senate - Committee of the Whole (DP)",0,0,0,0,0
1918530,1517526,2025-03-13,Senate,"Senate - Third Reading",17,11,2,0,30
1918530,1528469,2025-03-26,House,"House Transportation & Infrastructure Committee Action (DP)",4,2,0,1,7
1918530,1538292,2025-04-07,House,"House Rules Committee Action (C&P)",7,0,0,1,8
1918530,1547383,2025-04-14,House,"House - Committee of the Whole (DP)",0,0,0,0,0
1918530,1549878,2025-04-16,House,"House - Third Reading",33,25,2,0,60
1918543,1476187,2025-01-29,Senate,"Senate Health and Human Services Committee Action (DPA)",7,0,0,0,7
1918543,1478825,2025-02-03,Senate,"Senate Rules Committee Action (PFC)",0,0,0,0,0
1918543,1484892,2025-02-10,Senate,"Senate - Committee of the Whole (DPA)",0,0,0,0,0
1918543,1486556,2025-02-11,Senate,"Senate - Third Reading",26,0,4,0,30
1918543,1503455,2025-03-03,House,"House Health & Human Services Committee Action (DP)",12,0,0,0,12
1918543,1509518,2025-03-10,House,"House Rules Committee Action (C&P)",6,0,0,2,8
1918543,1517181,2025-03-13,House,"House - Committee of the Whole (DP)",0,0,0,0,0
1918543,1520409,2025-03-18,House,"House - Third Reading",58,0,2,0,60
1918557,1476333,2025-01-29,Senate,"Senate Government Committee Action (DPA)",4,3,0,0,7
1918557,1478879,2025-02-03,Senate,"Senate Rules Committee Action (PFC)",0,0,0,0,0
1918557,1494860,2025-02-20,Senate,"Senate - Committee of the Whole (DPA)",0,0,0,0,0
1918557,1494861,2025-02-20,Senate,"Senate - Third Reading",17,12,1,0,30
1918557,1527705,2025-03-26,House,"House Government Committee Action (HELD)",0,0,0,0,0
1918557,1530296,2025-03-27,House,"House Government Committee Action (DP)",4,3,0,0,7
1918557,1538504,2025-04-07,House,"House Rules Committee Action (C&P)",7,0,0,1,8
1918557,1548678,2025-04-15,House,"House - Committee of the Whole (DP)",0,0,0,0,0
1918567,1486485,2025-02-11,House,"House Commerce Committee Action (DPA)",6,3,1,0,10
1918567,1491176,2025-02-17,House,"House Rules Committee Action (C&P)",5,2,0,1,8
1918567,1499384,2025-02-25,House,"House - Committee of the Whole (DPA)",0,0,0,0,0
1918567,1500159,2025-02-26,House,"House - Third Reading",48,11,1,0,60
1918567,1522110,2025-03-19,Senate,"Senate Regulatory Affairs and Government Efficiency Committee Action (DP)",5,2,0,0,7
1918567,1525278,2025-03-24,Senate,"Senate Rules Committee Action (PFC)",0,0,0,0,0
1918567,1568089,2025-05-07,Senate,"Senate - Third Reading",16,9,5,0,30
1918581,1494588,2025-02-19,Senate,"Senate Judiciary and Elections Committee Action (DP)",4,3,0,0,7
1918581,1497530,2025-02-24,Senate,"Senate Rules Committee Action (PFC)",0,0,0,0,0
1918581,1503371,2025-03-03,Senate,"Senate - Committee of the Whole (DP)",0,0,0,0,0
1918581,1505995,2025-03-05,Senate,"Senate - Third Reading",17,12,1,0,30
1918581,1521588,2025-03-19,House,"House Federalism, Military Affairs & Elections Committee Action (DP)",4,2,0,1,7
1918581,1524837,2025-03-24,House,"House Rules Committee Action (C&P)",8,0,0,0,8
1918581,1527775,2025-03-26,House,"House - Committee of the Whole (DP)",0,0,0,0,0
1918581,1565002,2025-05-05,House,"House - Third Reading",32,25,3,0,60
1918596,1479788,2025-02-04,House,"House Education Committee Action (DPA)",10,1,0,1,12
1918596,1488104,2025-02-12,House,"House Appropriations Committee Action (DPA)",18,0,0,0,18
1918596,1494124,2025-02-17,House,"House Rules Committee Action (C&P)",7,0,0,1,8
1918596,1494702,2025-02-20,House,"House - Committee of the Whole (DPA)",0,0,0,0,0
1918596,1499100,2025-02-25,House,"House - Third Reading",24,36,0,0,60
1918611,1476696,2025-01-29,Senate,"Senate Public Safety Committee Action (DP)",4,3,0,0,7
1918611,1478786,2025-02-03,Senate,"Senate Rules Committee Action (PFC)",0,0,0,0,0
1918611,1507479,2025-03-06,Senate,"Senate - Committee of the Whole (DP)",0,0,0,0,0
1918611,1517211,2025-03-13,Senate,"Senate - Third Reading",17,11,2,0,30
1918611,1528141,2025-03-26,House,"House Transportation & Infrastructure Committee Action (DP)",4,2,0,1,7
1918611,1532434,2025-04-01,House,"House Rules Committee Action (C&P)",7,0,0,1,8
1918611,1543493,2025-04-10,House,"House - Committee of the Whole (DP)",0,0,0,0,0
1918611,1558983,2025-04-28,House,"House - Third Reading",32,24,4,0,60
1918621,1475459,2025-01-28,Senate,"Senate Natural Resources Committee Action (W/D)",0,0,0,0,0
1918621,1493549,2025-02-19,Senate,"Senate Government Committee Action (HELD)",0,0,0,0,0
1918621,1496682,2025-02-20,Senate,"Senate Government Committee Action (DPA/SE)",4,3,0,0,7
1918621,1497712,2025-02-24,Senate,"Senate Rules Committee Action (PFC)",4,3,0,0,7
1918621,1503817,2025-03-03,Senate,"Senate - Committee of the Whole (DPA)",0,0,0,0,0
1918621,1505951,2025-03-05,Senate,"Senate - Third Reading",17,12,1,0,30
1918621,1527742,2025-03-26,House,"House Government Committee Action (HELD)",0,0,0,0,0
1918621,1530302,2025-03-27,House,"House Government Committee Action (DP)",4,3,0,0,7
1918621,1532458,2025-04-01,House,"House Rules Committee Action (C&P)",7,0,0,1,8
1918621,1542667,2025-04-09,House,"House - Committee of the Whole (DP)",0,0,0,0,0
1918621,1564528,2025-05-01,House,"House - Third Reading",31,27,2,0,60
1918635,1473018,2025-01-22,Senate,"Senate Health and Human Services Committee Action (DPA)",6,0,1,0,7
1918635,1474766,2025-01-27,Senate,"Senate Rules Committee Action (PFC)",0,0,0,0,0
1918635,1476264,2025-01-29,Senate,"Senate - Committee of the Whole (DPA)",0,0,0,0,0
1918635,1478753,2025-02-03,Senate,"Senate - Third Reading",25,5,0,0,30
1918635,1518617,2025-03-17,House,"House Health & Human Services Committee Action (HELD)",0,0,0,0,0
1918645,1476186,2025-01-29,Senate,"Senate Regulatory Affairs and Government Efficiency Committee Action (DP)",4,3,0,0,7
1918645,1478755,2025-02-03,Senate,"Senate Rules Committee Action (PFC)",0,0,0,0,0
1918645,1497636,2025-02-24,Senate,"Senate - Committee of the Whole (DP)",0,0,0,0,0
1918645,1497637,2025-02-24,Senate,"Senate - Third Reading",16,14,0,0,30
1918645,1526703,2025-03-25,House,"House Commerce Committee Action (DP)",5,3,0,2,10
1918645,1531414,2025-03-31,House,"House Rules Committee Action (C&P)",7,0,0,1,8
1918645,1534433,2025-04-02,House,"House - Committee of the Whole (DP)",0,0,0,0,0
1918645,1549048,2025-04-15,House,"House - Third Reading",32,20,8,0,60
1918658,1476329,2025-01-29,Senate,"Senate Government Committee Action (DP)",4,3,0,0,7
1918672,1475832,2025-01-28,House,"House Regulatory Oversight Committee Action (DP)",3,2,0,0,5
1918689,1476323,2025-01-29,Senate,"Senate Government Committee Action (DP)",4,3,0,0,7
1918689,1478870,2025-02-03,Senate,"Senate Rules Committee Action (PFC)",4,3,0,0,7
1918689,1494886,2025-02-20,Senate,"Senate - Committee of the Whole (DP)",0,0,0,0,0
1918689,1494887,2025-02-20,Senate,"Senate - Third Reading",17,12,1,0,30
1918700,1476966,2025-01-29,Senate,"Senate Public Safety Committee Action (DP)",6,0,1,0,7
1918700,1478901,2025-02-03,Senate,"Senate Rules Committee Action (PFC)",0,0,0,0,0
1918700,1495773,2025-02-20,Senate,"Senate - Committee of the Whole (DPA)",0,0,0,0,0
1918700,1495774,2025-02-20,Senate,"Senate - Third Reading",28,1,1,0,30
1918700,1516526,2025-03-12,House,"House Transportation & Infrastructure Committee Action (DP)",6,0,0,1,7
1918700,1519273,2025-03-17,House,"House Rules Committee Action (C&P)",8,0,0,0,8
1918700,1521265,2025-03-19,House,"House - Third Reading",56,1,3,0,60
1918729,1476320,2025-01-29,Senate,"Senate Government Committee Action (DPA)",4,3,0,0,7
1918729,1478885,2025-02-03,Senate,"Senate Rules Committee Action (PFC)",0,0,0,0,0
1918738,1476521,2025-01-29,Senate,"Senate Education Committee Action (DP)",4,3,0,0,7
1918738,1478844,2025-02-03,Senate,"Senate Rules Committee Action (PFC)",0,0,0,0,0
1918738,1484921,2025-02-10,Senate,"Senate - Committee of the Whole (RETAINED)",0,0,0,0,0
1918738,1498930,2025-02-25,Senate,"Senate - Committee of the Whole (DP)",0,0,0,0,0
1918738,1500081,2025-02-26,Senate,"Senate - Third Reading",17,12,1,0,30
1918738,1514254,2025-03-11,House,"House Education Committee Action (DP)",7,4,0,1,12
1918738,1518944,2025-03-17,House,"House Rules Committee Action (C&P)",8,0,0,0,8
1918738,1522658,2025-03-20,House,"House - Committee of the Whole (DP)",0,0,0,0,0
1918738,1545684,2025-01-29,Senate,"Senate Education-Archived and Renamed Education and Transportation as of 04/01/2025 Committee Action (DP)",4,3,0,0,7
1918738,1564986,2025-05-05,House,"House - Third Reading",32,25,3,0,60
1918749,1472857,2025-01-21,Senate,"Senate Natural Resources Committee Action (DP)",5,1,2,0,8
1918749,1476082,2025-01-28,Senate,"Senate Appropriations Committee Action (DP)",8,1,1,0,10
1918749,1478908,2025-02-03,Senate,"Senate Rules Committee Action (PFC)",0,0,0,0,0
1918749,1502177,2025-02-27,Senate,"Senate - Committee of the Whole (DP)",0,0,0,0,0
1918749,1503274,2025-03-03,Senate,"Senate - Third Reading",19,10,1,0,30
1918749,1520484,2025-03-18,House,"House Education Committee Action (FAILED)",5,7,0,0,12
1918764,1476930,2025-01-29,Senate,"Senate Public Safety Committee Action (DP)",7,0,0,0,7
1918764,1478758,2025-02-03,Senate,"Senate Rules Committee Action (PFC)",0,0,0,0,0
1918764,1488485,2025-02-12,Senate,"Senate - Third Reading",28,0,2,0,30
1918764,1521170,2025-03-19,House,"House Government Committee Action (DP)",6,0,0,1,7
1918764,1524850,2025-03-24,House,"House Rules Committee Action (C&P)",8,0,0,0,8
1918764,1528758,2025-03-27,House,"House - Third Reading",57,0,3,0,60
1918780,1476257,2025-01-29,Senate,"Senate Government Committee Action (DPA)",4,3,0,0,7
1918780,1478767,2025-02-03,Senate,"Senate Rules Committee Action (PFC)",0,0,0,0,0
1918780,1494988,2025-02-20,Senate,"Senate - Committee of the Whole (DPA)",0,0,0,0,0
1918780,1494989,2025-02-20,Senate,"Senate - Third Reading",17,12,1,0,30
1918793,1492753,2025-02-18,House,"House Government Committee Action (W/D)",0,0,0,0,0
1918793,1497436,2025-02-24,House,"House Appropriations Committee Action (DP)",11,5,2,0,18
1918793,1503273,2025-03-03,House,"House Rules Committee Action (C&P)",8,0,0,0,8
1918793,1504471,2025-03-04,House,"House - Committee of the Whole (RET ON CAL)",0,0,0,0,0
1918793,1516098,2025-03-12,House,"House - Committee of the Whole (DPA)",0,0,0,0,0
1918793,1521554,2025-03-19,House,"Motion Motion by Representative Carbone that pursuant to House Rule 12(P), HB2191 be calendared for an Additional Committee of the Whole for purposes of further amending. Motion passed v/v.",0,0,0,0,0
1918793,1521555,2025-03-19,House,"House - Committee of the Whole (DPA)",0,0,0,0,0
1918793,1522667,2025-03-20,House,"House - Third Reading",28,26,6,0,60
1918793,1522668,2025-03-20,House,"House - Reconsider Third Reading",0,0,0,0,0
1918806,1476554,2025-01-29,House,"House Appropriations Committee Action (DP)",17,0,0,1,18
1918806,1478336,2025-01-29,House,"House Appropriations Committee Action (DPA)",17,0,0,1,18
1918806,1484957,2025-02-10,House,"House Rules Committee Action (C&P)",8,0,0,0,8
1918806,1491145,2025-02-17,House,"House - Committee of the Whole (DPA)",0,0,0,0,0
1918806,1492116,2025-02-18,House,"House - Third Reading",60,0,0,0,60
1918806,1506482,2025-03-05,Senate,"Senate Public Safety Committee Action (DP)",6,0,1,0,7
1918806,1515572,2025-03-11,Senate,"Senate Appropriations Committee Action (DP)",10,0,0,0,10
1918817,1474999,2025-01-27,Senate,"Senate Finance Committee Action (DP)",4,3,0,0,7
1918817,1478832,2025-02-03,Senate,"Senate Rules Committee Action (PFC)",4,3,0,0,7
1918817,1501077,2025-02-27,Senate,"Senate - Committee of the Whole (DP)",0,0,0,0,0
1918817,1503693,2025-03-03,Senate,"Senate - Third Reading",17,12,1,0,30
1918817,1514189,2025-03-11,House,"House Commerce Committee Action (DP)",6,4,0,0,10
1918817,1518883,2025-03-17,House,"House Rules Committee Action (C&P)",8,0,0,0,8
1918817,1526548,2025-03-25,House,"House - Committee of the Whole (DP)",0,0,0,0,0
1918817,1565117,2025-05-05,House,"House - Third Reading",32,25,3,0,60
1918827,1475216,2025-01-27,Senate,"Senate Finance Committee Action (DP)",4,3,0,0,7
1918827,1478792,2025-02-03,Senate,"Senate Rules Committee Action (PFC)",0,0,0,0,0
1918827,1501237,2025-02-27,Senate,"Senate - Committee of the Whole (DP)",0,0,0,0,0
1918827,1503322,2025-03-03,Senate,"Senate - Third Reading",17,12,1,0,30
1918827,1520030,2025-03-18,House,"House Regulatory Oversight Committee Action (DP)",3,2,0,0,5
1918841,1473468,2025-01-23,Senate,"Senate Federalism Committee Action (W/D)",0,0,0,0,0
1918841,1479076,2025-02-03,Senate,"Senate Military Affairs and Border Security Committee Action (DP)",4,3,0,0,7
1918841,1484958,2025-02-10,Senate,"Senate Rules Committee Action (PFC)",4,2,1,0,7
1918841,1499014,2025-02-25,Senate,"Senate - Committee of the Whole (DP)",0,0,0,0,0
1918841,1499800,2025-02-26,Senate,"Senate - Third Reading",17,12,1,0,30
1918841,1518584,2025-03-17,House,"House Land, Agriculture & Rural Affairs Committee Action (DP)",6,2,0,1,9
1918841,1524832,2025-03-24,House,"House Rules Committee Action (C&P)",5,3,0,0,8
1918841,1531445,2025-03-31,House,"House - Committee of the Whole (DP)",0,0,0,0,0
1918841,1565530,2025-05-06,House,"Motion Motion by Representative Carbone that pursuant to House Rule 12(P), SB1109 be calendared for an Additional Committee of the Whole for purposes of further amending. Motion passed v/v.",0,0,0,0,0
1918841,1565531,2025-05-06,House,"House - Committee of the Whole (DPA)",0,0,0,0,0
1918841,1567214,2025-05-07,House,"House - Third Reading",41,17,2,0,60
1918854,1476722,2025-01-29,Senate,"Senate Public Safety Committee Action (DP)",7,0,0,0,7
1918854,1478857,2025-02-03,Senate,"Senate Rules Committee Action (PFC)",0,0,0,0,0
1918854,1487687,2025-02-12,Senate,"Senate - Third Reading",26,2,2,0,30
1918867,1476542,2025-01-29,Senate,"Senate Education Committee Action (DP)",6,0,1,0,7
1918867,1478886,2025-02-03,Senate,"Senate Rules Committee Action (PFC)",0,0,0,0,0
1918867,1494909,2025-02-20,Senate,"Senate - Committee of the Whole (DPA)",0,0,0,0,0
1918867,1494910,2025-02-20,Senate,"Senate - Third Reading",29,0,1,0,30
1918867,1503858,2025-03-03,House,"House Health & Human Services Committee Action (DP)",12,0,0,0,12
1918867,1509526,2025-03-10,House,"House Rules Committee Action (C&P)",6,0,0,2,8
1918867,1517177,2025-03-13,House,"House - Committee of the Whole (DP)",0,0,0,0,0
1918867,1520366,2025-03-18,House,"House - Third Reading",56,2,2,0,60
1918867,1545719,2025-01-29,Senate,"Senate Education-Archived and Renamed Education and Transportation as of 04/01/2025 Committee Action (DP)",6,0,1,0,7
1918898,1476127,2025-01-29,Senate,"Senate Regulatory Affairs and Government Efficiency Committee Action (DP)",6,1,0,0,7
1918898,1478989,2025-02-03,Senate,"Senate Rules Committee Action (PFC)",0,0,0,0,0
1918898,1498260,2025-02-24,Senate,"Senate - Committee of the Whole (DPA)",0,0,0,0,0
1918898,1498261,2025-02-24,Senate,"Senate - Third Reading",26,4,0,0,30
1918898,1518674,2025-03-17,House,"House Health & Human Services Committee Action (DPA)",7,5,0,0,12
1918898,1524927,2025-03-24,House,"House Rules Committee Action (C&P)",8,0,0,0,8
1918898,1553643,2025-04-22,House,"House - Committee of the Whole (DPA)",0,0,0,0,0
1918908,1494585,2025-02-19,Senate,"Senate Judiciary and Elections Committee Action (DP)",4,3,0,0,7
1918908,1497492,2025-02-24,Senate,"Senate Rules Committee Action (PFC)",4,3,0,0,7
1918908,1503318,2025-03-03,Senate,"Senate - Committee of the Whole (DP)",0,0,0,0,0
1918908,1506405,2025-03-05,Senate,"Senate - Third Reading",17,12,1,0,30
1918908,1521576,2025-03-19,House,"House Federalism, Military Affairs & Elections Committee Action (DP)",4,2,0,1,7
1918908,1524869,2025-03-24,House,"House Rules Committee Action (C&P)",8,0,0,0,8
1918908,1533047,2025-04-01,House,"House - Committee of the Whole (DP)",0,0,0,0,0
1918908,1566387,2025-05-06,House,"House - Third Reading",31,23,6,0,60
1918921,1475689,2025-01-28,House,"House Commerce Committee Action (DP)",10,0,0,0,10
1918921,1478877,2025-02-03,House,"House Rules Committee Action (C&P)",8,0,0,0,8
1918921,1489025,2025-02-13,House,"House - Third Reading",51,2,7,0,60
1918921,1503621,2025-03-03,Senate,"Senate Finance Committee Action (DP)",6,1,0,0,7
1918921,1518776,2025-03-17,Senate,"Senate Rules Committee Action (PFC)",0,0,0,0,0
1918921,1562173,2025-04-30,Senate,"Senate - Third Reading",26,1,3,0,30
1918934,1482386,2025-02-05,Senate,"Senate Judiciary and Elections Committee Action (DPA)",7,0,0,0,7
1918934,1485043,2025-02-10,Senate,"Senate Rules Committee Action (PFC)",0,0,0,0,0
1918934,1504390,2025-03-04,Senate,"Senate - Committee of the Whole (DPA)",0,0,0,0,0
1918934,1507171,2025-03-06,Senate,"Senate - Third Reading",27,0,3,0,30
1918934,1521056,2025-03-19,House,"House Judiciary Committee Action (DP)",9,0,0,0,9
1918934,1524884,2025-03-24,House,"House Rules Committee Action (C&P)",8,0,0,0,8
1918934,1543457,2025-04-10,House,"House - Third Reading",58,0,2,0,60
1918945,1476339,2025-01-29,Senate,"Senate Government Committee Action (DP)",4,3,0,0,7
1918945,1478802,2025-02-03,Senate,"Senate Rules Committee Action (PFC)",0,0,0,0,0
1918945,1494995,2025-02-20,Senate,"Senate - Committee of the Whole (DP)",0,0,0,0,0
1918945,1494996,2025-02-20,Senate,"Senate - Third Reading",17,12,1,0,30
1918945,1526700,2025-03-25,House,"House Commerce Committee Action (DP)",6,3,0,1,10
1918945,1531380,2025-03-31,House,"House Rules Committee Action (C&P)",7,0,0,1,8
1918945,1541895,2025-04-09,House,"House - Committee of the Whole (DP)",0,0,0,0,0
1918945,1563782,2025-05-01,House,"House - Third Reading",31,27,2,0,60
1918975,1476318,2025-01-29,Senate,"Senate Government Committee Action (DP)",4,3,0,0,7
1918975,1478854,2025-02-03,Senate,"Senate Rules Committee Action (PFC)",0,0,0,0,0
1918987,1476534,2025-01-29,Senate,"Senate Education Committee Action (DP)",4,3,0,0,7
1918987,1545832,2025-01-29,Senate,"Senate Education-Archived and Renamed Education and Transportation as of 04/01/2025 Committee Action (DP)",4,3,0,0,7
1919011,1491710,2025-02-17,Senate,"Senate Finance Committee Action (DP)",6,1,0,0,7
1919011,1499364,2025-02-25,Senate,"Senate Appropriations Committee Action (DP)",6,4,0,0,10
1919011,1503155,2025-03-03,Senate,"Senate Rules Committee Action (PFC)",0,0,0,0,0
1919011,1507548,2025-03-06,Senate,"Senate - Committee of the Whole (DPA)",0,0,0,0,0
1919011,1517214,2025-03-13,Senate,"Senate - Third Reading",17,10,3,0,30
1919011,1527613,2025-03-26,House,"House Ways & Means Committee Action (DP)",4,3,0,2,9
1919026,1488029,2025-02-12,Senate,"Senate Education Committee Action (DP)",6,0,1,0,7
1919026,1499391,2025-02-25,Senate,"Senate Appropriations Committee Action (DP)",10,0,0,0,10
1919026,1503548,2025-03-03,Senate,"Senate Rules Committee Action (PFC)",0,0,0,0,0
1919026,1507475,2025-03-06,Senate,"Senate - Committee of the Whole (DP)",0,0,0,0,0
1919026,1509514,2025-03-10,Senate,"Senate - Third Reading",25,2,3,0,30
1919026,1526660,2025-03-25,House,"House Education Committee Action (DPA)",10,2,0,0,12
1919026,1529318,2025-03-26,House,"House Appropriations Committee Action (HELD)",0,0,0,0,0
1919026,1531576,2025-03-31,House,"House Appropriations Committee Action (DPA)",17,1,0,0,18
1919026,1535360,2025-04-01,House,"House Rules Committee Action (C&P)",7,0,0,1,8
1919026,1545520,2025-02-12,Senate,"Senate Education-Archived and Renamed Education and Transportation as of 04/01/2025 Committee Action (DP)",6,0,1,0,7
1919036,1485236,2025-02-10,House,"House Health & Human Services Committee Action (W/D)",0,0,0,0,0
1919048,1476646,2025-01-29,Senate,"Senate Judiciary and Elections Committee Action (DP)",7,0,0,0,7
1919048,1486365,2025-02-11,Senate,"Senate Appropriations Committee Action (W/D)",0,0,0,0,0
1919048,1490978,2025-02-17,Senate,"Senate Rules Committee Action (PFC)",0,0,0,0,0
1919048,1501239,2025-02-27,Senate,"Senate - Third Reading",27,1,2,0,30
1919048,1521180,2025-03-19,House,"House Government Committee Action (DP)",6,0,0,1,7
1919048,1547287,2025-04-14,House,"House Rules Committee Action (C&P)",8,0,0,0,8
1919048,1558938,2025-04-28,House,"House - Third Reading",39,17,4,0,60
1919373,1475944,2025-01-28,House,"House Natural Resources, Energy & Water Committee Action (DP)",5,4,0,1,10
1919373,1479312,2025-02-03,House,"House Rules Committee Action (C&P)",8,0,0,0,8
1919373,1488363,2025-02-12,House,"House - Third Reading",32,27,1,0,60
1919373,1504910,2025-03-04,Senate,"Senate Natural Resources Committee Action (DP)",5,2,1,0,8
1919373,1518634,2025-03-17,Senate,"Senate Rules Committee Action (PFC)",0,0,0,0,0
1919373,1543236,2025-04-09,Senate,"Senate - Committee of the Whole (DPA)",0,0,0,0,0
1919373,1543237,2025-04-09,Senate,"Senate - Third Reading",16,14,0,0,30
1919373,1558916,2025-04-28,House,"House - Concurrence",0,0,0,0,0
1919373,1558917,2025-04-28,House,"House - Third Reading",32,23,5,0,60
1919407,1475730,2025-01-28,House,"House Commerce Committee Action (DP)",9,1,0,0,10
1919407,1498569,2025-02-25,House,"House Rules Committee Action (C&P)",7,0,0,1,8
1919407,1504641,2025-03-04,House,"House - Third Reading",58,0,2,0,60
1919407,1520962,2025-03-19,Senate,"Senate Regulatory Affairs and Government Efficiency Committee Action (DP)",7,0,0,0,7
1919407,1524725,2025-03-24,Senate,"Senate Rules Committee Action (PFC)",0,0,0,0,0
1919407,1531847,2025-03-31,Senate,"Senate - Third Reading",28,0,2,0,30
1919483,1475918,2025-01-28,House,"House Education Committee Action (DP)",9,3,0,0,12
1919483,1488226,2025-02-12,House,"House Appropriations Committee Action (DPA)",16,2,0,0,18
1919483,1497326,2025-02-24,House,"House Rules Committee Action (C&P)",7,0,0,1,8
1919483,1498774,2025-02-25,House,"House - Committee of the Whole (DPA)",0,0,0,0,0
1919520,1486390,2025-02-11,House,"House Commerce Committee Action (DP)",10,0,0,0,10
1919520,1491018,2025-02-17,House,"House Rules Committee Action (C&P)",7,0,0,1,8
1919520,1494806,2025-02-20,House,"House - Third Reading",47,11,2,0,60
1919520,1519486,2025-03-17,Senate,"Senate Finance Committee Action (DP)",6,1,0,0,7
1919558,1476551,2025-01-29,House,"House Federalism, Military Affairs & Elections Committee Action (DPA)",4,3,0,0,7
1919558,1485084,2025-02-10,House,"House Rules Committee Action (C&P)",8,0,0,0,8
1919558,1492399,2025-02-18,House,"House - Committee of the Whole (DPA)",0,0,0,0,0
1919558,1495166,2025-02-20,House,"House - Third Reading",33,26,1,0,60
1919558,1507160,2025-03-05,Senate,"Senate Judiciary and Elections Committee Action (DP)",4,3,0,0,7
1919558,1518759,2025-03-17,Senate,"Senate Rules Committee Action (PFC)",0,0,0,0,0
1919558,1551080,2025-04-17,Senate,"Senate - Committee of the Whole (DP)",0,0,0,0,0
1919558,1560456,2025-04-29,Senate,"Senate - Third Reading",17,12,1,0,30
1919596,1490113,2025-02-14,House,"House Natural Resources, Energy & Water Committee Action (DPA)",6,3,0,1,10
1919596,1497374,2025-02-24,House,"House Rules Committee Action (C&P)",7,0,0,1,8
1919596,1500351,2025-02-26,House,"House - Committee of the Whole (DPA)",0,0,0,0,0
1919596,1512312,2025-03-10,House,"House - Third Reading",31,25,4,0,60
1919596,1527892,2025-03-25,Senate,"Senate Natural Resources Committee Action (DP)",4,3,1,0,8
1919596,1530922,2025-03-31,Senate,"Senate Rules Committee Action (PFC)",0,0,0,0,0
1919634,1491411,2025-02-17,House,"House Health & Human Services Committee Action (DP)",9,0,2,1,12
1919668,1488087,2025-02-12,House,"House Federalism, Military Affairs & Elections Committee Action (DP)",4,3,0,0,7
1919668,1490899,2025-02-17,House,"House Rules Committee Action (C&P)",7,0,0,1,8
1919668,1494788,2025-02-20,House,"House - Committee of the Whole (RET ON CAL)",0,0,0,0,0
1919668,1499850,2025-02-26,House,"House - Committee of the Whole (DPA)",0,0,0,0,0
1919668,1503368,2025-03-03,House,"House - Third Reading",31,27,2,0,60
1919668,1528594,2025-03-26,Senate,"Senate Judiciary and Elections Committee Action (DP)",4,3,0,0,7
1919668,1531278,2025-03-31,Senate,"Senate Rules Committee Action (PFC)",0,0,0,0,0
1919668,1551425,2025-04-17,Senate,"Senate - Committee of the Whole (DPA)",0,0,0,0,0
1919668,1566615,2025-05-06,Senate,"Senate - Third Reading",17,11,2,0,30
1919668,1567453,2025-05-07,House,"House - Concurrence",0,0,0,0,0
1919668,1567454,2025-05-07,House,"House - Third Reading",33,25,2,0,60
1919706,1479073,2025-02-03,House,"House Land, Agriculture & Rural Affairs Committee Action (DPA/SE)",5,2,1,1,9
1919706,1485155,2025-02-10,House,"House Rules Committee Action (C&P)",5,2,1,0,8
1919706,1487879,2025-02-12,House,"House - Committee of the Whole (DPA)",0,0,0,0,0
1919706,1492337,2025-02-18,House,"House - Third Reading",28,32,0,0,60
1919706,1492338,2025-02-18,House,"House - Reconsider Third Reading",0,0,0,0,0
1919706,1497767,2025-02-24,House,"Motion Motion by Representative Carbone that pursuant to House Rule 12(P), HB2201 be calendared for an Additional Committee of the Whole for purposes of further amending. Motion passed v/v.",0,0,0,0,0
1919706,1497768,2025-02-24,House,"House - Committee of the Whole (DPA)",0,0,0,0,0
1919706,1499000,2025-02-25,House,"House - Third Reading",35,25,0,0,60
1919706,1525802,2025-03-24,Senate,"Senate Finance Committee Action (DPA)",5,2,0,0,7
1919706,1539582,2025-04-08,Senate,"Senate Rules Committee Action (PFC)",0,0,0,0,0
1919706,1553773,2025-04-22,Senate,"Senate - Committee of the Whole (DPA)",0,0,0,0,0
1919706,1560670,2025-04-29,Senate,"Senate - Third Reading",22,7,1,0,30
1919706,1565532,2025-05-06,House,"House - Concurrence",0,0,0,0,0
1919706,1565533,2025-05-06,House,"House - Third Reading",41,15,4,0,60
1919782,1475619,2025-01-28,House,"House Natural Resources, Energy & Water Committee Action (DP)",5,4,0,1,10
1919782,1478703,2025-02-03,House,"House Rules Committee Action (C&P)",8,0,0,0,8
1919782,1487906,2025-02-12,House,"House - Third Reading",32,27,1,0,60
1919782,1527240,2025-03-25,Senate,"Senate Natural Resources Committee Action (DP)",4,3,1,0,8
1919782,1531008,2025-03-31,Senate,"Senate Rules Committee Action (PFC)",0,0,0,0,0
1919782,1541784,2025-04-09,Senate,"Senate - Committee of the Whole (DP)",0,0,0,0,0
1919782,1541785,2025-04-09,Senate,"Senate - Third Reading",16,14,0,0,30
1919857,1476504,2025-01-29,House,"House Judiciary Committee Action (DPA)",9,0,0,0,9
1919857,1479208,2025-02-03,House,"House Rules Committee Action (C&P)",8,0,0,0,8
1919857,1486173,2025-02-11,House,"House - Committee of the Whole (DPA)",0,0,0,0,0
1919857,1488690,2025-02-13,House,"House - Third Reading",53,0,7,0,60
1919857,1521618,2025-03-19,Senate,"Senate Judiciary and Elections Committee Action (DP)",4,3,0,0,7
1919857,1524732,2025-03-24,Senate,"Senate Rules Committee Action (PFC)",0,0,0,0,0
1919857,1553699,2025-04-22,Senate,"Senate - Committee of the Whole (DP)",0,0,0,0,0
1919857,1560674,2025-04-29,Senate,"Senate - Third Reading",29,0,1,0,30
1919893,1493999,2025-02-19,House,"House Appropriations Committee Action (DPA)",11,6,1,0,18
1919893,1497317,2025-02-24,House,"House Rules Committee Action (C&P)",7,0,0,1,8
1919893,1498764,2025-02-25,House,"House - Committee of the Whole (DPA)",0,0,0,0,0
1919893,1500485,2025-02-26,House,"House - Third Reading",32,27,1,0,60
1920016,1493000,2025-02-19,House,"House Judiciary Committee Action (DP)",7,2,0,0,9
1920016,1497263,2025-02-24,House,"House Rules Committee Action (C&P)",4,3,0,1,8
1920016,1499967,2025-02-26,House,"House - Committee of the Whole (DP)",0,0,0,0,0
1920016,1503270,2025-03-03,House,"House - Third Reading",31,27,2,0,60
1920043,1474920,2025-01-27,House,"House Public Safety & Law Enforcement Committee Action (DP)",8,7,0,0,15
1920043,1478831,2025-02-03,House,"House Rules Committee Action (C&P)",8,0,0,0,8
1920043,1486537,2025-02-11,House,"House - Committee of the Whole (DP)",0,0,0,0,0
1920043,1487638,2025-02-12,House,"House - Third Reading",35,24,1,0,60
1920043,1505826,2025-03-05,Senate,"Senate Government Committee Action (DP)",4,3,0,0,7
1920043,1539574,2025-04-08,Senate,"Senate Rules Committee Action (PFC)",0,0,0,0,0
1920043,1553812,2025-04-22,Senate,"Senate - Committee of the Whole (RETAINED)",0,0,0,0,0
1920043,1556832,2025-04-24,Senate,"Senate - Committee of the Whole (DPA)",0,0,0,0,0
1920043,1560244,2025-04-29,Senate,"Senate - Third Reading",16,13,1,0,30
1920043,1565613,2025-05-06,House,"House - Concurrence",0,0,0,0,0
1920043,1565614,2025-05-06,House,"House - Third Reading",34,22,4,0,60
1920071,1479318,2025-02-03,House,"House Land, Agriculture & Rural Affairs Committee Action (DP)",6,2,0,1,9
1920100,1497853,2025-02-24,House,"House Appropriations Committee Action (DP)",13,3,1,1,18
1920100,1500984,2025-02-25,House,"House Rules Committee Action (C&P)",7,0,0,1,8
1920100,1504960,2025-03-04,House,"House - Third Reading",55,3,2,0,60
1920100,1521617,2025-03-19,Senate,"Senate Public Safety Committee Action (DP)",7,0,0,0,7
1920100,1527129,2025-03-25,Senate,"Senate Appropriations Committee Action (DP)",6,0,4,0,10
1920128,1482207,2025-02-05,House,"House Government Committee Action (HELD)",0,0,0,0,0
1920128,1487516,2025-02-12,House,"House Government Committee Action (DP)",4,3,0,0,7
1920128,1491008,2025-02-17,House,"House Rules Committee Action (C&P)",7,0,0,1,8
1920128,1494838,2025-02-20,House,"House - Committee of the Whole (DP)",0,0,0,0,0
1920128,1500426,2025-02-26,House,"Motion Motion by Representative Carbone that pursuant to House Rule 12(P), HB2216 be calendared for an Additional Committee of the Whole for purposes of further amending. Motion passed v/v.",0,0,0,0,0
1920128,1500427,2025-02-26,House,"House - Committee of the Whole (DPA)",0,0,0,0,0
1920159,1476555,2025-01-29,House,"House Federalism, Military Affairs & Elections Committee Action (HELD)",0,0,0,0,0
1920187,1479733,2025-02-04,House,"House Natural Resources, Energy & Water Committee Action (DP)",6,4,0,0,10
1920187,1485093,2025-02-10,House,"House Rules Committee Action (C&P)",8,0,0,0,8
1920187,1493440,2025-02-19,House,"House - Committee of the Whole (DPA)",0,0,0,0,0
1920187,1503209,2025-03-03,House,"Motion Motion by Representative Carbone that pursuant to House Rule 12(P), HB2223 be calendared for an Additional Committee of the Whole for purposes of further amending. Motion passed v/v.",0,0,0,0,0
1920187,1503210,2025-03-03,House,"House - Committee of the Whole (DPA)",0,0,0,0,0
1920187,1506306,2025-03-05,House,"House - Third Reading",25,33,2,0,60
1920187,1506307,2025-03-05,House,"House - Reconsider Third Reading",0,0,0,0,0
1920187,1516026,2025-03-12,House,"Motion Motion by Representative Carbone that pursuant to House Rule 12(P), HB2223 be calendared for an Additional Committee of the Whole for purposes of further amending. Motion passed v/v.",0,0,0,0,0
1920187,1516027,2025-03-12,House,"House - Committee of the Whole (DPA)",0,0,0,0,0
1920219,1486931,2025-02-11,House,"House Commerce Committee Action (DPA)",10,0,0,0,10
1920219,1490918,2025-02-17,House,"House Rules Committee Action (C&P)",7,0,0,1,8
1920219,1494794,2025-02-20,House,"House - Committee of the Whole (DPA)",0,0,0,0,0
1920219,1497919,2025-02-24,House,"House - Third Reading",16,43,1,0,60
1920219,1497920,2025-02-24,House,"House - Reconsider Third Reading",0,0,0,0,0
1920219,1501331,2025-02-27,House,"House - Third Reading",42,15,3,0,60
1920219,1527602,2025-03-26,Senate,"Senate Government Committee Action (DPA/SE)",4,3,0,0,7
1920219,1531242,2025-03-31,Senate,"Senate Rules Committee Action (PFC)",0,0,0,0,0
1920219,1553978,2025-04-22,Senate,"Senate - Committee of the Whole (DPA)",0,0,0,0,0
1920219,1560471,2025-04-29,Senate,"Senate - Third Reading",17,12,1,0,30
1920219,1565778,2025-05-06,House,"House - Concurrence",0,0,0,0,0
1920219,1565779,2025-05-06,House,"House - Third Reading",32,24,4,0,60
1920252,1485378,2025-02-10,House,"House Health & Human Services Committee Action (HELD)",0,0,0,0,0
1920280,1493271,2025-02-19,House,"House Government Committee Action (DP)",4,3,0,0,7
1920280,1497467,2025-02-24,House,"House Rules Committee Action (C&P)",7,0,0,1,8
1920280,1500461,2025-02-26,House,"House - Committee of the Whole (DP)",0,0,0,0,0
1920280,1505189,2025-03-04,House,"House - Third Reading",37,21,2,0,60
1920280,1521440,2025-03-19,Senate,"Senate Judiciary and Elections Committee Action (DPA)",4,3,0,0,7
1920280,1531230,2025-03-31,Senate,"Senate Rules Committee Action (PFC)",0,0,0,0,0
1920280,1555588,2025-04-23,Senate,"Senate - Committee of the Whole (DPA)",0,0,0,0,0
1920280,1560273,2025-04-29,Senate,"Senate - Third Reading",17,12,1,0,30
1920280,1565626,2025-05-06,House,"House - Concurrence",0,0,0,0,0
1920280,1565627,2025-05-06,House,"House - Third Reading",32,24,4,0,60
1920312,1480845,2025-02-05,House,"House Judiciary Committee Action (DISC/HELD)",0,0,0,0,0
1920312,1485731,2025-02-10,House,"House Judiciary Committee Action (W/D)",0,0,0,0,0
1920345,1488574,2025-02-12,House,"House Federalism, Military Affairs & Elections Committee Action (DP)",6,0,0,1,7
1920345,1503213,2025-03-03,House,"House Rules Committee Action (C&P)",8,0,0,0,8
1920405,1494040,2025-02-19,Senate,"Senate Government Committee Action (HELD)",0,0,0,0,0
1920405,1496838,2025-02-20,Senate,"Senate Government Committee Action (DPA/SE)",4,3,0,0,7
1920405,1503330,2025-03-03,Senate,"Senate Rules Committee Action (PFC)",5,4,0,0,9
1920436,1482938,2025-02-05,House,"House Transportation & Infrastructure Committee Action (HELD)",0,0,0,0,0
1920436,1494175,2025-02-19,House,"House Transportation & Infrastructure Committee Action (DPA/SE)",7,0,0,0,7
1920436,1497838,2025-02-24,House,"House Rules Committee Action (C&P)",7,0,0,1,8
1920436,1501154,2025-02-27,House,"House - Committee of the Whole (DPA)",0,0,0,0,0
1920436,1504522,2025-03-04,House,"House - Third Reading",31,27,2,0,60
1920436,1521933,2025-03-19,Senate,"Senate Public Safety Committee Action (HELD)",0,0,0,0,0
1920436,1527963,2025-03-26,Senate,"Senate Public Safety Committee Action (DP)",6,0,1,0,7
1920436,1532577,2025-04-01,Senate,"Senate Appropriations Committee Action (DP)",6,4,0,0,10
1920589,1492529,2025-02-18,House,"House Natural Resources, Energy & Water Committee Action (DP)",9,1,0,0,10
1920589,1497228,2025-02-24,House,"House Rules Committee Action (C&P)",7,0,0,1,8
1920589,1499880,2025-02-26,House,"House - Committee of the Whole (DPA)",0,0,0,0,0
1920589,1501313,2025-02-27,House,"House - Third Reading",57,0,3,0,60
1920589,1514191,2025-03-11,Senate,"Senate Natural Resources Committee Action (DP)",7,0,1,0,8
1920589,1518869,2025-03-17,Senate,"Senate Rules Committee Action (PFC)",0,0,0,0,0
1920589,1526586,2025-03-25,Senate,"Senate - Third Reading",25,0,4,0,29
1920623,1494245,2025-02-19,House,"House Government Committee Action (DP)",7,0,0,0,7
1920623,1497721,2025-02-24,House,"House Rules Committee Action (C&P)",7,0,0,1,8
1920623,1500669,2025-02-26,House,"House - Third Reading",57,1,2,0,60
1920623,1527736,2025-03-26,Senate,"Senate Government Committee Action (DPA)",7,0,0,0,7
1920623,1531283,2025-03-31,Senate,"Senate Rules Committee Action (PFC)",0,0,0,0,0
1920623,1553587,2025-04-22,Senate,"Senate - Committee of the Whole (DPA)",0,0,0,0,0
1920623,1560359,2025-04-29,Senate,"Senate - Third Reading",29,0,1,0,30
1920623,1566007,2025-05-06,House,"House - Concurrence",0,0,0,0,0
1920623,1566008,2025-05-06,House,"House - Third Reading",39,16,5,0,60
1920651,1476947,2025-01-29,House,"House Transportation & Infrastructure Committee Action (DPA)",6,1,0,0,7
1920651,1478957,2025-02-03,House,"House Rules Committee Action (C&P)",8,0,0,0,8
1920651,1486187,2025-02-11,House,"House - Committee of the Whole (DPA)",0,0,0,0,0
1920651,1491336,2025-02-17,House,"House - Third Reading",47,12,1,0,60
1920651,1506665,2025-03-05,Senate,"Senate Public Safety Committee Action (DP)",6,0,1,0,7
1920682,1485399,2025-02-10,House,"House Land, Agriculture & Rural Affairs Committee Action (HELD)",0,0,0,0,0
1920883,1482246,2025-02-05,House,"House Government Committee Action (DP)",4,3,0,0,7
1920883,1485147,2025-02-10,House,"House Rules Committee Action (C&P)",8,0,0,0,8
1920883,1493461,2025-02-19,House,"House - Committee of the Whole (DP)",0,0,0,0,0
1920883,1504891,2025-03-04,House,"House - Third Reading",36,22,2,0,60
1920904,1495699,2025-02-20,House,"House Natural Resources, Energy & Water Committee Action (DP)",4,3,0,3,10
1920904,1497217,2025-02-24,House,"House Rules Committee Action (C&P)",7,0,0,1,8
1920904,1500277,2025-02-26,House,"House - Third Reading",32,27,1,0,60
1920904,1520502,2025-03-18,Senate,"Senate Natural Resources Committee Action (DP)",4,3,1,0,8
1920904,1525304,2025-03-24,Senate,"Senate Rules Committee Action (PFC)",0,0,0,0,0
1920904,1551021,2025-04-16,Senate,"Senate - Third Reading",16,13,1,0,30
1920940,1479059,2025-02-03,Senate,"Senate Finance Committee Action (DPA)",6,0,1,0,7
1920940,1484951,2025-02-10,Senate,"Senate Rules Committee Action (PFC)",0,0,0,0,0
1920940,1499059,2025-02-25,Senate,"Senate - Committee of the Whole (DPA)",0,0,0,0,0
1920940,1500138,2025-02-26,Senate,"Senate - Third Reading",29,0,1,0,30
1920940,1520961,2025-03-19,House,"House Ways & Means Committee Action (DP)",9,0,0,0,9
1920940,1524836,2025-03-24,House,"House Rules Committee Action (C&P)",8,0,0,0,8
1920940,1547236,2025-04-14,House,"House - Third Reading",56,0,4,0,60
1920951,1489829,2025-02-13,House,"House Health & Human Services Committee Action (DP)",12,0,0,0,12
1920951,1497744,2025-02-24,House,"House Rules Committee Action (C&P)",7,0,0,1,8
1920951,1500976,2025-02-26,House,"House - Third Reading",45,13,2,0,60
1920951,1528026,2025-03-26,Senate,"Senate Health and Human Services Committee Action (DP)",7,0,0,0,7
1920964,1482188,2025-02-05,House,"House Government Committee Action (DPA)",4,3,0,0,7
1920964,1497252,2025-02-24,House,"House Rules Committee Action (C&P)",7,0,0,1,8
1920964,1498754,2025-02-25,House,"House - Committee of the Whole (DPA)",0,0,0,0,0
1920964,1500441,2025-02-26,House,"House - Third Reading",32,27,1,0,60
1920964,1527664,2025-03-26,Senate,"Senate Health and Human Services Committee Action (DP)",4,3,0,0,7
1920964,1531183,2025-03-31,Senate,"Senate Rules Committee Action (PFC)",0,0,0,0,0
1920964,1544185,2025-04-10,Senate,"Senate - Committee of the Whole (DP)",0,0,0,0,0
1920964,1548885,2025-04-15,Senate,"Senate - Third Reading",17,13,0,0,30
1920977,1488096,2025-02-12,House,"House Federalism, Military Affairs & Elections Committee Action (DP)",4,3,0,0,7
1920977,1490920,2025-02-17,House,"House Rules Committee Action (C&P)",7,0,0,1,8
1920977,1495274,2025-02-20,House,"House - Third Reading",33,26,1,0,60
1920977,1509683,2025-03-10,Senate,"Senate Military Affairs and Border Security Committee Action (DP)",4,2,1,0,7
1920977,1518806,2025-03-17,Senate,"Senate Rules Committee Action (PFC)",0,0,0,0,0
1920977,1549911,2025-04-16,Senate,"Senate - Third Reading",17,12,1,0,30
1920987,1490034,2025-02-14,House,"House Natural Resources, Energy & Water Committee Action (DP)",5,3,1,1,10
1920987,1497333,2025-02-24,House,"House Rules Committee Action (C&P)",7,0,0,1,8
1920987,1500552,2025-02-26,House,"House - Third Reading",32,27,1,0,60
1920987,1527276,2025-03-25,Senate,"Senate Natural Resources Committee Action (DP)",4,3,1,0,8
1920987,1531279,2025-03-31,Senate,"Senate Rules Committee Action (PFC)",0,0,0,0,0
1921012,1489153,2025-02-13,House,"House Health & Human Services Committee Action (DP)",12,0,0,0,12
1921012,1497363,2025-02-24,House,"House Rules Committee Action (C&P)",7,0,0,1,8
1921012,1500646,2025-02-26,House,"House - Third Reading",44,14,2,0,60
1921012,1527895,2025-03-26,Senate,"Senate Health and Human Services Committee Action (DP)",7,0,0,0,7
1921024,1482788,2025-02-05,House,"House Transportation & Infrastructure Committee Action (DP)",7,0,0,0,7
1921024,1484519,2025-02-05,House,"House Transportation & Infrastructure Committee Action (DPA)",7,0,0,0,7
1921024,1491132,2025-02-17,House,"House Rules Committee Action (C&P)",7,0,0,1,8
1921024,1494839,2025-02-20,House,"House - Committee of the Whole (DPA)",0,0,0,0,0
1921024,1497615,2025-02-24,House,"House - Third Reading",43,16,1,0,60
1921024,1527279,2025-03-25,Senate,"Senate Natural Resources Committee Action (DPA/SE)",4,3,1,0,8
1921024,1531018,2025-03-31,Senate,"Senate Rules Committee Action (PFC)",0,0,0,0,0
1921024,1541612,2025-04-09,Senate,"Senate - Committee of the Whole (DPA)",0,0,0,0,0
1921024,1542358,2025-04-09,Senate,"Senate - Third Reading",17,13,0,0,30
1921024,1567260,2025-05-07,House,"House - Concurrence",0,0,0,0,0
1921024,1567261,2025-05-07,House,"House - Third Reading",27,31,2,0,60
1921024,1567262,2025-05-07,House,"House - Reconsider Third Reading",0,0,0,0,0
1921081,1480131,2025-02-04,Senate,"Senate Natural Resources Committee Action (DPA)",5,3,0,0,8
1921108,1480094,2025-02-04,Senate,"Senate Natural Resources Committee Action (DP)",5,3,0,0,8
1921108,1486833,2025-02-11,Senate,"Senate Appropriations Committee Action (HELD)",0,0,0,0,0
1921108,1492553,2025-02-18,Senate,"Senate Appropriations Committee Action (DP)",6,3,1,0,10
1921108,1497542,2025-02-24,Senate,"Senate Rules Committee Action (PFC)",4,3,0,0,7
1921108,1503236,2025-03-03,Senate,"Senate - Committee of the Whole (DP)",0,0,0,0,0
1921108,1506318,2025-03-05,Senate,"Senate - Third Reading",15,14,1,0,30
1921108,1506319,2025-03-05,Senate,"Senate - Reconsider Third Reading",18,11,1,0,30
1921108,1509665,2025-03-10,Senate,"Senate - Third Reading",16,11,3,0,30
1921108,1528637,2025-03-27,House,"House Land, Agriculture & Rural Affairs Committee Action (DP)",6,3,0,0,9
1921132,1472741,2025-01-21,House,"House Natural Resources, Energy & Water Committee Action (DP)",6,2,0,2,10
1921132,1478704,2025-02-03,House,"House Rules Committee Action (C&P)",8,0,0,0,8
1921132,1486229,2025-02-11,House,"House - Third Reading",38,20,2,0,60
1921132,1505088,2025-03-04,Senate,"Senate Natural Resources Committee Action (DP)",6,1,1,0,8
1921132,1515587,2025-03-11,Senate,"Senate Appropriations Committee Action (DP)",8,2,0,0,10
1921132,1518582,2025-03-17,Senate,"Senate Rules Committee Action (PFC)",0,0,0,0,0
1921132,1563315,2025-04-30,Senate,"Senate - Third Reading",18,9,3,0,30
1921155,1476457,2025-01-29,House,"House Transportation & Infrastructure Committee Action (DP)",7,0,0,0,7
1921155,1503146,2025-03-03,House,"House Rules Committee Action (C&P)",8,0,0,0,8
1921155,1506176,2025-03-05,House,"House - Committee of the Whole (DPA)",0,0,0,0,0
1921166,1479058,2025-02-03,House,"House Health & Human Services Committee Action (DP)",9,2,1,0,12
1921166,1485080,2025-02-10,House,"House Rules Committee Action (C&P)",8,0,0,0,8
1921166,1495180,2025-02-20,House,"House - Third Reading",36,22,2,0,60
1921166,1505949,2025-03-05,Senate,"Senate Health and Human Services Committee Action (DP)",5,1,1,0,7
1921166,1518807,2025-03-17,Senate,"Senate Rules Committee Action (PFC)",0,0,0,0,0
1921166,1532796,2025-04-01,Senate,"Senate - Third Reading",16,13,1,0,30
1921203,1475656,2025-01-28,Senate,"Senate Natural Resources Committee Action (DP)",5,3,0,0,8
1921203,1490842,2025-02-17,Senate,"Senate Rules Committee Action (PFC)",0,0,0,0,0
1921203,1503221,2025-03-03,Senate,"Senate - Committee of the Whole (DPA)",0,0,0,0,0
1921203,1506297,2025-03-05,Senate,"Senate - Third Reading",16,13,1,0,30
1921203,1526678,2025-03-25,House,"House Natural Resources, Energy & Water Committee Action (FAILED)",5,5,0,0,10
1921214,1479005,2025-02-03,Senate,"Senate Finance Committee Action (DP)",6,0,1,0,7
1921214,1485058,2025-02-10,Senate,"Senate Rules Committee Action (PFC)",0,0,0,0,0
1921214,1501282,2025-02-27,Senate,"Senate - Third Reading",28,0,2,0,30
1921214,1515825,2025-03-12,House,"House Ways & Means Committee Action (DP)",7,0,0,2,9
1921214,1518843,2025-03-17,House,"House Rules Committee Action (C&P)",8,0,0,0,8
1921214,1525061,2025-03-24,House,"House - Third Reading",52,5,3,0,60
1921226,1490030,2025-02-14,House,"House Natural Resources, Energy & Water Committee Action (DPA/SE)",6,3,0,1,10
1921226,1497233,2025-02-24,House,"House Rules Committee Action (C&P)",7,0,0,1,8
1921226,1498674,2025-02-25,House,"House - Committee of the Whole (DPA)",0,0,0,0,0
1921226,1500358,2025-02-26,House,"House - Third Reading",31,28,1,0,60
1921226,1520288,2025-03-18,Senate,"Senate Natural Resources Committee Action (DP)",4,3,1,0,8
1921226,1524747,2025-03-24,Senate,"Senate Rules Committee Action (PFC)",0,0,0,0,0
1921226,1551395,2025-04-17,Senate,"Senate - Committee of the Whole (DPA)",0,0,0,0,0
1921226,1560432,2025-04-29,Senate,"Senate - Third Reading",17,11,2,0,30
1921226,1565966,2025-05-06,House,"House - Concurrence",0,0,0,0,0
1921226,1565967,2025-05-06,House,"House - Third Reading",31,23,6,0,60
1921288,1476645,2025-01-29,Senate,"Senate Judiciary and Elections Committee Action (DP)",7,0,0,0,7
1921288,1478842,2025-02-03,Senate,"Senate Rules Committee Action (PFC)",0,0,0,0,0
1921288,1501083,2025-02-27,Senate,"Senate - Committee of the Whole (DPA)",0,0,0,0,0
1921288,1503673,2025-03-03,Senate,"Senate - Third Reading",29,0,1,0,30
1921288,1527538,2025-03-26,House,"House Judiciary Committee Action (DPA/SE)",7,1,0,1,9
1921309,1476196,2025-01-29,Senate,"Senate Health and Human Services Committee Action (DPA)",5,1,1,0,7
1921309,1478892,2025-02-03,Senate,"Senate Rules Committee Action (PFC)",0,0,0,0,0
1921309,1498806,2025-02-25,Senate,"Senate - Committee of the Whole (DPA)",0,0,0,0,0
1921309,1499988,2025-02-26,Senate,"Senate - Third Reading",29,0,1,0,30
1921309,1509223,2025-03-10,House,"House Health & Human Services Committee Action (DP)",8,2,0,2,12
1921309,1518866,2025-03-17,House,"House Rules Committee Action (C&P)",8,0,0,0,8
1921309,1525196,2025-03-24,House,"House - Committee of the Whole (DP)",0,0,0,0,0
1921309,1526690,2025-03-25,House,"House - Third Reading",38,20,2,0,60
1921321,1489247,2025-02-13,House,"House Health & Human Services Committee Action (DPA/SE)",9,3,0,0,12
1921321,1498567,2025-02-25,House,"House Rules Committee Action (C&P)",7,0,0,1,8
1921321,1499910,2025-02-26,House,"House - Committee of the Whole (DPA)",0,0,0,0,0
1921332,1485801,2025-02-10,House,"House Public Safety & Law Enforcement Committee Action (DP)",11,4,0,0,15
1921332,1503320,2025-03-03,House,"House Rules Committee Action (C&P)",8,0,0,0,8
1921356,1479016,2025-02-03,Senate,"Senate Finance Committee Action (DP)",5,1,1,0,7
1921382,1487230,2025-02-11,House,"House Land, Agriculture & Rural Affairs Committee Action (W/D)",0,0,0,0,0
1921382,1494253,2025-02-19,House,"House Appropriations Committee Action (HELD)",0,0,0,0,0
1921382,1497989,2025-02-24,House,"House Appropriations Committee Action (DPA/SE)",16,2,0,0,18
1921382,1500592,2025-02-25,House,"House Rules Committee Action (C&P)",7,0,0,1,8
1921382,1500593,2025-02-26,House,"House - Committee of the Whole (RET ON CAL)",0,0,0,0,0
1921382,1501100,2025-02-27,House,"House - Committee of the Whole (DPA)",0,0,0,0,0
1921382,1504704,2025-03-04,House,"House - Third Reading",46,12,2,0,60
1921382,1532821,2025-04-01,Senate,"Senate Appropriations Committee Action (DPA)",10,0,0,0,10
1921432,1489751,2025-02-13,House,"House Health & Human Services Committee Action (DP)",12,0,0,0,12
1921432,1497733,2025-02-24,House,"House Rules Committee Action (C&P)",7,0,0,1,8
1921432,1500967,2025-02-26,House,"House - Third Reading",45,13,2,0,60
1921432,1528345,2025-03-26,Senate,"Senate Health and Human Services Committee Action (DP)",7,0,0,0,7
1921442,1490314,2025-02-14,House,"House Natural Resources, Energy & Water Committee Action (DP)",6,3,0,1,10
1921442,1497456,2025-02-24,House,"House Rules Committee Action (C&P)",7,0,0,1,8
1921442,1500827,2025-02-26,House,"House - Third Reading",33,27,0,0,60
1921452,1480444,2025-02-04,Senate,"Senate Natural Resources Committee Action (DP)",5,3,0,0,8
1921452,1485761,2025-02-10,Senate,"Senate Rules Committee Action (PFC)",4,2,1,0,7
1921452,1502128,2025-02-27,Senate,"Senate - Committee of the Whole (DPA)",0,0,0,0,0
1921452,1503862,2025-03-03,Senate,"Senate - Third Reading",17,12,1,0,30
1921452,1520348,2025-03-18,House,"House Natural Resources, Energy & Water Committee Action (DP)",5,3,0,2,10
1921452,1525561,2025-03-24,House,"House Rules Committee Action (C&P)",8,0,0,0,8
1921452,1533704,2025-04-01,House,"House - Committee of the Whole (RET ON CAL)",0,0,0,0,0
1921477,1480718,2025-02-05,House,"House Judiciary Committee Action (DPA)",6,3,0,0,9
1921477,1484929,2025-02-10,House,"House Rules Committee Action (C&P)",8,0,0,0,8
1921477,1491283,2025-02-17,House,"House - Committee of the Whole (DPA)",0,0,0,0,0
1921477,1493382,2025-02-19,House,"House - Third Reading",35,24,1,0,60
1921486,1482231,2025-02-05,House,"House Government Committee Action (DPA)",4,3,0,0,7
1921486,1485171,2025-02-10,House,"House Rules Committee Action (C&P)",8,0,0,0,8
1921486,1493577,2025-02-19,House,"House - Committee of the Whole (DPA)",0,0,0,0,0
1921486,1504473,2025-03-04,House,"House - Third Reading",36,22,2,0,60
1921486,1528541,2025-03-26,Senate,"Senate Judiciary and Elections Committee Action (DPA/SE)",4,3,0,0,7
1921486,1551282,2025-04-17,Senate,"Senate - Committee of the Whole (DPA)",0,0,0,0,0
1921486,1560263,2025-04-29,Senate,"Senate - Third Reading",17,12,1,0,30
1921486,1565623,2025-05-06,House,"House - Concurrence",0,0,0,0,0
1921486,1565624,2025-05-06,House,"House - Third Reading",36,19,5,0,60
1921518,1476360,2025-01-29,Senate,"Senate Health and Human Services Committee Action (DP)",6,0,1,0,7
1921518,1479946,2025-02-04,Senate,"Senate Appropriations Committee Action (DP)",8,1,1,0,10
1921518,1485189,2025-02-10,Senate,"Senate Rules Committee Action (PFC)",0,0,0,0,0
1921518,1501595,2025-02-27,Senate,"Senate - Third Reading",25,3,2,0,30
1921518,1528018,2025-03-26,House,"House Appropriations Committee Action (DP)",17,0,0,1,18
1921542,1479747,2025-02-04,House,"House Commerce Committee Action (DPA)",10,0,0,0,10
1921542,1484978,2025-02-10,House,"House Rules Committee Action (C&P)",8,0,0,0,8
1921542,1491285,2025-02-17,House,"House - Committee of the Whole (DPA)",0,0,0,0,0
1921542,1494985,2025-02-20,House,"Motion Motion by Representative Carbone that pursuant to House Rule 12(P), HB2322 be calendared for an Additional Committee of the Whole for purposes of further amending. Motion passed v/v.",0,0,0,0,0
1921542,1494986,2025-02-20,House,"House - Committee of the Whole (DPA)",0,0,0,0,0
1921542,1498986,2025-02-25,House,"House - Third Reading",60,0,0,0,60
1921542,1521182,2025-03-19,Senate,"Senate Government Committee Action (DP)",7,0,0,0,7
1921542,1524858,2025-03-24,Senate,"Senate Rules Committee Action (PFC)",0,0,0,0,0
1921542,1533171,2025-04-01,Senate,"Senate - Third Reading",18,11,1,0,30
1921572,1491438,2025-02-17,House,"House Health & Human Services Committee Action (DISC/HELD)",0,0,0,0,0
1921588,1476155,2025-01-29,Senate,"Senate Health and Human Services Committee Action (DP)",6,0,1,0,7
1921588,1479840,2025-02-04,Senate,"Senate Appropriations Committee Action (DP)",9,0,1,0,10
1921588,1485055,2025-02-10,Senate,"Senate Rules Committee Action (PFC)",0,0,0,0,0
1921588,1501541,2025-02-27,Senate,"Senate - Third Reading",26,2,2,0,30
1921588,1518728,2025-03-17,House,"House Health & Human Services Committee Action (DP)",12,0,0,0,12
1921588,1528040,2025-03-26,House,"House Appropriations Committee Action (DP)",15,2,0,1,18
1921588,1532441,2025-04-01,House,"House Rules Committee Action (C&P)",7,0,0,1,8
1921588,1547465,2025-04-14,House,"House - Committee of the Whole (DP)",0,0,0,0,0
1921588,1567021,2025-05-07,House,"House - Third Reading",48,10,2,0,60
1921601,1487040,2025-02-11,House,"House Natural Resources, Energy & Water Committee Action (DP)",10,0,0,0,10
1921601,1494433,2025-02-19,House,"House Appropriations Committee Action (DP)",18,0,0,0,18
1921601,1497646,2025-02-24,House,"House Rules Committee Action (C&P)",7,0,0,1,8
1921601,1500881,2025-02-26,House,"House - Third Reading",53,5,2,0,60
1921601,1515483,2025-03-11,Senate,"Senate Natural Resources Committee Action (DP)",8,0,0,0,8
1921601,1519894,2025-03-18,Senate,"Senate Appropriations Committee Action (DP)",9,0,1,0,10
1921610,1489475,2025-02-13,Senate,"Senate Regulatory Affairs and Government Efficiency Committee Action (DP)",5,0,2,0,7
1921610,1492871,2025-02-18,Senate,"Senate Appropriations Committee Action (DP)",9,0,1,0,10
1921610,1498433,2025-02-24,Senate,"Senate Rules Committee Action (PFC)",0,0,0,0,0
1921610,1512121,2025-03-10,Senate,"Senate - Third Reading",25,2,3,0,30
1921610,1528155,2025-03-26,House,"House Appropriations Committee Action (HELD)",0,0,0,0,0
1921610,1531374,2025-03-31,House,"House Appropriations Committee Action (DPA/SE)",18,0,0,0,18
1921610,1547881,2025-04-14,House,"House Rules Committee Action (C&P)",8,0,0,0,8
1921610,1551068,2025-04-17,House,"House - Committee of the Whole (DPA)",0,0,0,0,0
1921610,1562645,2025-04-30,House,"House - Third Reading",40,10,10,0,60
1921610,1566099,2025-05-06,Senate,"Senate - Concurrence",0,0,0,0,0
1921610,1566100,2025-05-06,Senate,"Senate - Third Reading",27,1,2,0,30
1921648,1489131,2025-02-13,House,"House Health & Human Services Committee Action (DP)",12,0,0,0,12
1921648,1497761,2025-02-24,House,"House Rules Committee Action (C&P)",7,0,0,1,8
1921648,1500935,2025-02-26,House,"House - Third Reading",50,8,2,0,60
1921648,1528189,2025-03-26,Senate,"Senate Health and Human Services Committee Action (DP)",7,0,0,0,7
1921683,1487229,2025-02-11,House,"House Natural Resources, Energy & Water Committee Action (DP)",6,4,0,0,10
1921683,1491654,2025-02-17,House,"House Rules Committee Action (C&P)",7,0,0,1,8
1921683,1495075,2025-02-20,House,"House - Third Reading",32,26,2,0,60
1921683,1514312,2025-03-11,Senate,"Senate Natural Resources Committee Action (DP)",5,3,0,0,8
1921683,1518792,2025-03-17,Senate,"Senate Rules Committee Action (PFC)",0,0,0,0,0
1921683,1541944,2025-04-09,Senate,"Senate - Committee of the Whole (DP)",0,0,0,0,0
1921683,1541945,2025-04-09,Senate,"Senate - Third Reading",17,13,0,0,30
1921706,1487148,2025-02-11,House,"House Natural Resources, Energy & Water Committee Action (DPA)",10,0,0,0,10
1921706,1491163,2025-02-17,House,"House Rules Committee Action (C&P)",7,0,0,1,8
1921706,1494699,2025-02-20,House,"House - Committee of the Whole (DPA)",0,0,0,0,0
1921706,1497875,2025-02-24,House,"House - Third Reading",54,5,1,0,60
1921706,1527232,2025-03-25,Senate,"Senate Natural Resources Committee Action (DP)",7,0,1,0,8
1921706,1531309,2025-03-31,Senate,"Senate Rules Committee Action (PFC)",0,0,0,0,0
1921706,1553644,2025-04-22,Senate,"Senate - Committee of the Whole (DP)",0,0,0,0,0
1921706,1560672,2025-04-29,Senate,"Senate - Third Reading",27,2,1,0,30
1921742,1493682,2025-02-19,Senate,"Senate Public Safety Committee Action (DP)",7,0,0,0,7
1921742,1497948,2025-02-24,Senate,"Senate Rules Committee Action (PFC)",0,0,0,0,0
1921742,1501747,2025-02-27,Senate,"Senate - Third Reading",28,0,2,0,30
1921742,1516749,2025-03-12,House,"House Transportation & Infrastructure Committee Action (W/D)",0,0,0,0,0
1921742,1527722,2025-03-26,House,"House Government Committee Action (DPA/SE)",5,2,0,0,7
1921742,1532432,2025-04-01,House,"House Rules Committee Action (C&P)",7,0,0,1,8
1921742,1536110,2025-04-03,House,"House - Committee of the Whole (DPA)",0,0,0,0,0
1921742,1567274,2025-05-07,House,"House - Third Reading",34,24,2,0,60
1921779,1476706,2025-01-29,Senate,"Senate Judiciary and Elections Committee Action (DP)",4,3,0,0,7
1921779,1478867,2025-02-03,Senate,"Senate Rules Committee Action (PFC)",0,0,0,0,0
1921779,1501306,2025-02-27,Senate,"Senate - Committee of the Whole (DP)",0,0,0,0,0
1921779,1503358,2025-03-03,Senate,"Senate - Third Reading",17,12,1,0,30
1921779,1521434,2025-03-19,House,"House Federalism, Military Affairs & Elections Committee Action (DP)",4,2,0,1,7
1921779,1524877,2025-03-24,House,"House Rules Committee Action (C&P)",8,0,0,0,8
1921779,1533079,2025-04-01,House,"House - Committee of the Whole (DP)",0,0,0,0,0
1921779,1548881,2025-04-15,House,"House - Third Reading",31,21,8,0,60
1921791,1489527,2025-02-13,Senate,"Senate Regulatory Affairs and Government Efficiency Committee Action (DP)",4,1,2,0,7
1921791,1497573,2025-02-24,Senate,"Senate Rules Committee Action (PFC)",0,0,0,0,0
1921791,1500300,2025-02-26,Senate,"Senate - Committee of the Whole (DP)",0,0,0,0,0
1921791,1501664,2025-02-27,Senate,"Senate - Third Reading",22,7,1,0,30
1921791,1531448,2025-03-31,House,"House Appropriations Committee Action (FAILED)",8,9,0,1,18
1921802,1494045,2025-02-19,House,"House Appropriations Committee Action (DPA/SE)",11,7,0,0,18
1921802,1497324,2025-02-24,House,"House Rules Committee Action (C&P)",7,0,0,1,8
1921802,1498780,2025-02-25,House,"House - Committee of the Whole (DPA)",0,0,0,0,0
1921802,1500489,2025-02-26,House,"House - Third Reading",32,27,1,0,60
1921802,1514165,2025-03-11,Senate,"Senate Appropriations Committee Action (DISC/HELD)",0,0,0,0,0
1921802,1520286,2025-03-18,Senate,"Senate Appropriations Committee Action (DP)",6,4,0,0,10
1921839,1485248,2025-02-10,House,"House Health & Human Services Committee Action (W/D)",0,0,0,0,0
1921873,1482409,2025-02-05,House,"House Transportation & Infrastructure Committee Action (DP)",7,0,0,0,7
1921873,1490908,2025-02-17,House,"House Rules Committee Action (C&P)",7,0,0,1,8
1921873,1494728,2025-02-20,House,"House - Committee of the Whole (DPA)",0,0,0,0,0
1921873,1499061,2025-02-25,House,"House - Third Reading",60,0,0,0,60
1921873,1506520,2025-03-05,Senate,"Senate Public Safety Committee Action (DPA)",6,0,1,0,7
1921873,1518864,2025-03-17,Senate,"Senate Rules Committee Action (PFC)",0,0,0,0,0
1921873,1525057,2025-03-24,Senate,"Senate - Committee of the Whole (RETAINED)",0,0,0,0,0
1921873,1561949,2025-04-30,Senate,"Senate - Committee of the Whole (DPA)",0,0,0,0,0
1921873,1566252,2025-05-06,Senate,"Senate - Third Reading",28,0,2,0,30
1921873,1567228,2025-05-07,House,"House - Concurrence",0,0,0,0,0
1921873,1567229,2025-05-07,House,"House - Third Reading",57,0,3,0,60
1921885,1490500,2025-02-14,House,"House Natural Resources, Energy & Water Committee Action (DP)",6,3,0,1,10
1921885,1497367,2025-02-24,House,"House Rules Committee Action (C&P)",7,0,0,1,8
1921885,1500910,2025-02-26,House,"House - Third Reading",26,34,0,0,60
1921885,1500911,2025-02-26,House,"House - Reconsider Third Reading",0,0,0,0,0
1921885,1516732,2025-03-12,House,"House - Third Reading",29,26,5,0,60
1921898,1476178,2025-01-29,House,"House Government Committee Action (FAILED)",1,6,0,0,7
1921924,1476118,2025-01-29,House,"House Government Committee Action (HELD)",0,0,0,0,0
1921947,1472715,2025-01-21,House,"House Natural Resources, Energy & Water Committee Action (DP)",5,3,0,2,10
1921947,1478808,2025-02-03,House,"House Rules Committee Action (C&P)",8,0,0,0,8
1921947,1487646,2025-02-12,House,"House - Third Reading",29,30,1,0,60
1921947,1487647,2025-02-12,House,"House - Reconsider Third Reading",0,0,0,0,0
1921947,1492221,2025-02-18,House,"House - Third Reading",33,27,0,0,60
1921947,1514193,2025-03-11,Senate,"Senate Natural Resources Committee Action (DP)",4,2,2,0,8
1921947,1518757,2025-03-17,Senate,"Senate Rules Committee Action (PFC)",0,0,0,0,0
1921947,1550205,2025-04-16,Senate,"Senate - Third Reading",17,12,1,0,30
1921968,1476088,2025-01-28,Senate,"Senate Natural Resources Committee Action (DP)",5,3,0,0,8
1921968,1478711,2025-02-03,Senate,"Senate Rules Committee Action (PFC)",0,0,0,0,0
1921968,1484873,2025-02-10,Senate,"Senate - Committee of the Whole (DP)",0,0,0,0,0
1921968,1486999,2025-02-11,Senate,"Senate - Third Reading",18,8,4,0,30
1921968,1520385,2025-03-18,House,"House Natural Resources, Energy & Water Committee Action (DP)",5,4,0,1,10
1921968,1524938,2025-03-24,House,"House Rules Committee Action (C&P)",8,0,0,0,8
1921968,1544088,2025-04-10,House,"House - Committee of the Whole (DP)",0,0,0,0,0
1921968,1558877,2025-04-28,House,"House - Third Reading",19,37,4,0,60
1921968,1559605,2025-04-28,House,"House - Reconsider Third Reading",0,0,0,0,0
1921993,1474068,2025-01-23,House,"House Public Safety & Law Enforcement Committee Action (W/D)",0,0,0,0,0
1921993,1482524,2025-02-05,House,"House Transportation & Infrastructure Committee Action (DP)",7,0,0,0,7
1921993,1490942,2025-02-17,House,"House Rules Committee Action (C&P)",7,0,0,1,8
1921993,1495050,2025-02-20,House,"House - Committee of the Whole (DPA)",0,0,0,0,0
1921993,1497657,2025-02-24,House,"House - Third Reading",59,0,1,0,60
1921993,1516207,2025-03-12,Senate,"Senate Public Safety Committee Action (DP)",7,0,0,0,7
1921993,1518891,2025-03-17,Senate,"Senate Rules Committee Action (PFC)",0,0,0,0,0
1921993,1551337,2025-04-17,Senate,"Senate - Committee of the Whole (DPA)",0,0,0,0,0
1921993,1562152,2025-04-30,Senate,"Senate - Committee of the Whole (DPA)",0,0,0,0,0
1921993,1566359,2025-05-06,Senate,"Senate - Third Reading",28,0,2,0,30
1921993,1567282,2025-05-07,House,"House - Concurrence",0,0,0,0,0
1921993,1567283,2025-05-07,House,"House - Third Reading",57,0,3,0,60
1922005,1488575,2025-02-12,House,"House Federalism, Military Affairs & Elections Committee Action (DP)",6,0,0,1,7
1922005,1497983,2025-02-24,House,"House Appropriations Committee Action (DP)",14,0,4,0,18
1922005,1499916,2025-02-26,House,"House - Committee of the Whole (DPA)",0,0,0,0,0
1922005,1500792,2025-02-25,House,"House Rules Committee Action (C&P)",7,0,0,1,8
1922005,1501342,2025-02-27,House,"House - Third Reading",57,0,3,0,60
1922005,1525050,2025-03-24,Senate,"Senate Military Affairs and Border Security Committee Action (DP)",7,0,0,0,7
1922005,1532626,2025-04-01,Senate,"Senate Appropriations Committee Action (DP)",9,0,1,0,10
1922018,1494020,2025-02-19,House,"House Transportation & Infrastructure Committee Action (DP)",4,2,1,0,7
1922018,1503532,2025-03-03,House,"House Rules Committee Action (HELD)",0,0,0,0,0
1922028,1492992,2025-02-19,House,"House Judiciary Committee Action (DPA/SE)",9,0,0,0,9
1922028,1497327,2025-02-24,House,"House Rules Committee Action (C&P)",7,0,0,1,8
1922028,1501070,2025-02-27,House,"House - Committee of the Whole (DPA)",0,0,0,0,0
1922028,1503495,2025-03-03,House,"House - Third Reading",58,0,2,0,60
1922028,1521600,2025-03-19,Senate,"Senate Judiciary and Elections Committee Action (DP)",6,1,0,0,7
1922028,1524817,2025-03-24,Senate,"Senate Rules Committee Action (PFC)",0,0,0,0,0
1922028,1549979,2025-04-16,Senate,"Senate - Third Reading",20,9,1,0,30
1922054,1495260,2025-02-20,House,"House Natural Resources, Energy & Water Committee Action (DPA/SE)",5,3,0,2,10
1922054,1497247,2025-02-24,House,"House Rules Committee Action (C&P)",7,0,0,1,8
1922054,1498687,2025-02-25,House,"House - Committee of the Whole (DPA)",0,0,0,0,0
1922065,1476512,2025-01-29,Senate,"Senate Education Committee Action (DP)",4,3,0,0,7
1922065,1478810,2025-02-03,Senate,"Senate Rules Committee Action (PFC)",0,0,0,0,0
1922065,1501473,2025-02-27,Senate,"Senate - Committee of the Whole (DP)",0,0,0,0,0
1922065,1503443,2025-03-03,Senate,"Senate - Third Reading",17,12,1,0,30
1922065,1545764,2025-01-29,Senate,"Senate Education-Archived and Renamed Education and Transportation as of 04/01/2025 Committee Action (DP)",4,3,0,0,7
1922078,1487307,2025-02-12,House,"House Government Committee Action (DP)",6,0,1,0,7
1922078,1490961,2025-02-17,House,"House Rules Committee Action (C&P)",7,0,0,1,8
1922078,1497877,2025-02-24,House,"House - Committee of the Whole (DPA)",0,0,0,0,0
1922078,1500196,2025-02-26,House,"Motion 
Motion by Representative Carbone that pursuant to House Rule 12(P), HB2296 be calendared for an Additional Committee of the Whole for purposes of further amending. Motion passed v/v.",0,0,0,0,0
1922078,1500197,2025-02-26,House,"House - Committee of the Whole (DPA)",0,0,0,0,0
1922078,1504912,2025-03-04,House,"Motion Motion by Representative Carbone that pursuant to House Rule 12(P), HB2296 be calendared for an Additional Committee of the Whole for purposes of further amending. Motion passed v/v.",0,0,0,0,0
1922078,1504913,2025-03-04,House,"House - Committee of the Whole (DPA)",0,0,0,0,0
1922078,1506214,2025-03-05,House,"House - Third Reading",37,21,2,0,60
1922090,1487051,2025-02-11,House,"House Natural Resources, Energy & Water Committee Action (DP)",9,0,0,1,10
1922123,1476090,2025-01-28,Senate,"Senate Natural Resources Committee Action (DPA)",5,3,0,0,8
1922123,1479323,2025-02-03,Senate,"Senate Rules Committee Action (PFC)",0,0,0,0,0
1922123,1499096,2025-02-25,Senate,"Senate - Committee of the Whole (DPA)",0,0,0,0,0
1922123,1499811,2025-02-26,Senate,"Senate - Third Reading",17,12,1,0,30
1922123,1514547,2025-03-11,House,"House Natural Resources, Energy & Water Committee Action (DP)",5,4,0,1,10
1922123,1518831,2025-03-17,House,"House Rules Committee Action (C&P)",8,0,0,0,8
1922123,1525011,2025-03-24,House,"House - Committee of the Whole (DP)",0,0,0,0,0
1922123,1526511,2025-03-25,House,"House - Third Reading",37,21,2,0,60
1922133,1476086,2025-01-28,Senate,"Senate Natural Resources Committee Action (DP)",5,3,0,0,8
1922133,1478707,2025-02-03,Senate,"Senate Rules Committee Action (PFC)",0,0,0,0,0
1922133,1499704,2025-02-25,Senate,"Senate - Committee of the Whole (DP)",0,0,0,0,0
1922133,1500134,2025-02-26,Senate,"Senate - Third Reading",18,11,1,0,30
1922133,1520423,2025-03-18,House,"House Natural Resources, Energy & Water Committee Action (DP)",5,4,0,1,10
1922133,1524941,2025-03-24,House,"House Rules Committee Action (C&P)",8,0,0,0,8
1922133,1544779,2025-04-10,House,"House - Committee of the Whole (DP)",0,0,0,0,0
1922133,1565287,2025-05-05,House,"House - Third Reading",32,25,3,0,60
1922164,1497764,2025-02-24,House,"House Appropriations Committee Action (DPA/SE)",17,0,0,1,18
1922164,1500361,2025-02-25,House,"House Rules Committee Action (C&P)",7,0,0,1,8
1922164,1501326,2025-02-27,House,"House - Committee of the Whole (DPA)",0,0,0,0,0
1922164,1504761,2025-03-04,House,"House - Third Reading",58,0,2,0,60
1922164,1520334,2025-03-18,Senate,"Senate Appropriations Committee Action (DP)",10,0,0,0,10
1922181,1492654,2025-02-18,House,"House Commerce Committee Action (DPA/SE)",9,0,0,1,10
1922181,1497355,2025-02-24,House,"House Rules Committee Action (C&P)",7,0,0,1,8
1922181,1500047,2025-02-26,House,"House - Committee of the Whole (RET ON CAL)",0,0,0,0,0
1922181,1501093,2025-02-27,House,"House - Committee of the Whole (DPA)",0,0,0,0,0
1922181,1504992,2025-03-04,House,"House - Third Reading",50,8,2,0,60
1922181,1519479,2025-03-17,Senate,"Senate Finance Committee Action (DP)",5,2,0,0,7
1922181,1539546,2025-04-08,Senate,"Senate Rules Committee Action (PFC)",0,0,0,0,0
1922181,1562126,2025-04-30,Senate,"Senate - Committee of the Whole (DPA)",0,0,0,0,0
1922181,1566451,2025-05-06,Senate,"Senate - Third Reading",16,12,2,0,30
1922181,1567363,2025-05-07,House,"House - Concurrence",0,0,0,0,0
1922181,1567364,2025-05-07,House,"House - Third Reading",26,32,2,0,60
1922181,1567365,2025-05-07,House,"House - Reconsider Third Reading",0,0,0,0,0
1922218,1497991,2025-02-24,House,"House Appropriations Committee Action (DPA/SE)",11,3,3,1,18
1922218,1499943,2025-02-26,House,"House - Committee of the Whole (DPA)",0,0,0,0,0
1922218,1500822,2025-02-25,House,"House Rules Committee Action (C&P)",7,0,0,1,8
1922218,1503623,2025-03-03,House,"House - Third Reading",27,31,2,0,60
1922218,1503624,2025-03-03,House,"House - Reconsider Third Reading",0,0,0,0,0
1922218,1506217,2025-03-05,House,"House - Third Reading",34,24,2,0,60
1922218,1520310,2025-03-18,Senate,"Senate Appropriations Committee Action (DP)",6,4,0,0,10
1922237,1492565,2025-02-18,House,"House Commerce Committee Action (DPA/SE)",6,4,0,0,10
1922237,1497332,2025-02-24,House,"House Rules Committee Action (HELD)",0,0,0,0,0
1922237,1499883,2025-02-25,House,"House Rules Committee Action (C&P)",5,2,0,1,8
1922899,1493570,2025-02-19,House,"House Health & Human Services Committee Action (W/D)",0,0,0,0,0
1922899,1497979,2025-02-24,House,"House Appropriations Committee Action (DPA)",18,0,0,0,18
1922899,1500817,2025-02-25,House,"House Rules Committee Action (C&P)",7,0,0,1,8
1922899,1501391,2025-02-27,House,"House - Committee of the Whole (DPA)",0,0,0,0,0
1922899,1503466,2025-03-03,House,"House - Third Reading",55,3,2,0,60
1922899,1515754,2025-03-12,Senate,"Senate Health and Human Services Committee Action (DPA)",6,0,1,0,7
1922899,1518895,2025-03-17,Senate,"Senate Rules Committee Action (PFC)",0,0,0,0,0
1922899,1551156,2025-04-17,Senate,"Senate - Committee of the Whole (DPA)",0,0,0,0,0
1922899,1560560,2025-04-29,Senate,"Senate - Third Reading",25,3,2,0,30
1922899,1567125,2025-05-07,House,"House - Concurrence",0,0,0,0,0
1922899,1567575,2025-05-07,House,"House - Third Reading",44,13,3,0,60
1923058,1485150,2025-02-10,House,"House Health & Human Services Committee Action (DP)",11,1,0,0,12
1923058,1497982,2025-02-24,House,"House Appropriations Committee Action (DPA)",16,0,0,2,18
1923058,1500734,2025-02-25,House,"House Rules Committee Action (C&P)",7,0,0,1,8
1923058,1500735,2025-02-26,House,"House - Committee of the Whole (DPA)",0,0,0,0,0
1923058,1501907,2025-02-27,House,"House - Third Reading",47,10,3,0,60
1923058,1515775,2025-03-12,Senate,"Senate Health and Human Services Committee Action (DP)",6,0,1,0,7
1923058,1520483,2025-03-18,Senate,"Senate Appropriations Committee Action (DP)",9,1,0,0,10
1923138,1485271,2025-02-10,House,"House Public Safety & Law Enforcement Committee Action (DPA/SE)",15,0,0,0,15
1923138,1490890,2025-02-17,House,"House Rules Committee Action (C&P)",7,0,0,1,8
1923138,1494738,2025-02-20,House,"House - Committee of the Whole (DPA)",0,0,0,0,0
1923138,1499125,2025-02-25,House,"House - Third Reading",60,0,0,0,60
1923138,1506530,2025-03-05,Senate,"Senate Public Safety Committee Action (DP)",6,0,1,0,7
1923138,1518856,2025-03-17,Senate,"Senate Rules Committee Action (PFC)",0,0,0,0,0
1923138,1561922,2025-04-30,Senate,"Senate - Third Reading",26,1,3,0,30
1923247,1480678,2025-02-05,House,"House Judiciary Committee Action (DPA)",6,3,0,0,9
1923247,1485019,2025-02-10,House,"House Rules Committee Action (C&P)",5,3,0,0,8
1923247,1491347,2025-02-17,House,"House - Committee of the Whole (DPA)",0,0,0,0,0
1923247,1493525,2025-02-19,House,"House - Third Reading",33,26,1,0,60
1923247,1521301,2025-03-19,Senate,"Senate Health and Human Services Committee Action (DP)",4,3,0,0,7
1923247,1524795,2025-03-24,Senate,"Senate Rules Committee Action (PFC)",5,4,0,0,9
1923247,1543687,2025-04-10,Senate,"Senate - Committee of the Whole (DPA)",0,0,0,0,0
1923247,1548507,2025-04-15,Senate,"Senate - Third Reading",17,13,0,0,30
1923247,1559218,2025-04-28,House,"House - Concurrence",0,0,0,0,0
1923247,1559219,2025-04-28,House,"House - Third Reading",32,23,5,0,60
1923264,1492047,2025-02-17,Senate,"Senate Finance Committee Action (DPA/SE)",5,2,0,0,7
1923264,1497567,2025-02-24,Senate,"Senate Rules Committee Action (PFC)",0,0,0,0,0
1923264,1500339,2025-02-26,Senate,"Senate - Committee of the Whole (RETAINED)",0,0,0,0,0
1923264,1503198,2025-03-03,Senate,"Senate - Committee of the Whole (DPA)",0,0,0,0,0
1923264,1506315,2025-03-05,Senate,"Senate - Third Reading",17,12,1,0,30
1923264,1521636,2025-03-19,House,"House Government Committee Action (W/D)",0,0,0,0,0
1923264,1527040,2025-03-25,House,"House Commerce Committee Action (DPA)",7,1,1,1,10
1923264,1547260,2025-04-14,House,"House Rules Committee Action (C&P)",8,0,0,0,8
1923286,1485595,2025-02-10,House,"House Health & Human Services Committee Action (W/D)",0,0,0,0,0
1923296,1479802,2025-02-04,House,"House Education Committee Action (DP)",6,4,0,2,12
1923296,1488185,2025-02-12,House,"House Appropriations Committee Action (FAILED)",7,9,1,1,18
1923311,1476772,2025-01-29,House,"House Federalism, Military Affairs & Elections Committee Action (DP)",6,1,0,0,7
1923311,1479251,2025-02-03,House,"House Rules Committee Action (C&P)",8,0,0,0,8
1923311,1487585,2025-02-12,House,"House - Third Reading",59,0,1,0,60
1923311,1507721,2025-03-05,Senate,"Senate Judiciary and Elections Committee Action (DP)",7,0,0,0,7
1923311,1519111,2025-03-17,Senate,"Senate Rules Committee Action (PFC)",0,0,0,0,0
1923311,1524809,2025-03-24,Senate,"Senate - Committee of the Whole (DPA)",0,0,0,0,0
1923311,1524810,2025-03-24,Senate,"Senate - Third Reading",26,1,2,0,29
1923311,1529014,2025-03-27,House,"House - Concurrence",0,0,0,0,0
1923311,1529015,2025-03-27,House,"House - Third Reading",56,1,3,0,60
1923318,1476644,2025-01-29,Senate,"Senate Judiciary and Elections Committee Action (DP)",5,2,0,0,7
1923318,1478798,2025-02-03,Senate,"Senate Rules Committee Action (PFC)",0,0,0,0,0
1923318,1484770,2025-02-10,Senate,"Senate - Committee of the Whole (DP)",0,0,0,0,0
1923318,1486487,2025-02-11,Senate,"Senate - Third Reading",19,7,4,0,30
1923318,1506532,2025-03-05,House,"House Federalism, Military Affairs & Elections Committee Action (DISC/HELD)",4,2,1,0,7
1923318,1528166,2025-03-26,House,"House Federalism, Military Affairs & Elections Committee Action (DPA)",4,2,1,0,7
1923318,1532468,2025-04-01,House,"House Rules Committee Action (C&P)",7,0,0,1,8
1923318,1536104,2025-04-03,House,"House - Committee of the Whole (RET ON CAL)",0,0,0,0,0
1923337,1480427,2025-02-04,House,"House Commerce Committee Action (DP)",8,2,0,0,10
1923337,1485643,2025-02-10,House,"House Rules Committee Action (C&P)",8,0,0,0,8
1923337,1492834,2025-02-18,House,"House - Third Reading",47,13,0,0,60
1923337,1526597,2025-03-24,Senate,"Senate Finance Committee Action (DPA)",5,2,0,0,7
1923337,1531332,2025-03-31,Senate,"Senate Rules Committee Action (PFC)",0,0,0,0,0
1923337,1567035,2025-05-07,Senate,"Senate - Committee of the Whole (DPA)",0,0,0,0,0
1923337,1567036,2025-05-07,Senate,"Senate - Third Reading",26,0,4,0,30
1923348,1479063,2025-02-03,House,"House Public Safety & Law Enforcement Committee Action (DP)",13,0,2,0,15
1923348,1485112,2025-02-10,House,"House Rules Committee Action (C&P)",8,0,0,0,8
1923348,1488683,2025-02-13,House,"House - Third Reading",53,0,7,0,60
1923348,1506478,2025-03-05,Senate,"Senate Public Safety Committee Action (HELD)",0,0,0,0,0
1923348,1516334,2025-03-12,Senate,"Senate Public Safety Committee Action (DP)",6,0,1,0,7
1923348,1520023,2025-03-18,Senate,"Senate Appropriations Committee Action (DP)",10,0,0,0,10
1923356,1480423,2025-02-04,House,"House Commerce Committee Action (DPA)",10,0,0,0,10
1923356,1503166,2025-03-03,House,"House Rules Committee Action (C&P)",8,0,0,0,8
1923356,1504884,2025-03-04,House,"House - Committee of the Whole (DPA)",0,0,0,0,0
1923365,1491391,2025-02-17,House,"House Public Safety & Law Enforcement Committee Action (DP)",9,3,1,2,15
1923365,1497256,2025-02-24,House,"House Rules Committee Action (C&P)",7,0,0,1,8
1923365,1498729,2025-02-25,House,"House - Committee of the Whole (RET ON CAL)",0,0,0,0,0
1923365,1500425,2025-02-26,House,"House - Committee of the Whole (DPA)",0,0,0,0,0
1923365,1504680,2025-03-04,House,"House - Third Reading",58,0,2,0,60
1923365,1521765,2025-03-19,Senate,"Senate Public Safety Committee Action (DP)",5,0,2,0,7
1923365,1524766,2025-03-24,Senate,"Senate Rules Committee Action (PFC)",0,0,0,0,0
1923365,1544051,2025-04-10,Senate,"Senate - Third Reading",28,1,1,0,30
1923380,1479716,2025-02-04,House,"House Education Committee Action (DP)",10,0,0,2,12
1923380,1484898,2025-02-10,House,"House Rules Committee Action (C&P)",8,0,0,0,8
1923380,1489042,2025-02-13,House,"House - Third Reading",46,8,6,0,60
1923380,1525151,2025-03-24,Senate,"Senate Education Committee Action (W/D)",0,0,0,0,0
1923380,1528067,2025-03-26,Senate,"Senate Health and Human Services Committee Action (DPA/SE)",6,1,0,0,7
1923380,1545765,2025-03-24,Senate,"Senate Education-Archived and Renamed Education and Transportation as of 04/01/2025 Committee Action (W/D)",0,0,0,0,0
1923400,1494165,2025-02-19,House,"House Government Committee Action (DP)",6,0,1,0,7
1923400,1497634,2025-02-24,House,"House Rules Committee Action (C&P)",7,0,0,1,8
1923400,1499930,2025-02-26,House,"House - Committee of the Whole (DPA)",0,0,0,0,0
1923400,1501301,2025-02-27,House,"House - Third Reading",45,12,3,0,60
1923414,1493268,2025-02-19,House,"House Government Committee Action (DPA)",4,3,0,0,7
1923414,1497270,2025-02-24,House,"House Rules Committee Action (C&P)",7,0,0,1,8
1923414,1498747,2025-02-25,House,"House - Committee of the Whole (DPA)",0,0,0,0,0
1923414,1500471,2025-02-26,House,"House - Third Reading",60,0,0,0,60
1923414,1521067,2025-03-19,Senate,"Senate Government Committee Action (DP)",7,0,0,0,7
1923414,1524675,2025-03-24,Senate,"Senate Rules Committee Action (PFC)",0,0,0,0,0
1923414,1551108,2025-04-17,Senate,"Senate - Committee of the Whole (DPA)",0,0,0,0,0
1923414,1560556,2025-04-29,Senate,"Senate - Third Reading",28,0,2,0,30
1923414,1566062,2025-05-06,House,"House - Concurrence",0,0,0,0,0
1923414,1566063,2025-05-06,House,"House - Third Reading",52,3,5,0,60
1923440,1479293,2025-02-03,House,"House Land, Agriculture & Rural Affairs Committee Action (DP)",6,2,0,1,9
1923452,1482255,2025-02-05,House,"House Transportation & Infrastructure Committee Action (DP)",7,0,0,0,7
1923452,1491199,2025-02-17,House,"House Rules Committee Action (C&P)",7,0,0,1,8
1923452,1495993,2025-02-20,House,"House - Third Reading",59,0,1,0,60
1923452,1506692,2025-03-05,Senate,"Senate Public Safety Committee Action (DP)",6,0,1,0,7
1923452,1518796,2025-03-17,Senate,"Senate Rules Committee Action (PFC)",0,0,0,0,0
1923452,1565976,2025-05-06,Senate,"Senate - Third Reading",28,0,2,0,30
1923461,1486974,2025-02-11,House,"House Education Committee Action (DP)",7,5,0,0,12
1923461,1491187,2025-02-17,House,"House Rules Committee Action (C&P)",7,0,0,1,8
1923461,1495334,2025-02-20,House,"House - Committee of the Whole (DP)",0,0,0,0,0
1923461,1498910,2025-02-25,House,"House - Third Reading",33,27,0,0,60
1923489,1482342,2025-02-05,House,"House Government Committee Action (DPA)",4,0,3,0,7
1923489,1485743,2025-02-10,House,"House Rules Committee Action (C&P)",8,0,0,0,8
1923489,1491494,2025-02-17,House,"House - Committee of the Whole (DP)",0,0,0,0,0
1923489,1492683,2025-02-18,House,"House - Third Reading",60,0,0,0,60
1923489,1506611,2025-03-05,Senate,"Senate Regulatory Affairs and Government Efficiency Committee Action (DP)",6,1,0,0,7
1923489,1518623,2025-03-17,Senate,"Senate Rules Committee Action (PFC)",0,0,0,0,0
1923489,1554057,2025-04-22,Senate,"Senate - Committee of the Whole (DP)",0,0,0,0,0
1923489,1560508,2025-04-29,Senate,"Senate - Third Reading",28,0,2,0,30
1923509,1482353,2025-02-05,House,"House Transportation & Infrastructure Committee Action (HELD)",0,0,0,0,0
1923539,1495754,2025-02-20,House,"House Government Committee Action (DP)",4,3,0,0,7
1923539,1497278,2025-02-24,House,"House Rules Committee Action (C&P)",7,0,0,1,8
1923539,1499939,2025-02-26,House,"House - Committee of the Whole (DPA)",0,0,0,0,0
1923539,1509302,2025-03-10,House,"Motion Motion by Representative Carbone that pursuant to House Rule 12(P), HCR2025 be calendared for an Additional Committee of the Whole for purposes of further amending. Motion passed v/v.",0,0,0,0,0
1923539,1509303,2025-03-10,House,"House - Committee of the Whole (DPA)",0,0,0,0,0
1923539,1509304,2025-03-10,House,"House - Representative Marquez  to include the Marquez Floor Amendment and exclude the Carter N  Floor amendment",24,30,6,0,60
1923539,1514590,2025-03-11,House,"House - Third Reading",31,26,3,0,60
1923539,1528668,2025-03-26,Senate,"Senate Judiciary and Elections Committee Action (DP)",4,2,1,0,7
1923567,1480702,2025-02-05,House,"House Judiciary Committee Action (DP)",5,3,1,0,9
1923567,1485024,2025-02-10,House,"House Rules Committee Action (C&P)",8,0,0,0,8
1923567,1491288,2025-02-17,House,"House - Committee of the Whole (DPA)",0,0,0,0,0
1923567,1493393,2025-02-19,House,"House - Third Reading",29,30,1,0,60
1923567,1493394,2025-02-19,House,"House - Reconsider Third Reading",0,0,0,0,0
1923567,1507057,2025-03-06,House,"Motion Motion by Representative Carbone that pursuant to House Rule 12(P), HB2437 be calendared for an Additional Committee of the Whole for purposes of further amending. Motion passed v/v.",0,0,0,0,0
1923567,1507058,2025-03-06,House,"House - Committee of the Whole (DPA)",0,0,0,0,0
1923567,1509299,2025-03-10,House,"House - Third Reading",31,25,4,0,60
1923567,1528598,2025-03-26,Senate,"Senate Judiciary and Elections Committee Action (DP)",4,3,0,0,7
1923567,1539663,2025-04-08,Senate,"Senate Rules Committee Action (PFC)",5,3,1,0,9
1923567,1553839,2025-04-22,Senate,"Senate - Committee of the Whole (DP)",0,0,0,0,0
1923567,1560782,2025-04-29,Senate,"Senate - Third Reading",15,13,2,0,30
1923567,1560783,2025-04-29,Senate,"Senate - Reconsider Third Reading",0,0,0,0,0
1923567,1566446,2025-05-06,Senate,"Senate - Third Reading",16,12,2,0,30
1923577,1476315,2025-01-29,House,"House Judiciary Committee Action (HELD)",0,0,0,0,0
1923577,1493348,2025-02-19,House,"House Judiciary Committee Action (DP)",5,0,4,0,9
1923577,1497224,2025-02-24,House,"House Rules Committee Action (C&P)",7,0,0,1,8
1923577,1501288,2025-02-27,House,"House - Committee of the Whole (DP)",0,0,0,0,0
1923577,1504652,2025-03-04,House,"House - Third Reading",48,10,2,0,60
1923577,1521412,2025-03-19,Senate,"Senate Judiciary and Elections Committee Action (DPA)",4,3,0,0,7
1923577,1524825,2025-03-24,Senate,"Senate Rules Committee Action (PFC)",5,4,0,0,9
1923577,1553863,2025-04-22,Senate,"Senate - Committee of the Whole (DPA)",0,0,0,0,0
1923577,1560286,2025-04-29,Senate,"Senate - Third Reading",18,10,2,0,30
1923577,1560808,2025-04-29,Senate,"Senate - Reconsider Third Reading",0,0,0,0,0
1923577,1560809,2025-04-29,Senate,"Senate - Third Reading",15,13,2,0,30
1923638,1491678,2025-02-17,House,"House Public Safety & Law Enforcement Committee Action (DP)",11,2,0,2,15
1923638,1497443,2025-02-24,House,"House Rules Committee Action (C&P)",7,0,0,1,8
1923638,1500886,2025-02-26,House,"House - Third Reading",41,19,0,0,60
1923638,1522155,2025-03-19,Senate,"Senate Public Safety Committee Action (DP)",7,0,0,0,7
1923638,1525276,2025-03-24,Senate,"Senate Rules Committee Action (PFC)",0,0,0,0,0
1923638,1529057,2025-03-27,Senate,"Senate - Third Reading",15,11,3,0,29
1923655,1491478,2025-02-17,House,"House Land, Agriculture & Rural Affairs Committee Action (DP)",6,3,0,0,9
1923655,1497311,2025-02-24,House,"House Rules Committee Action (HELD)",0,0,0,0,0
1923655,1503544,2025-03-03,House,"House Rules Committee Action (C&P)",8,0,0,0,8
1923655,1504839,2025-03-04,House,"House - Committee of the Whole (RET ON CAL)",0,0,0,0,0
1923655,1509577,2025-03-10,House,"House - Committee of the Whole (RET ON CAL)",0,0,0,0,0
1923655,1515942,2025-03-12,House,"House - Committee of the Whole (DP)",0,0,0,0,0
1923655,1518672,2025-03-17,House,"House - Third Reading",28,31,1,0,60
1923655,1518673,2025-03-17,House,"House - Reconsider Third Reading",0,0,0,0,0
1923655,1523109,2025-03-20,House,"House - Third Reading",33,20,7,0,60
1923684,1485592,2025-02-10,House,"House Public Safety & Law Enforcement Committee Action (DP)",15,0,0,0,15
1923690,1475702,2025-01-28,Senate,"Senate Natural Resources Committee Action (DP)",5,3,0,0,8
1923690,1478846,2025-02-03,Senate,"Senate Rules Committee Action (PFC)",0,0,0,0,0
1923690,1484752,2025-02-10,Senate,"Senate - Committee of the Whole (RETAINED)",0,0,0,0,0
1923690,1498879,2025-02-25,Senate,"Senate - Committee of the Whole (DPA)",0,0,0,0,0
1923690,1500067,2025-02-26,Senate,"Senate - Third Reading",17,12,1,0,30
1923690,1526676,2025-03-25,House,"House Natural Resources, Energy & Water Committee Action (DPA/SE)",9,0,0,1,10
1923690,1532428,2025-04-01,House,"House Rules Committee Action (C&P)",7,0,0,1,8
1923690,1538273,2025-04-07,House,"House - Committee of the Whole (DPA)",0,0,0,0,0
1923690,1547515,2025-04-14,House,"House - Third Reading",46,10,4,0,60
1923700,1484800,2025-02-10,House,"House Health & Human Services Committee Action (W/D)",0,0,0,0,0
1923707,1493021,2025-02-19,House,"House Ways & Means Committee Action (DP)",5,4,0,0,9
1923707,1497288,2025-02-24,House,"House Rules Committee Action (C&P)",7,0,0,1,8
1923707,1499933,2025-02-26,House,"House - Committee of the Whole (DP)",0,0,0,0,0
1923728,1482171,2025-02-05,House,"House Federalism, Military Affairs & Elections Committee Action (DP)",4,0,3,0,7
1923728,1484984,2025-02-10,House,"House Rules Committee Action (C&P)",8,0,0,0,8
1923728,1492405,2025-02-18,House,"House - Committee of the Whole (RET ON CAL)",0,0,0,0,0
1923728,1493552,2025-02-19,House,"House - Committee of the Whole (DPA)",0,0,0,0,0
1923728,1499138,2025-02-25,House,"House - Third Reading",54,6,0,0,60
1923736,1494079,2025-02-19,House,"House Appropriations Committee Action (DPA/SE)",18,0,0,0,18
1923736,1497236,2025-02-24,House,"House Rules Committee Action (C&P)",7,0,0,1,8
1923736,1501357,2025-02-27,House,"House - Committee of the Whole (DPA)",0,0,0,0,0
1923736,1505984,2025-03-05,House,"House - Third Reading",46,12,2,0,60
1923736,1520305,2025-03-18,Senate,"Senate Natural Resources Committee Action (DP)",7,0,1,0,8
1923736,1526710,2025-03-25,Senate,"Senate Appropriations Committee Action (DPA)",8,0,2,0,10
1923759,1492630,2025-02-18,House,"House Education Committee Action (DPA/SE)",6,2,4,0,12
1923759,1503151,2025-03-03,House,"House Rules Committee Action (C&P)",8,0,0,0,8
1923759,1504872,2025-03-04,House,"House - Committee of the Whole (RET ON CAL)",0,0,0,0,0
1923768,1492735,2025-02-18,House,"House Commerce Committee Action (DPA/SE)",5,4,0,1,10
1923768,1497344,2025-02-24,House,"House Rules Committee Action (C&P)",7,0,0,1,8
1923768,1501079,2025-02-27,House,"House - Committee of the Whole (DPA)",0,0,0,0,0
1923768,1503608,2025-03-03,House,"House - Third Reading",39,19,2,0,60
1923768,1521091,2025-03-19,Senate,"Senate Regulatory Affairs and Government Efficiency Committee Action (DP)",4,3,0,0,7
1923768,1524710,2025-03-24,Senate,"Senate Rules Committee Action (PFC)",0,0,0,0,0
1923768,1543981,2025-04-10,Senate,"Senate - Third Reading",17,12,1,0,30
1923793,1492560,2025-02-18,House,"House Regulatory Oversight Committee Action (DP)",3,2,0,0,5
1923793,1497253,2025-02-24,House,"House Rules Committee Action (C&P)",7,0,0,1,8
1923793,1499944,2025-02-26,House,"House - Committee of the Whole (DP)",0,0,0,0,0
1923802,1485180,2025-02-10,House,"House Health & Human Services Committee Action (W/D)",0,0,0,0,0
1923808,1485425,2025-02-10,House,"House Health & Human Services Committee Action (HELD)",0,0,0,0,0
1923817,1475885,2025-01-28,House,"House Judiciary Committee Action (W/D)",0,0,0,0,0
1923817,1495035,2025-02-20,House,"House Public Safety & Law Enforcement Committee Action (DP)",13,0,0,2,15
1923817,1503168,2025-03-03,House,"House Rules Committee Action (C&P)",8,0,0,0,8
1923826,1495682,2025-02-20,House,"House Government Committee Action (DP)",7,0,0,0,7
1923826,1499148,2025-02-25,House,"House Rules Committee Action (C&P)",7,0,0,1,8
1923826,1503775,2025-03-03,House,"House - Committee of the Whole (DPA)",0,0,0,0,0
1923826,1506618,2025-03-05,House,"House - Third Reading",42,15,3,0,60
1923833,1480547,2025-02-05,House,"House Government Committee Action (DPA)",6,0,0,1,7
1923833,1484941,2025-02-10,House,"House Rules Committee Action (C&P)",8,0,0,0,8
1923833,1491127,2025-02-17,House,"House - Committee of the Whole (DPA)",0,0,0,0,0
1923833,1491995,2025-02-18,House,"House - Third Reading",60,0,0,0,60
1923833,1505927,2025-03-05,Senate,"Senate Regulatory Affairs and Government Efficiency Committee Action (DP)",7,0,0,0,7
1923833,1518919,2025-03-17,Senate,"Senate Rules Committee Action (PFC)",0,0,0,0,0
1923833,1555405,2025-04-23,Senate,"Senate - Committee of the Whole (RETAINED)",0,0,0,0,0
1923846,1491688,2025-02-17,House,"House Public Safety & Law Enforcement Committee Action (DPA/SE)",11,2,1,1,15
1923846,1497798,2025-02-24,House,"House Rules Committee Action (C&P)",7,0,0,1,8
1923846,1498700,2025-02-25,House,"House - Committee of the Whole (RET ON CAL)",0,0,0,0,0
1923846,1503896,2025-03-03,House,"House - Committee of the Whole (DPA)",0,0,0,0,0
1923846,1509718,2025-03-10,House,"House - Third Reading",54,2,4,0,60
1923846,1528186,2025-03-26,Senate,"Senate Public Safety Committee Action (DPA)",6,1,0,0,7
1923846,1531258,2025-03-31,Senate,"Senate Rules Committee Action (PFC)",0,0,0,0,0
1923846,1542628,2025-04-09,Senate,"Senate - Committee of the Whole (DPA)",0,0,0,0,0
1923846,1542629,2025-04-09,Senate,"Senate - Third Reading",29,1,0,0,30
1923846,1559078,2025-04-28,House,"House - Concurrence",0,0,0,0,0
1923846,1559079,2025-04-28,House,"House - Third Reading",50,5,5,0,60
1923860,1487499,2025-02-12,House,"House Ways & Means Committee Action (DP)",5,4,0,0,9
1923860,1490936,2025-02-17,House,"House Rules Committee Action (C&P)",7,0,0,1,8
1923860,1493723,2025-02-19,House,"House - Committee of the Whole (DPA)",0,0,0,0,0
1923860,1503263,2025-03-03,House,"Motion Motion by Representative Carbone that pursuant to House Rule 12(P), HCR2021 be calendared for an Additional Committee of the Whole for purposes of further amending. Motion passed v/v.",0,0,0,0,0
1923860,1503264,2025-03-03,House,"House - Committee of the Whole (DPA)",0,0,0,0,0
1923860,1505072,2025-03-04,House,"House - Third Reading",37,21,2,0,60
1923860,1526017,2025-03-24,Senate,"Senate Finance Committee Action (DP)",7,0,0,0,7
1923877,1480520,2025-02-05,House,"House Government Committee Action (DPA)",7,0,0,0,7
1923877,1485501,2025-02-10,House,"House Rules Committee Action (C&P)",8,0,0,0,8
1923877,1491312,2025-02-17,House,"House - Committee of the Whole (DPA)",0,0,0,0,0
1923877,1493466,2025-02-19,House,"House - Third Reading",59,0,1,0,60
1923877,1515731,2025-03-12,Senate,"Senate Regulatory Affairs and Government Efficiency Committee Action (FAILED)",3,4,0,0,7
1923877,1527593,2025-03-26,Senate,"Senate Regulatory Affairs and Government Efficiency Committee Action (DPA)",6,1,0,0,7
1923877,1531184,2025-03-31,Senate,"Senate Rules Committee Action (PFC)",0,0,0,0,0
1923898,1480546,2025-02-05,House,"House Government Committee Action (DP)",4,3,0,0,7
1923898,1485152,2025-02-10,House,"House Rules Committee Action (C&P)",8,0,0,0,8
1923898,1493432,2025-02-19,House,"House - Committee of the Whole (RET ON CAL)",0,0,0,0,0
1923898,1494629,2025-02-20,House,"House - Committee of the Whole (RET ON CAL)",0,0,0,0,0
1923898,1498995,2025-02-25,House,"House - Committee of the Whole (DPA)",0,0,0,0,0
1923898,1500135,2025-02-26,House,"House - Third Reading",33,27,0,0,60
1923898,1520993,2025-03-19,Senate,"Senate Government Committee Action (DPA)",4,3,0,0,7
1923948,1486901,2025-02-11,House,"House Commerce Committee Action (DP)",8,2,0,0,10
1923948,1490979,2025-02-17,House,"House Rules Committee Action (C&P)",7,0,0,1,8
1923948,1497494,2025-02-24,House,"House - Committee of the Whole (DP)",0,0,0,0,0
1923948,1499160,2025-02-25,House,"House - Third Reading",34,26,0,0,60
1923976,1488018,2025-02-12,House,"House Federalism, Military Affairs & Elections Committee Action (DP)",4,2,1,0,7
1923976,1491370,2025-02-17,House,"House Rules Committee Action (C&P)",7,0,0,1,8
1923976,1495173,2025-02-20,House,"House - Third Reading",33,25,2,0,60
1923976,1507034,2025-03-05,Senate,"Senate Judiciary and Elections Committee Action (DP)",5,2,0,0,7
1923976,1518832,2025-03-17,Senate,"Senate Rules Committee Action (PFC)",0,0,0,0,0
1923976,1543849,2025-04-10,Senate,"Senate - Committee of the Whole (DPA)",0,0,0,0,0
1923976,1548685,2025-04-15,Senate,"Senate - Third Reading",18,12,0,0,30
1923976,1563738,2025-05-01,House,"House - Concurrence",0,0,0,0,0
1923976,1563739,2025-05-01,House,"House - Third Reading",41,16,3,0,60
1923993,1476446,2025-01-29,House,"House Federalism, Military Affairs & Elections Committee Action (DP)",7,0,0,0,7
1923993,1478751,2025-02-03,House,"House Rules Committee Action (C&P)",8,0,0,0,8
1923993,1485311,2025-02-10,House,"House - Third Reading",55,0,5,0,60
1923993,1507025,2025-03-05,Senate,"Senate Judiciary and Elections Committee Action (DP)",7,0,0,0,7
1923993,1518817,2025-03-17,Senate,"Senate Rules Committee Action (PFC)",0,0,0,0,0
1923993,1565672,2025-05-06,Senate,"Senate - Committee of the Whole (DPA)",0,0,0,0,0
1923993,1565673,2025-05-06,Senate,"Senate - Third Reading",28,0,2,0,30
1923993,1567448,2025-05-07,House,"House - Concurrence",0,0,0,0,0
1923993,1567449,2025-05-07,House,"House - Third Reading",58,0,2,0,60
1924028,1475834,2025-01-28,House,"House Education Committee Action (DPA)",7,5,0,0,12
1924028,1478843,2025-02-03,House,"House Rules Committee Action (C&P)",8,0,0,0,8
1924028,1487616,2025-02-12,House,"House - Committee of the Whole (DPA)",0,0,0,0,0
1924028,1491220,2025-02-17,House,"House - Third Reading",33,26,1,0,60
1924028,1506503,2025-03-05,Senate,"Senate Education Committee Action (DP)",4,3,0,0,7
1924028,1518804,2025-03-17,Senate,"Senate Rules Committee Action (PFC)",0,0,0,0,0
1924028,1544292,2025-04-10,Senate,"Senate - Committee of the Whole (DP)",0,0,0,0,0
1924028,1545599,2025-03-05,Senate,"Senate Education-Archived and Renamed Education and Transportation as of 04/01/2025 Committee Action (DP)",4,3,0,0,7
1924028,1548979,2025-04-15,Senate,"Senate - Third Reading",17,13,0,0,30
1924036,1480586,2025-02-05,House,"House Judiciary Committee Action (DPA)",6,3,0,0,9
1924036,1498066,2025-02-24,House,"House Rules Committee Action (C&P)",7,0,0,1,8
1924036,1499372,2025-02-25,House,"House - Committee of the Whole (DPA)",0,0,0,0,0
1924036,1500064,2025-02-26,House,"House - Third Reading",35,25,0,0,60
1924036,1522219,2025-03-19,Senate,"Senate Judiciary and Elections Committee Action (DP)",5,2,0,0,7
1924080,1476110,2025-01-29,House,"House International Trade Committee Action (DP)",9,0,0,1,10
1924080,1478839,2025-02-03,House,"House Rules Committee Action (C&P)",8,0,0,0,8
1924080,1493315,2025-02-19,House,"House - Third Reading",55,4,1,0,60
1924087,1480151,2025-02-04,House,"House Commerce Committee Action (DP)",10,0,0,0,10
1924087,1485139,2025-02-10,House,"House Rules Committee Action (C&P)",8,0,0,0,8
1924087,1488735,2025-02-13,House,"House - Third Reading",53,0,7,0,60
1924087,1509739,2025-03-10,Senate,"Senate Finance Committee Action (DP)",7,0,0,0,7
1924087,1518805,2025-03-17,Senate,"Senate Rules Committee Action (PFC)",0,0,0,0,0
1924087,1524986,2025-03-24,Senate,"Senate - Committee of the Whole (DPA)",0,0,0,0,0
1924087,1524987,2025-03-24,Senate,"Senate - Third Reading",27,0,2,0,29
1924087,1528889,2025-03-27,House,"House - Concurrence",0,0,0,0,0
1924087,1528890,2025-03-27,House,"House - Third Reading",57,0,3,0,60
1924097,1479070,2025-02-03,House,"House Health & Human Services Committee Action (DP)",12,0,0,0,12
1924097,1495214,2025-02-20,House,"House Government Committee Action (DP)",5,1,1,0,7
1924097,1497244,2025-02-24,House,"House Rules Committee Action (C&P)",7,0,0,1,8
1924097,1500455,2025-02-26,House,"House - Third Reading",46,12,2,0,60
1924097,1515745,2025-03-12,Senate,"Senate Health and Human Services Committee Action (DPA)",6,0,1,0,7
1924097,1518825,2025-03-17,Senate,"Senate Rules Committee Action (PFC)",0,0,0,0,0
1924097,1554182,2025-04-22,Senate,"Senate - Committee of the Whole (DPA)",0,0,0,0,0
1924097,1560548,2025-04-29,Senate,"Senate - Third Reading",24,4,2,0,30
1924097,1566121,2025-05-06,House,"House - Concurrence",0,0,0,0,0
1924097,1566122,2025-05-06,House,"House - Third Reading",42,13,5,0,60
1924107,1475713,2025-01-28,House,"House Commerce Committee Action (DP)",8,2,0,0,10
1924107,1478853,2025-02-03,House,"House Rules Committee Action (C&P)",8,0,0,0,8
1924107,1487592,2025-02-12,House,"House - Committee of the Whole (RET ON CAL)",0,0,0,0,0
1924126,1478934,2025-02-03,House,"House Land, Agriculture & Rural Affairs Committee Action (DP)",6,2,0,1,9
1924153,1482305,2025-02-05,House,"House Federalism, Military Affairs & Elections Committee Action (DP)",4,3,0,0,7
1924153,1485062,2025-02-10,House,"House Rules Committee Action (C&P)",8,0,0,0,8
1924153,1492343,2025-02-18,House,"House - Committee of the Whole (DP)",0,0,0,0,0
1924153,1495068,2025-02-20,House,"House - Third Reading",32,26,2,0,60
1924159,1476640,2025-01-29,Senate,"Senate Public Safety Committee Action (DP)",4,3,0,0,7
1924159,1478860,2025-02-03,Senate,"Senate Rules Committee Action (PFC)",0,0,0,0,0
1924159,1503579,2025-03-03,Senate,"Senate - Committee of the Whole (DP)",0,0,0,0,0
1924159,1506197,2025-03-05,Senate,"Senate - Third Reading",17,12,1,0,30
1924159,1527486,2025-03-26,House,"House Judiciary Committee Action (DP)",6,2,0,1,9
1924159,1538560,2025-04-07,House,"House Rules Committee Action (C&P)",7,0,0,1,8
1924159,1544009,2025-04-10,House,"House - Committee of the Whole (DP)",0,0,0,0,0
1924159,1565143,2025-05-05,House,"House - Third Reading",32,25,3,0,60
1924169,1480351,2025-02-04,House,"House Natural Resources, Energy & Water Committee Action (DP)",6,4,0,0,10
1924169,1485748,2025-02-10,House,"House Rules Committee Action (C&P)",8,0,0,0,8
1924169,1492341,2025-02-18,House,"House - Committee of the Whole (DPA)",0,0,0,0,0
1924169,1495404,2025-02-20,House,"House - Third Reading",41,18,1,0,60
1924169,1514147,2025-03-11,Senate,"Senate Natural Resources Committee Action (DP)",7,0,1,0,8
1924169,1518818,2025-03-17,Senate,"Senate Rules Committee Action (PFC)",0,0,0,0,0
1924169,1531384,2025-03-31,Senate,"Senate - Committee of the Whole (DP)",0,0,0,0,0
1924169,1531851,2025-03-31,Senate,"Senate - Third Reading",25,3,2,0,30
1924185,1478933,2025-02-03,House,"House Land, Agriculture & Rural Affairs Committee Action (DP)",6,2,0,1,9
1924193,1487464,2025-02-12,House,"House Ways & Means Committee Action (DPA)",5,4,0,0,9
1924193,1490921,2025-02-17,House,"House Rules Committee Action (C&P)",7,0,0,1,8
1924193,1494784,2025-02-20,House,"House - Committee of the Whole (DPA)",0,0,0,0,0
1924193,1499137,2025-02-25,House,"House - Third Reading",33,27,0,0,60
1924193,1509716,2025-03-10,Senate,"Senate Finance Committee Action (DP)",4,3,0,0,7
1924193,1520338,2025-03-18,Senate,"Senate Appropriations Committee Action (DP)",7,3,0,0,10
1924210,1490451,2025-02-14,House,"House Natural Resources, Energy & Water Committee Action (DISC/HELD)",0,0,0,0,0
1924222,1492576,2025-02-18,House,"House Commerce Committee Action (DPA)",9,0,0,1,10
1924222,1497303,2025-02-24,House,"House Rules Committee Action (C&P)",7,0,0,1,8
1924222,1499985,2025-02-26,House,"House - Committee of the Whole (RET ON CAL)",0,0,0,0,0
1924222,1501443,2025-02-27,House,"House - Committee of the Whole (DPA)",0,0,0,0,0
1924222,1504903,2025-03-04,House,"House - Third Reading",50,8,2,0,60
1924222,1528622,2025-03-26,Senate,"Senate Judiciary and Elections Committee Action (DPA)",7,0,0,0,7
1924222,1531152,2025-03-31,Senate,"Senate Rules Committee Action (PFC)",0,0,0,0,0
1924222,1553876,2025-04-22,Senate,"Senate - Committee of the Whole (DPA)",0,0,0,0,0
1924222,1560816,2025-04-29,Senate,"Senate - Third Reading",27,1,2,0,30
1924222,1565718,2025-05-06,House,"House - Concurrence",0,0,0,0,0
1924222,1565719,2025-05-06,House,"House - Third Reading",51,4,5,0,60
1924241,1476692,2025-01-29,Senate,"Senate Public Safety Committee Action (HELD)",0,0,0,0,0
1924241,1482500,2025-02-05,Senate,"Senate Public Safety Committee Action (DP)",7,0,0,0,7
1924241,1484901,2025-02-10,Senate,"Senate Rules Committee Action (PFC)",0,0,0,0,0
1924241,1501540,2025-02-27,Senate,"Senate - Third Reading",23,5,2,0,30
1924241,1520998,2025-03-19,House,"House Government Committee Action (DP)",7,0,0,0,7
1924241,1547347,2025-04-14,House,"House Rules Committee Action (C&P)",8,0,0,0,8
1924241,1565103,2025-05-05,House,"House - Third Reading",45,12,3,0,60
1924256,1476883,2025-01-29,House,"House Judiciary Committee Action (DP)",8,0,0,1,9
1924256,1478909,2025-02-03,House,"House Rules Committee Action (C&P)",8,0,0,0,8
1924256,1489323,2025-02-13,House,"House - Third Reading",53,0,7,0,60
1924256,1507717,2025-03-05,Senate,"Senate Judiciary and Elections Committee Action (HELD)",0,0,0,0,0
1924256,1516730,2025-03-12,Senate,"Senate Judiciary and Elections Committee Action (DP)",7,0,0,0,7
1924256,1519250,2025-03-17,Senate,"Senate Rules Committee Action (PFC)",0,0,0,0,0
1924256,1527986,2025-03-26,Senate,"Senate - Third Reading",27,0,2,0,29
1924291,1490340,2025-02-14,House,"House Natural Resources, Energy & Water Committee Action (DISC/HELD)",0,0,0,0,0
1924297,1479090,2025-02-03,House,"House Health & Human Services Committee Action (DP)",12,0,0,0,12
1924297,1484999,2025-02-10,House,"House Rules Committee Action (C&P)",8,0,0,0,8
1924297,1492406,2025-02-18,House,"House - Committee of the Whole (DPA)",0,0,0,0,0
1924297,1495162,2025-02-20,House,"House - Third Reading",58,0,2,0,60
1924297,1505823,2025-03-05,Senate,"Senate Health and Human Services Committee Action (DP)",5,0,2,0,7
1924297,1518862,2025-03-17,Senate,"Senate Rules Committee Action (PFC)",0,0,0,0,0
1924297,1527945,2025-03-26,Senate,"Senate - Third Reading",27,0,2,0,29
1924306,1493033,2025-02-19,House,"House Ways & Means Committee Action (DP)",5,4,0,0,9
1924306,1497307,2025-02-24,House,"House Rules Committee Action (C&P)",7,0,0,1,8
1924306,1500458,2025-02-26,House,"House - Third Reading",32,27,1,0,60
1924306,1519377,2025-03-17,Senate,"Senate Finance Committee Action (DP)",4,3,0,0,7
1924350,1499666,2025-02-25,Senate,"Senate Appropriations Committee Action (DP)",7,3,0,0,10
1924354,1490044,2025-02-14,House,"House Natural Resources, Energy & Water Committee Action (DP)",6,3,0,1,10
1924354,1497235,2025-02-24,House,"House Rules Committee Action (C&P)",7,0,0,1,8
1924354,1500416,2025-02-26,House,"House - Third Reading",32,26,2,0,60
1924354,1527266,2025-03-25,Senate,"Senate Natural Resources Committee Action (DP)",4,3,1,0,8
1924354,1531277,2025-03-31,Senate,"Senate Rules Committee Action (PFC)",0,0,0,0,0
1924354,1557015,2025-04-24,Senate,"Senate - Committee of the Whole (DP)",0,0,0,0,0
1924354,1566487,2025-05-06,Senate,"Senate - Third Reading",17,11,2,0,30
1924360,1485736,2025-02-10,House,"House Public Safety & Law Enforcement Committee Action (DPA)",9,2,4,0,15
1924360,1494089,2025-02-19,House,"House Appropriations Committee Action (DPA)",9,8,1,0,18
1924360,1503144,2025-03-03,House,"House Rules Committee Action (C&P)",8,0,0,0,8
1924360,1504890,2025-03-04,House,"House - Committee of the Whole (DPA)",0,0,0,0,0
1924360,1506225,2025-03-05,House,"House - Third Reading",33,25,2,0,60
1924360,1521744,2025-03-19,Senate,"Senate Public Safety Committee Action (HELD)",0,0,0,0,0
1924360,1527967,2025-03-26,Senate,"Senate Public Safety Committee Action (DP)",6,1,0,0,7
1924360,1532707,2025-04-01,Senate,"Senate Appropriations Committee Action (DP)",7,3,0,0,10
1924365,1485357,2025-02-10,House,"House Land, Agriculture & Rural Affairs Committee Action (DPA)",4,2,1,2,9
1924365,1491559,2025-02-17,House,"House Rules Committee Action (C&P)",7,0,0,1,8
1924365,1495818,2025-02-20,House,"House - Committee of the Whole (DPA)",0,0,0,0,0
1924365,1499135,2025-02-25,House,"House - Third Reading",52,8,0,0,60
1924365,1514750,2025-03-11,Senate,"Senate Natural Resources Committee Action (DPA)",8,0,0,0,8
1924365,1518575,2025-03-17,Senate,"Senate Rules Committee Action (PFC)",0,0,0,0,0
1924365,1530876,2025-03-31,Senate,"Senate - Committee of the Whole (DPA)",0,0,0,0,0
1924365,1531849,2025-03-31,Senate,"Senate - Third Reading",26,2,2,0,30
1924365,1544443,2025-04-10,House,"House - Concurrence",0,0,0,0,0
1924365,1544444,2025-04-10,House,"House - Third Reading",48,10,2,0,60
1924387,1482296,2025-02-05,House,"House Federalism, Military Affairs & Elections Committee Action (DP)",7,0,0,0,7
1924387,1484927,2025-02-10,House,"House Rules Committee Action (C&P)",8,0,0,0,8
1924387,1488656,2025-02-13,House,"House - Third Reading",54,0,6,0,60
1924387,1507019,2025-03-05,Senate,"Senate Judiciary and Elections Committee Action (HELD)",0,0,0,0,0
1924387,1516296,2025-03-12,Senate,"Senate Judiciary and Elections Committee Action (FAILED)",2,5,0,0,7
1924400,1485389,2025-02-10,House,"House Health & Human Services Committee Action (DP)",10,0,0,2,12
1924400,1491367,2025-02-17,House,"House Rules Committee Action (C&P)",7,0,0,1,8
1924400,1495187,2025-02-20,House,"House - Third Reading",58,0,2,0,60
1924400,1505844,2025-03-05,Senate,"Senate Health and Human Services Committee Action (DP)",6,0,1,0,7
1924400,1518841,2025-03-17,Senate,"Senate Rules Committee Action (PFC)",0,0,0,0,0
1924400,1527881,2025-03-26,Senate,"Senate - Third Reading",27,0,2,0,29
1924405,1493015,2025-02-19,House,"House Judiciary Committee Action (DP)",6,0,3,0,9
1924405,1497300,2025-02-24,House,"House Rules Committee Action (C&P)",7,0,0,1,8
1924405,1501038,2025-02-27,House,"Motion Motion by Representative Carbone that pursuant to House Rule 12(P), HB2607 be calendared for an Additional Committee of the Whole for purposes of further amending. Motion passed v/v.",0,0,0,0,0
1924405,1501411,2025-02-27,House,"House - Committee of the Whole (DPA)",0,0,0,0,0
1924405,1503490,2025-03-03,House,"House - Third Reading",46,12,2,0,60
1924405,1528610,2025-03-26,Senate,"Senate Judiciary and Elections Committee Action (DP)",4,3,0,0,7
1924405,1531246,2025-03-31,Senate,"Senate Rules Committee Action (PFC)",0,0,0,0,0
1924405,1544168,2025-04-10,Senate,"Senate - Committee of the Whole (DP)",0,0,0,0,0
1924405,1549814,2025-04-16,Senate,"Senate - Third Reading",17,13,0,0,30
1924412,1491721,2025-02-17,Senate,"Senate Finance Committee Action (DP)",5,1,1,0,7
1924412,1499381,2025-02-25,Senate,"Senate Appropriations Committee Action (DP)",10,0,0,0,10
1924412,1503499,2025-03-03,Senate,"Senate Rules Committee Action (PFC)",0,0,0,0,0
1924412,1518680,2025-03-17,Senate,"Senate - Committee of the Whole (DP)",0,0,0,0,0
1924412,1518681,2025-03-17,Senate,"Senate - Third Reading",24,3,2,0,29
1924412,1527671,2025-03-26,House,"House Government Committee Action (DP)",7,0,0,0,7
1924412,1547272,2025-04-14,House,"House Rules Committee Action (C&P)",8,0,0,0,8
1924416,1491714,2025-02-17,Senate,"Senate Finance Committee Action (DP)",6,1,0,0,7
1924416,1499379,2025-02-25,Senate,"Senate Appropriations Committee Action (DP)",10,0,0,0,10
1924416,1503153,2025-03-03,Senate,"Senate Rules Committee Action (PFC)",0,0,0,0,0
1924416,1518893,2025-03-17,Senate,"Senate - Committee of the Whole (DP)",0,0,0,0,0
1924416,1518894,2025-03-17,Senate,"Senate - Third Reading",24,3,2,0,29
1924416,1527706,2025-03-26,House,"House Government Committee Action (DP)",7,0,0,0,7
1924416,1547263,2025-04-14,House,"House Rules Committee Action (C&P)",8,0,0,0,8
1924424,1482185,2025-02-05,House,"House Government Committee Action (DP)",6,1,0,0,7
1924424,1497239,2025-02-24,House,"House Rules Committee Action (C&P)",7,0,0,1,8
1924424,1500432,2025-02-26,House,"House - Third Reading",49,9,2,0,60
1924433,1482665,2025-02-05,House,"House Judiciary Committee Action (DPA)",9,0,0,0,9
1924433,1485722,2025-02-10,House,"House Rules Committee Action (C&P)",8,0,0,0,8
1924433,1491659,2025-02-17,House,"House - Committee of the Whole (DPA)",0,0,0,0,0
1924433,1494055,2025-02-19,House,"House - Third Reading",57,2,1,0,60
1924451,1492653,2025-02-18,House,"House Natural Resources, Energy & Water Committee Action (DP)",5,4,0,1,10
1924451,1497251,2025-02-24,House,"House Rules Committee Action (C&P)",7,0,0,1,8
1924451,1500404,2025-02-26,House,"House - Third Reading",33,27,0,0,60
1924451,1514266,2025-03-11,Senate,"Senate Natural Resources Committee Action (DP)",5,3,0,0,8
1924451,1518892,2025-03-17,Senate,"Senate Rules Committee Action (PFC)",0,0,0,0,0
1924451,1544222,2025-04-10,Senate,"Senate - Committee of the Whole (DP)",0,0,0,0,0
1924451,1549778,2025-04-16,Senate,"Senate - Third Reading",17,13,0,0,30
1924487,1479694,2025-02-04,House,"House Regulatory Oversight Committee Action (DPA)",3,2,0,0,5
1924487,1485097,2025-02-10,House,"House Rules Committee Action (C&P)",8,0,0,0,8
1924487,1493499,2025-02-19,House,"House - Committee of the Whole (DPA)",0,0,0,0,0
1924522,1486930,2025-02-11,House,"House Natural Resources, Energy & Water Committee Action (DISC/HELD)",0,0,0,0,0
1924522,1492678,2025-02-18,House,"House Natural Resources, Energy & Water Committee Action (DPA)",5,4,0,1,10
1924522,1497258,2025-02-24,House,"House Rules Committee Action (C&P)",7,0,0,1,8
1924522,1498736,2025-02-25,House,"House - Committee of the Whole (RET ON CAL)",0,0,0,0,0
1924522,1503258,2025-03-03,House,"House - Committee of the Whole (RET ON CAL)",0,0,0,0,0
1924522,1509123,2025-03-10,House,"House - Committee of the Whole (DPA)",0,0,0,0,0
1924522,1513980,2025-03-11,House,"House - Third Reading",31,26,3,0,60
1924522,1527692,2025-03-26,Senate,"Senate Government Committee Action (DP)",4,3,0,0,7
1924522,1531231,2025-03-31,Senate,"Senate Rules Committee Action (PFC)",0,0,0,0,0
1924522,1544124,2025-04-10,Senate,"Senate - Committee of the Whole (DP)",0,0,0,0,0
1924522,1549805,2025-04-16,Senate,"Senate - Third Reading",16,14,0,0,30
1924538,1490310,2025-02-14,House,"House Natural Resources, Energy & Water Committee Action (DP)",6,3,0,1,10
1924538,1497836,2025-02-24,House,"House Rules Committee Action (C&P)",7,0,0,1,8
1924538,1500309,2025-02-26,House,"House - Third Reading",33,27,0,0,60
1924538,1527973,2025-03-25,Senate,"Senate Natural Resources Committee Action (DP)",4,3,1,0,8
1924538,1531340,2025-03-31,Senate,"Senate Rules Committee Action (PFC)",0,0,0,0,0
1924543,1482969,2025-02-05,Senate,"Senate Public Safety Committee Action (DP)",7,0,0,0,7
1924543,1485667,2025-02-10,Senate,"Senate Rules Committee Action (PFC)",0,0,0,0,0
1924543,1501317,2025-02-27,Senate,"Senate - Third Reading",24,4,2,0,30
1924543,1519061,2025-03-17,House,"House Public Safety & Law Enforcement Committee Action (DP)",11,3,0,1,15
1924543,1547876,2025-04-14,House,"House Rules Committee Action (C&P)",8,0,0,0,8
1924563,1486932,2025-02-11,House,"House Commerce Committee Action (DP)",8,1,0,1,10
1924563,1491589,2025-02-17,House,"House Rules Committee Action (C&P)",7,0,0,1,8
1924563,1495736,2025-02-20,House,"House - Committee of the Whole (DPA)",0,0,0,0,0
1924563,1499431,2025-02-25,House,"House - Third Reading",38,22,0,0,60
1924563,1515843,2025-03-12,Senate,"Senate Regulatory Affairs and Government Efficiency Committee Action (DP)",6,0,1,0,7
1924563,1519182,2025-03-17,Senate,"Senate Rules Committee Action (PFC)",0,0,0,0,0
1924563,1527483,2025-03-26,Senate,"Senate - Third Reading",15,12,2,0,29
1924563,1527484,2025-03-26,Senate,"Senate - Reconsider Third Reading",0,0,0,0,0
1924563,1527485,2025-03-26,Senate,"Senate - Third Reading",19,8,2,0,29
1924569,1479030,2025-02-03,House,"House Land, Agriculture & Rural Affairs Committee Action (DP)",5,2,0,2,9
1924569,1485598,2025-02-10,House,"House Rules Committee Action (C&P)",8,0,0,0,8
1924569,1491101,2025-02-17,House,"House - Third Reading",37,22,1,0,60
1924569,1504073,2025-03-03,Senate,"Senate Finance Committee Action (HELD)",0,0,0,0,0
1924569,1509589,2025-03-10,Senate,"Senate Finance Committee Action (DP)",7,0,0,0,7
1924569,1518916,2025-03-17,Senate,"Senate Rules Committee Action (PFC)",0,0,0,0,0
1924569,1555380,2025-04-23,Senate,"Senate - Committee of the Whole (DP)",0,0,0,0,0
1924569,1560543,2025-04-29,Senate,"Senate - Third Reading",25,3,2,0,30
1924616,1492995,2025-02-19,House,"House Government Committee Action (DPA)",4,2,1,0,7
1924616,1497271,2025-02-24,House,"House Rules Committee Action (C&P)",7,0,0,1,8
1924616,1498761,2025-02-25,House,"House - Committee of the Whole (DPA)",0,0,0,0,0
1924616,1507339,2025-03-06,House,"Motion Motion by Representative Carbone that pursuant to House Rule 12(P), HB2594 be calendared for an Additional Committee of the Whole for purposes of further amending. Motion passed v/v.",0,0,0,0,0
1924616,1507340,2025-03-06,House,"House - Committee of the Whole (DPA)",0,0,0,0,0
1924616,1509236,2025-03-10,House,"House - Third Reading",31,25,4,0,60
1924616,1528054,2025-03-26,Senate,"Senate Government Committee Action (DP)",4,3,0,0,7
1924652,1486464,2025-02-11,House,"House Natural Resources, Energy & Water Committee Action (DP)",9,0,0,1,10
1924652,1491143,2025-02-17,House,"House Rules Committee Action (C&P)",7,0,0,1,8
1924652,1495986,2025-02-20,House,"House - Third Reading",58,0,2,0,60
1924652,1515579,2025-03-11,Senate,"Senate Natural Resources Committee Action (DP)",8,0,0,0,8
1924652,1518593,2025-03-17,Senate,"Senate Rules Committee Action (PFC)",0,0,0,0,0
1924652,1556376,2025-04-23,Senate,"Senate - Committee of the Whole (DPA)",0,0,0,0,0
1924652,1560946,2025-04-29,Senate,"Senate - Third Reading",28,0,2,0,30
1924696,1476981,2025-01-29,House,"House Transportation & Infrastructure Committee Action (DISC/HELD)",0,0,0,0,0
1924696,1482972,2025-02-05,House,"House Transportation & Infrastructure Committee Action (HELD)",0,0,0,0,0
1924701,1491430,2025-02-17,House,"House Public Safety & Law Enforcement Committee Action (DP)",12,0,2,1,15
1924721,1497975,2025-02-24,House,"House Appropriations Committee Action (DPA)",16,1,0,1,18
1924721,1499918,2025-02-26,House,"House - Committee of the Whole (DPA)",0,0,0,0,0
1924721,1500903,2025-02-25,House,"House Rules Committee Action (C&P)",7,0,0,1,8
1924721,1501217,2025-02-27,House,"House - Third Reading",50,7,3,0,60
1924721,1516332,2025-03-12,Senate,"Senate Public Safety Committee Action (DP)",7,0,0,0,7
1924721,1520371,2025-03-18,Senate,"Senate Appropriations Committee Action (DP)",10,0,0,0,10
1924756,1487302,2025-02-12,House,"House Judiciary Committee Action (DP)",8,0,1,0,9
1924756,1490928,2025-02-17,House,"House Rules Committee Action (C&P)",7,0,0,1,8
1924756,1494793,2025-02-20,House,"House - Third Reading",43,15,2,0,60
1924756,1521216,2025-03-19,Senate,"Senate Judiciary and Elections Committee Action (W/D)",0,0,0,0,0
1924756,1527495,2025-03-26,Senate,"Senate Health and Human Services Committee Action (DP)",7,0,0,0,7
1924756,1532731,2025-04-01,Senate,"Senate Appropriations Committee Action (DP)",10,0,0,0,10
1924774,1491958,2025-02-18,House,"House Judiciary Committee Action (W/D)",0,0,0,0,0
1924779,1487248,2025-02-11,House,"House Natural Resources, Energy & Water Committee Action (DP)",8,1,0,1,10
1924785,1488098,2025-02-12,Senate,"Senate Judiciary and Elections Committee Action (DP)",5,1,1,0,7
1924785,1490870,2025-02-17,Senate,"Senate Rules Committee Action (PFC)",0,0,0,0,0
1924785,1501233,2025-02-27,Senate,"Senate - Third Reading",26,2,2,0,30
1924785,1516237,2025-03-12,House,"House Federalism, Military Affairs & Elections Committee Action (DP)",5,1,1,0,7
1924785,1518948,2025-03-17,House,"House Rules Committee Action (C&P)",8,0,0,0,8
1924785,1525060,2025-03-24,House,"House - Third Reading",41,16,3,0,60
1924813,1480635,2025-02-05,House,"House Judiciary Committee Action (DPA)",9,0,0,0,9
1924813,1484967,2025-02-10,House,"House Rules Committee Action (C&P)",8,0,0,0,8
1924813,1491295,2025-02-17,House,"House - Committee of the Whole (DPA)",0,0,0,0,0
1924813,1493484,2025-02-19,House,"House - Third Reading",59,0,1,0,60
1924813,1507029,2025-03-05,Senate,"Senate Judiciary and Elections Committee Action (DP)",6,1,0,0,7
1924813,1518768,2025-03-17,Senate,"Senate Rules Committee Action (PFC)",0,0,0,0,0
1924813,1543984,2025-04-10,Senate,"Senate - Committee of the Whole (DPA)",0,0,0,0,0
1924813,1548722,2025-04-15,Senate,"Senate - Third Reading",24,6,0,0,30
1924813,1560197,2025-04-29,House,"House - Concurrence",0,0,0,0,0
1924813,1560198,2025-04-29,House,"House - Third Reading",53,2,5,0,60
1924818,1486953,2025-02-11,House,"House Public Safety & Law Enforcement Committee Action (W/D)",0,0,0,0,0
1924818,1495722,2025-02-20,House,"House Government Committee Action (HELD)",0,0,0,0,0
1924840,1480637,2025-02-05,House,"House Judiciary Committee Action (DPA)",9,0,0,0,9
1924840,1484953,2025-02-10,House,"House Rules Committee Action (C&P)",8,0,0,0,8
1924840,1491235,2025-02-17,House,"House - Committee of the Whole (DPA)",0,0,0,0,0
1924840,1493853,2025-02-19,House,"House - Third Reading",59,0,1,0,60
1924840,1516260,2025-03-12,Senate,"Senate Judiciary and Elections Committee Action (DP)",7,0,0,0,7
1924840,1518838,2025-03-17,Senate,"Senate Rules Committee Action (PFC)",0,0,0,0,0
1924840,1566177,2025-05-06,Senate,"Senate - Third Reading",27,1,2,0,30
1924846,1482687,2025-02-05,Senate,"Senate Judiciary and Elections Committee Action (DP)",4,3,0,0,7
1924846,1485145,2025-02-10,Senate,"Senate Rules Committee Action (PFC)",0,0,0,0,0
1924846,1501188,2025-02-27,Senate,"Senate - Committee of the Whole (DP)",0,0,0,0,0
1924846,1503314,2025-03-03,Senate,"Senate - Third Reading",17,12,1,0,30
1924846,1522680,2025-03-20,House,"House Federalism, Military Affairs & Elections Committee Action (W/D)",0,0,0,0,0
1924846,1527567,2025-03-26,House,"House Judiciary Committee Action (HELD)",0,0,0,0,0
1924854,1475647,2025-01-28,House,"House Education Committee Action (DPA)",12,0,0,0,12
1924854,1478899,2025-02-03,House,"House Rules Committee Action (C&P)",5,3,0,0,8
1924854,1493300,2025-02-19,House,"House - Committee of the Whole (DPA)",0,0,0,0,0
1924854,1495009,2025-02-20,House,"House - Third Reading",37,21,2,0,60
1924854,1516279,2025-03-12,Senate,"Senate Education Committee Action (HELD)",0,0,0,0,0
1924854,1522628,2025-03-19,Senate,"Senate Education Committee Action (DPA)",5,2,0,0,7
1924854,1524692,2025-03-24,Senate,"Senate Rules Committee Action (PFC)",0,0,0,0,0
1924854,1545834,2025-03-19,Senate,"Senate Education-Archived and Renamed Education and Transportation as of 04/01/2025 Committee Action (DPA)",5,2,0,0,7
1924921,1482749,2025-02-05,House,"House Government Committee Action (DP)",4,3,0,0,7
1924921,1484944,2025-02-10,House,"House Rules Committee Action (C&P)",8,0,0,0,8
1924921,1494207,2025-02-19,House,"House - Committee of the Whole (DPA)",0,0,0,0,0
1924921,1495440,2025-02-20,House,"House - Third Reading",23,36,1,0,60
1924921,1495441,2025-02-20,House,"House - Reconsider Third Reading",0,0,0,0,0
1924921,1519322,2025-03-17,House,"Motion Motion by Representative Carbone that pursuant to House Rule 12(P), HB2542 be calendared for an Additional Committee of the Whole for purposes of further amending. Motion passed v/v.",0,0,0,0,0
1924921,1519323,2025-03-17,House,"House - Committee of the Whole (DPA)",0,0,0,0,0
1924921,1519734,2025-03-18,House,"House - Third Reading",32,26,2,0,60
1924921,1528049,2025-03-26,Senate,"Senate Government Committee Action (DP)",4,3,0,0,7
1924926,1487515,2025-02-12,House,"House Ways & Means Committee Action (DP)",5,4,0,0,9
1924926,1490919,2025-02-17,House,"House Rules Committee Action (C&P)",7,0,0,1,8
1924926,1495246,2025-02-20,House,"House - Third Reading",32,26,2,0,60
1924926,1509671,2025-03-10,Senate,"Senate Finance Committee Action (DP)",4,3,0,0,7
1924934,1491458,2025-02-17,House,"House Health & Human Services Committee Action (DP)",11,0,1,0,12
1924934,1498568,2025-02-25,House,"House Rules Committee Action (C&P)",7,0,0,1,8
1924934,1501374,2025-02-27,House,"House - Third Reading",56,1,3,0,60
1924934,1521058,2025-03-19,Senate,"Senate Health and Human Services Committee Action (DPA)",7,0,0,0,7
1924934,1526674,2025-03-25,Senate,"Senate Appropriations Committee Action (DP)",6,2,2,0,10
1924934,1531221,2025-03-31,Senate,"Senate Rules Committee Action (PFC)",0,0,0,0,0
1924934,1553780,2025-04-22,Senate,"Senate - Committee of the Whole (DPA)",0,0,0,0,0
1924955,1487336,2025-02-12,House,"House Judiciary Committee Action (DP)",8,0,0,1,9
1924955,1490896,2025-02-17,House,"House Rules Committee Action (C&P)",7,0,0,1,8
1924955,1494833,2025-02-20,House,"House - Third Reading",56,2,2,0,60
1924955,1516447,2025-03-12,Senate,"Senate Public Safety Committee Action (DP)",7,0,0,0,7
1924955,1518876,2025-03-17,Senate,"Senate Rules Committee Action (PFC)",0,0,0,0,0
1924955,1531334,2025-03-31,Senate,"Senate - Committee of the Whole (DPA)",0,0,0,0,0
1924955,1531848,2025-03-31,Senate,"Senate - Third Reading",27,1,2,0,30
1924955,1567178,2025-05-07,Senate,"Senate - Third Reading",26,0,4,0,30
1925009,1476244,2025-01-29,House,"House Judiciary Committee Action (DP)",5,4,0,0,9
1925009,1478851,2025-02-03,House,"House Rules Committee Action (C&P)",8,0,0,0,8
1925009,1499968,2025-02-26,House,"Motion 
Motion by Representative Carbone that pursuant to House Rule 12(P), HB2611 be calendared for an Additional Committee of the Whole for purposes of further amending. Motion passed v/v.",0,0,0,0,0
1925009,1499969,2025-02-26,House,"House - Committee of the Whole (DPA)",0,0,0,0,0
1925009,1503506,2025-03-03,House,"House - Third Reading",37,21,2,0,60
1925009,1528576,2025-03-26,Senate,"Senate Judiciary and Elections Committee Action (DP)",4,3,0,0,7
1925009,1531223,2025-03-31,Senate,"Senate Rules Committee Action (PFC)",0,0,0,0,0
1925009,1554068,2025-04-22,Senate,"Senate - Committee of the Whole (DPA)",0,0,0,0,0
1925009,1560913,2025-04-29,Senate,"Senate - Third Reading",18,10,2,0,30
1925009,1565714,2025-05-06,House,"House - Concurrence",0,0,0,0,0
1925009,1565715,2025-05-06,House,"House - Third Reading",35,19,6,0,60
1925024,1479171,2025-02-03,House,"House Land, Agriculture & Rural Affairs Committee Action (DP)",5,2,0,2,9
1925024,1484687,2025-02-10,House,"House Rules Committee Action (C&P)",8,0,0,0,8
1925024,1492746,2025-02-18,House,"House - Third Reading",56,4,0,0,60
1925024,1515228,2025-03-11,Senate,"Senate Natural Resources Committee Action (DP)",7,1,0,0,8
1925024,1518565,2025-03-17,Senate,"Senate Rules Committee Action (PFC)",0,0,0,0,0
1925024,1545722,2025-04-10,Senate,"Senate - Committee of the Whole (DP)",0,0,0,0,0
1925024,1549889,2025-04-16,Senate,"Senate - Third Reading",25,5,0,0,30
1925037,1479134,2025-02-03,Senate,"Senate Finance Committee Action (DP)",6,0,1,0,7
1925037,1485762,2025-02-10,Senate,"Senate Rules Committee Action (PFC)",0,0,0,0,0
1925037,1502257,2025-02-27,Senate,"Senate - Third Reading",25,3,2,0,30
1925037,1513874,2025-03-11,House,"House Commerce Committee Action (DP)",10,0,0,0,10
1925037,1524807,2025-03-24,House,"House Rules Committee Action (C&P)",8,0,0,0,8
1925037,1528727,2025-03-27,House,"House - Third Reading",42,15,3,0,60
1925054,1479737,2025-02-04,House,"House Commerce Committee Action (DP)",6,3,1,0,10
1925054,1485154,2025-02-10,House,"House Rules Committee Action (C&P)",8,0,0,0,8
1925054,1491897,2025-02-18,House,"House - Committee of the Whole (DP)",0,0,0,0,0
1925054,1495196,2025-02-20,House,"House - Third Reading",32,26,2,0,60
1925054,1519364,2025-03-17,Senate,"Senate Finance Committee Action (DP)",4,3,0,0,7
1925054,1539672,2025-04-08,Senate,"Senate Rules Committee Action (PFC)",0,0,0,0,0
1925054,1553822,2025-04-22,Senate,"Senate - Committee of the Whole (DP)",0,0,0,0,0
1925054,1560753,2025-04-29,Senate,"Senate - Third Reading",17,11,2,0,30
1925071,1475965,2025-01-28,House,"House Natural Resources, Energy & Water Committee Action (DP)",6,4,0,0,10
1925071,1478716,2025-02-03,House,"House Rules Committee Action (C&P)",8,0,0,0,8
1925071,1486588,2025-02-11,House,"House - Third Reading",32,26,2,0,60
1925071,1505588,2025-03-04,Senate,"Senate Natural Resources Committee Action (DP)",5,2,1,0,8
1925071,1518605,2025-03-17,Senate,"Senate Rules Committee Action (PFC)",0,0,0,0,0
1925071,1550964,2025-04-16,Senate,"Senate - Third Reading",17,12,1,0,30
1925077,1495776,2025-02-20,House,"House Government Committee Action (DPA)",4,0,3,0,7
1925077,1498551,2025-02-25,House,"House Rules Committee Action (C&P)",7,0,0,1,8
1925077,1509253,2025-03-10,House,"House - Committee of the Whole (DPA)",0,0,0,0,0
1925077,1516266,2025-03-12,House,"Motion Motion by Representative Carbone that pursuant to House Rule 12(P), HB2518 be calendared for an Additional Committee of the Whole for purposes of further amending. Motion passed v/v.",0,0,0,0,0
1925077,1516267,2025-03-12,House,"House - Committee of the Whole (DPA)",0,0,0,0,0
1925077,1517079,2025-03-13,House,"House - Third Reading",21,35,4,0,60
1925077,1517080,2025-03-13,House,"House - Reconsider Third Reading",0,0,0,0,0
1925077,1521098,2025-03-19,House,"Motion Motion by Representative Carbone that pursuant to House Rule 12(P), HB2518 be calendared for an Additional Committee of the Whole for purposes of further amending. Motion passed v/v.",0,0,0,0,0
1925077,1521099,2025-03-19,House,"House - Committee of the Whole (DPA)",0,0,0,0,0
1925077,1522705,2025-03-20,House,"House - Third Reading",51,2,7,0,60
1925077,1527674,2025-03-26,Senate,"Senate Government Committee Action (DP)",7,0,0,0,7
1925077,1531290,2025-03-31,Senate,"Senate Rules Committee Action (PFC)",0,0,0,0,0
1925077,1553570,2025-04-22,Senate,"Senate - Committee of the Whole (DP)",0,0,0,0,0
1925077,1560498,2025-04-29,Senate,"Senate - Third Reading",28,0,2,0,30
1925081,1480248,2025-02-04,House,"House Commerce Committee Action (DP)",10,0,0,0,10
1925081,1485625,2025-02-10,House,"House Rules Committee Action (C&P)",8,0,0,0,8
1925081,1489041,2025-02-13,House,"House - Third Reading",46,8,6,0,60
1925094,1475806,2025-01-28,House,"House Natural Resources, Energy & Water Committee Action (DISC/HELD)",0,0,0,0,0
1925116,1476454,2025-01-29,Senate,"Senate Public Safety Committee Action (HELD)",0,0,0,0,0
1925116,1494012,2025-02-19,Senate,"Senate Public Safety Committee Action (DPA/SE)",5,2,0,0,7
1925116,1496927,2025-02-20,Senate,"Senate Appropriations Committee Action (W/D)",0,0,0,0,0
1925116,1497583,2025-02-24,Senate,"Senate Rules Committee Action (PFC)",0,0,0,0,0
1925116,1518945,2025-03-17,Senate,"Senate - Committee of the Whole (DPA)",0,0,0,0,0
1925116,1518946,2025-03-17,Senate,"Senate - Third Reading",15,12,2,0,29
1925116,1518947,2025-03-17,Senate,"Senate - Reconsider Third Reading",15,10,4,0,29
1925116,1521376,2025-03-19,Senate,"Senate - Committee of the Whole (DPA)",0,0,0,0,0
1925116,1521377,2025-03-19,Senate,"Senate - Third Reading",11,16,2,0,29
1925122,1473459,2025-01-23,House,"House Health & Human Services Committee Action (W/D)",0,0,0,0,0
1925122,1494051,2025-02-19,House,"House Appropriations Committee Action (DPA)",11,6,1,0,18
1925122,1497338,2025-02-24,House,"House Rules Committee Action (C&P)",7,0,0,1,8
1925122,1498792,2025-02-25,House,"House - Committee of the Whole (DPA)",0,0,0,0,0
1925122,1500493,2025-02-26,House,"House - Third Reading",33,27,0,0,60
1925122,1520946,2025-03-19,Senate,"Senate Regulatory Affairs and Government Efficiency Committee Action (DP)",4,3,0,0,7
1925122,1524760,2025-03-24,Senate,"Senate Rules Committee Action (PFC)",0,0,0,0,0
1925122,1541576,2025-04-09,Senate,"Senate - Committee of the Whole (DPA)",0,0,0,0,0
1925122,1542303,2025-04-09,Senate,"Senate - Third Reading",17,13,0,0,30
1925122,1559193,2025-04-28,House,"House - Concurrence",0,0,0,0,0
1925122,1559194,2025-04-28,House,"House - Third Reading",32,23,5,0,60
1925168,1487699,2025-02-12,House,"House Judiciary Committee Action (DPA)",8,1,0,0,9
1925168,1494480,2025-02-19,House,"House Appropriations Committee Action (DPA)",18,0,0,0,18
1925168,1497432,2025-02-24,House,"House Rules Committee Action (C&P)",7,0,0,1,8
1925168,1498662,2025-02-25,House,"House - Committee of the Whole (DPA)",0,0,0,0,0
1925168,1500650,2025-02-26,House,"House - Third Reading",49,9,2,0,60
1925168,1521498,2025-03-19,Senate,"Senate Judiciary and Elections Committee Action (DP)",7,0,0,0,7
1925168,1526679,2025-03-25,Senate,"Senate Appropriations Committee Action (DP)",6,0,4,0,10
1925176,1476290,2025-01-29,House,"House Ways & Means Committee Action (DPA)",9,0,0,0,9
1925176,1478827,2025-02-03,House,"House Rules Committee Action (C&P)",8,0,0,0,8
1925176,1484807,2025-02-10,House,"House - Committee of the Whole (DPA)",0,0,0,0,0
1925176,1486530,2025-02-11,House,"House - Third Reading",35,23,2,0,60
1925176,1503475,2025-03-03,Senate,"Senate Finance Committee Action (DP)",4,3,0,0,7
1925176,1518827,2025-03-17,Senate,"Senate Rules Committee Action (PFC)",0,0,0,0,0
1925176,1544174,2025-04-10,Senate,"Senate - Third Reading",18,11,1,0,30
1925182,1482374,2025-02-05,House,"House Federalism, Military Affairs & Elections Committee Action (DPA)",4,3,0,0,7
1925182,1498563,2025-02-25,House,"House Rules Committee Action (C&P)",7,0,0,1,8
1925182,1499934,2025-02-26,House,"House - Committee of the Whole (DPA)",0,0,0,0,0
1925182,1503647,2025-03-03,House,"House - Third Reading",33,25,2,0,60
1925189,1485463,2025-02-10,House,"House Land, Agriculture & Rural Affairs Committee Action (DPA)",5,3,0,1,9
1925189,1491048,2025-02-17,House,"House Rules Committee Action (C&P)",7,0,0,1,8
1925189,1495446,2025-02-20,House,"House - Committee of the Whole (DPA)",0,0,0,0,0
1925189,1499056,2025-02-25,House,"House - Third Reading",20,40,0,0,60
1925210,1486905,2025-02-11,House,"House Natural Resources, Energy & Water Committee Action (DPA)",5,4,0,1,10
1925210,1491373,2025-02-17,House,"House Rules Committee Action (C&P)",7,0,0,1,8
1925210,1494753,2025-02-20,House,"House - Committee of the Whole (DPA)",0,0,0,0,0
1925210,1498795,2025-02-25,House,"House - Third Reading",33,26,1,0,60
1925210,1527630,2025-03-26,Senate,"Senate Government Committee Action (DP)",4,3,0,0,7
1925210,1531071,2025-03-31,Senate,"Senate Rules Committee Action (PFC)",0,0,0,0,0
1925210,1543940,2025-04-10,Senate,"Senate - Committee of the Whole (DP)",0,0,0,0,0
1925210,1549699,2025-04-16,Senate,"Senate - Third Reading",17,13,0,0,30
1925215,1486691,2025-02-11,House,"House Education Committee Action (DP)",12,0,0,0,12
1925215,1491661,2025-02-17,House,"House Rules Committee Action (C&P)",7,0,0,1,8
1925215,1495415,2025-02-20,House,"House - Third Reading",58,0,2,0,60
1925215,1516736,2025-03-12,Senate,"Senate Education Committee Action (DP)",5,2,0,0,7
1925215,1518573,2025-03-17,Senate,"Senate Rules Committee Action (PFC)",0,0,0,0,0
1925215,1544413,2025-04-10,Senate,"Senate - Third Reading",18,11,1,0,30
1925215,1545692,2025-03-12,Senate,"Senate Education-Archived and Renamed Education and Transportation as of 04/01/2025 Committee Action (DP)",5,2,0,0,7
1925228,1479288,2025-02-03,House,"House Land, Agriculture & Rural Affairs Committee Action (DP)",5,2,0,2,9
1925228,1497713,2025-02-24,House,"House Appropriations Committee Action (DPA)",11,4,3,0,18
1925228,1500567,2025-02-25,House,"House Rules Committee Action (C&P)",7,0,0,1,8
1925228,1500568,2025-02-26,House,"House - Committee of the Whole (RET ON CAL)",0,0,0,0,0
1925228,1503250,2025-03-03,House,"House - Committee of the Whole (DPA)",0,0,0,0,0
1925228,1506734,2025-03-05,House,"House - Third Reading",29,29,2,0,60
1925228,1506735,2025-03-05,House,"House - Reconsider Third Reading",0,0,0,0,0
1925228,1522077,2025-03-19,House,"House - Third Reading",34,23,3,0,60
1925228,1533212,2025-04-01,Senate,"Senate Appropriations Committee Action (DP)",7,3,0,0,10
1925239,1492938,2025-02-18,House,"House Education Committee Action (DP)",5,4,3,0,12
1925239,1497357,2025-02-24,House,"House Rules Committee Action (C&P)",7,0,0,1,8
1925239,1498672,2025-02-25,House,"House - Committee of the Whole (RET ON CAL)",0,0,0,0,0
1925239,1509121,2025-03-10,House,"House - Committee of the Whole (DPA)",0,0,0,0,0
1925239,1515074,2025-03-11,House,"House - Third Reading",19,38,3,0,60
1925244,1482893,2025-02-05,Senate,"Senate Natural Resources Committee Action (W/D)",0,0,0,0,0
1925244,1491653,2025-02-17,Senate,"Senate Federalism Committee Action (DPA)",4,2,1,0,7
1925244,1498015,2025-02-24,Senate,"Senate Rules Committee Action (PFC)",0,0,0,0,0
1925244,1504029,2025-03-03,Senate,"Senate - Committee of the Whole (DPA)",0,0,0,0,0
1925244,1507322,2025-03-06,Senate,"Senate - Third Reading",16,10,4,0,30
1925244,1525324,2025-03-24,House,"House Land, Agriculture & Rural Affairs Committee Action (FAILED)",3,3,2,1,9
1925244,1529542,2025-03-27,House,"House Land, Agriculture & Rural Affairs Committee Action (DP)",5,4,0,0,9
1925250,1492741,2025-02-18,House,"House Education Committee Action (DPA)",11,0,0,1,12
1925250,1499302,2025-02-25,House,"House Rules Committee Action (C&P)",7,0,0,1,8
1925250,1501763,2025-02-27,House,"House - Committee of the Whole (DPA)",0,0,0,0,0
1925270,1476860,2025-01-29,Senate,"Senate Public Safety Committee Action (HELD)",0,0,0,0,0
1925270,1482515,2025-02-05,Senate,"Senate Public Safety Committee Action (DP)",7,0,0,0,7
1925270,1486948,2025-02-11,Senate,"Senate Appropriations Committee Action (DP)",6,4,0,0,10
1925270,1490878,2025-02-17,Senate,"Senate Rules Committee Action (PFC)",0,0,0,0,0
1925270,1501169,2025-02-27,Senate,"Senate - Committee of the Whole (DPA)",0,0,0,0,0
1925270,1507166,2025-03-06,Senate,"Senate - Third Reading",16,11,3,0,30
1925270,1520777,2025-03-19,House,"House Government Committee Action (DP)",4,3,0,0,7
1925270,1531562,2025-03-31,House,"House Appropriations Committee Action (DP)",11,6,1,0,18
1925277,1488547,2025-02-12,House,"House Science & Technology Committee Action (DP)",9,0,0,0,9
1925277,1491190,2025-02-17,House,"House Rules Committee Action (C&P)",7,0,0,1,8
1925277,1495083,2025-02-20,House,"House - Committee of the Whole (DP)",0,0,0,0,0
1925277,1498183,2025-02-24,House,"House - Third Reading",41,18,1,0,60
1925277,1516738,2025-03-12,Senate,"Senate Education Committee Action (DPA)",7,0,0,0,7
1925277,1518977,2025-03-17,Senate,"Senate Rules Committee Action (PFC)",0,0,0,0,0
1925277,1525386,2025-03-24,Senate,"Senate - Committee of the Whole (DPA)",0,0,0,0,0
1925277,1525387,2025-03-24,Senate,"Senate - Third Reading",26,1,2,0,29
1925277,1545322,2025-04-10,House,"House - Concurrence",0,0,0,0,0
1925277,1545323,2025-04-10,House,"House - Third Reading",45,13,2,0,60
1925277,1545741,2025-03-12,Senate,"Senate Education-Archived and Renamed Education and Transportation as of 04/01/2025 Committee Action (DPA)",7,0,0,0,7
1925285,1487167,2025-02-11,House,"House Education Committee Action (DPA)",7,4,1,0,12
1925285,1491186,2025-02-17,House,"House Rules Committee Action (C&P)",7,0,0,1,8
1925285,1499031,2025-02-25,House,"House - Committee of the Whole (DPA)",0,0,0,0,0
1925285,1500152,2025-02-26,House,"House - Third Reading",33,27,0,0,60
1925285,1522875,2025-03-19,Senate,"Senate Education Committee Action (DP)",4,3,0,0,7
1925285,1524800,2025-03-24,Senate,"Senate Rules Committee Action (PFC)",5,4,0,0,9
1925285,1544567,2025-04-10,Senate,"Senate - Committee of the Whole (DP)",0,0,0,0,0
1925285,1545774,2025-03-19,Senate,"Senate Education-Archived and Renamed Education and Transportation as of 04/01/2025 Committee Action (DP)",4,3,0,0,7
1925285,1549945,2025-04-16,Senate,"Senate - Third Reading",17,13,0,0,30
1925302,1493005,2025-02-19,House,"House Judiciary Committee Action (DP)",6,0,3,0,9
1925302,1497242,2025-02-24,House,"House Rules Committee Action (C&P)",7,0,0,1,8
1925302,1500394,2025-02-26,House,"House - Committee of the Whole (DP)",0,0,0,0,0
1925302,1505017,2025-03-04,House,"House - Third Reading",32,26,2,0,60
1925302,1521695,2025-03-19,Senate,"Senate Judiciary and Elections Committee Action (DP)",4,3,0,0,7
1925302,1524708,2025-03-24,Senate,"Senate Rules Committee Action (PFC)",0,0,0,0,0
1925302,1550054,2025-04-16,Senate,"Senate - Third Reading",17,12,1,0,30
1925312,1492920,2025-02-18,House,"House Commerce Committee Action (HELD)",0,0,0,0,0
1925317,1489253,2025-02-13,House,"House Health & Human Services Committee Action (DP)",6,5,1,0,12
1925317,1497272,2025-02-24,House,"House Rules Committee Action (C&P)",7,0,0,1,8
1925317,1499952,2025-02-26,House,"House - Committee of the Whole (DP)",0,0,0,0,0
1925317,1503222,2025-03-03,House,"House - Third Reading",32,26,2,0,60
1925317,1520976,2025-03-19,Senate,"Senate Government Committee Action (DP)",4,3,0,0,7
1925317,1524762,2025-03-24,Senate,"Senate Rules Committee Action (PFC)",0,0,0,0,0
1925317,1553663,2025-04-22,Senate,"Senate - Committee of the Whole (DP)",0,0,0,0,0
1925317,1560602,2025-04-29,Senate,"Senate - Third Reading",17,11,2,0,30
1925322,1493649,2025-02-19,House,"House Government Committee Action (DP)",7,0,0,0,7
1925322,1497757,2025-02-24,House,"House Rules Committee Action (C&P)",7,0,0,1,8
1925322,1500934,2025-02-26,House,"House - Third Reading",42,16,2,0,60
1925329,1482291,2025-02-05,House,"House Federalism, Military Affairs & Elections Committee Action (DPA)",4,1,2,0,7
1925329,1485067,2025-02-10,House,"House Rules Committee Action (C&P)",8,0,0,0,8
1925329,1492377,2025-02-18,House,"House - Committee of the Whole (DPA)",0,0,0,0,0
1925329,1495144,2025-02-20,House,"House - Third Reading",39,19,2,0,60
1925329,1507009,2025-03-05,Senate,"Senate Judiciary and Elections Committee Action (HELD)",0,0,0,0,0
1925329,1516290,2025-03-12,Senate,"Senate Judiciary and Elections Committee Action (DPA)",4,3,0,0,7
1925329,1518821,2025-03-17,Senate,"Senate Rules Committee Action (PFC)",0,0,0,0,0
1925329,1544112,2025-04-10,Senate,"Senate - Committee of the Whole (DPA)",0,0,0,0,0
1925329,1548784,2025-04-15,Senate,"Senate - Third Reading",17,13,0,0,30
1925329,1565894,2025-05-06,House,"House - Concurrence",0,0,0,0,0
1925329,1565895,2025-05-06,Senate,"Motion Senator Shamp moved that the Senate request the House of Representatives return House Bill 2448, which was passed by the Senate and transmitted to the House of Representative on April 15, 2025 for the purpose of reconsideration. Motion carried.",0,0,0,0,0
1925329,1565896,2025-05-06,House,"Motion Motion by Representative Carbone to rescind its actions on May 6, 2025, whereby it concurred in the Senate amendments to HB2448 and that the House accede to the Senate request to return HB2448 for the purpose of reconsideration. Passed by vv.",0,0,0,0,0
1925336,1482601,2025-02-05,House,"House Federalism, Military Affairs & Elections Committee Action (DP)",4,0,3,0,7
1925336,1485040,2025-02-10,House,"House Rules Committee Action (C&P)",8,0,0,0,8
1925336,1495104,2025-02-20,House,"House - Third Reading",37,21,2,0,60
1925357,1482377,2025-02-05,Senate,"Senate Public Safety Committee Action (DP)",7,0,0,0,7
1925357,1485632,2025-02-10,Senate,"Senate Rules Committee Action (PFC)",0,0,0,0,0
1925357,1501797,2025-02-27,Senate,"Senate - Third Reading",26,2,2,0,30
1925357,1528138,2025-03-26,House,"House Transportation & Infrastructure Committee Action (DPA/SE)",5,1,0,1,7
1925357,1532436,2025-04-01,House,"House Rules Committee Action (C&P)",7,0,0,1,8
1925357,1535949,2025-04-03,House,"House - Committee of the Whole (DPA)",0,0,0,0,0
1925381,1486402,2025-02-11,House,"House Regulatory Oversight Committee Action (DP)",5,0,0,0,5
1925381,1490954,2025-02-17,House,"House Rules Committee Action (C&P)",7,0,0,1,8
1925381,1497499,2025-02-24,House,"House - Committee of the Whole (DP)",0,0,0,0,0
1925381,1499140,2025-02-25,House,"House - Third Reading",33,27,0,0,60
1925381,1527587,2025-03-26,Senate,"Senate Regulatory Affairs and Government Efficiency Committee Action (DP)",4,3,0,0,7
1925381,1531247,2025-03-31,Senate,"Senate Rules Committee Action (PFC)",0,0,0,0,0
1925381,1556971,2025-04-24,Senate,"Senate - Committee of the Whole (DP)",0,0,0,0,0
1925381,1560857,2025-04-29,Senate,"Senate - Third Reading",17,11,2,0,30
1925392,1475986,2025-01-28,House,"House Commerce Committee Action (DP)",10,0,0,0,10
1925392,1479135,2025-02-03,House,"House Rules Committee Action (C&P)",8,0,0,0,8
1925392,1488716,2025-02-13,House,"House - Third Reading",54,0,6,0,60
1925392,1527753,2025-03-26,Senate,"Senate Regulatory Affairs and Government Efficiency Committee Action (DPA)",6,1,0,0,7
1925392,1531328,2025-03-31,Senate,"Senate Rules Committee Action (PFC)",0,0,0,0,0
1925392,1544352,2025-04-10,Senate,"Senate - Committee of the Whole (DPA)",0,0,0,0,0
1925392,1549612,2025-04-16,Senate,"Senate - Third Reading",30,0,0,0,30
1925392,1560817,2025-04-29,House,"House - Concurrence",0,0,0,0,0
1925392,1560818,2025-04-29,House,"House - Third Reading",55,0,5,0,60
1925410,1488116,2025-02-12,Senate,"Senate Judiciary and Elections Committee Action (DP)",4,2,1,0,7
1925410,1491004,2025-02-17,Senate,"Senate Rules Committee Action (PFC)",0,0,0,0,0
1925410,1499204,2025-02-25,Senate,"Senate - Committee of the Whole (DP)",0,0,0,0,0
1925410,1499885,2025-02-26,Senate,"Senate - Third Reading",17,12,1,0,30
1925410,1525161,2025-03-24,House,"House Federalism, Military Affairs & Elections Committee Action (W/D)",0,0,0,0,0
1925441,1480560,2025-02-05,House,"House Judiciary Committee Action (DP)",9,0,0,0,9
1925441,1497302,2025-02-24,House,"House Rules Committee Action (C&P)",7,0,0,1,8
1925441,1499950,2025-02-26,House,"House - Committee of the Whole (DP)",0,0,0,0,0
1925441,1501457,2025-02-27,House,"House - Third Reading",55,2,3,0,60
1925456,1491445,2025-02-17,Senate,"Senate Federalism Committee Action (DPA)",4,2,1,0,7
1925456,1497527,2025-02-24,Senate,"Senate Rules Committee Action (PFC)",0,0,0,0,0
1925456,1503435,2025-03-03,Senate,"Senate - Committee of the Whole (DPA)",0,0,0,0,0
1925456,1506016,2025-03-05,Senate,"Senate - Third Reading",16,13,1,0,30
1925456,1525045,2025-03-24,House,"House Land, Agriculture & Rural Affairs Committee Action (DPA/SE)",6,3,0,0,9
1925456,1547264,2025-04-14,House,"House Rules Committee Action (C&P)",5,3,0,0,8
1925456,1549956,2025-04-16,House,"House - Committee of the Whole (DPA)",0,0,0,0,0
1925456,1555084,2025-04-23,House,"House - Third Reading",31,28,1,0,60
1925469,1485405,2025-02-10,House,"House Health & Human Services Committee Action (DP)",6,4,2,0,12
1925469,1518439,2025-03-17,House,"House Rules Committee Action (HELD)",0,0,0,0,0
1925497,1493844,2025-02-19,House,"House Health & Human Services Committee Action (W/D)",0,0,0,0,0
1925515,1491685,2025-02-17,House,"House Land, Agriculture & Rural Affairs Committee Action (DPA)",7,2,0,0,9
1925515,1504016,2025-03-03,House,"House Rules Committee Action (C&P)",8,0,0,0,8
1925515,1504850,2025-03-04,House,"House - Committee of the Whole (DPA)",0,0,0,0,0
1925515,1506799,2025-03-05,House,"House - Third Reading",49,9,2,0,60
1925515,1520487,2025-03-18,Senate,"Senate Natural Resources Committee Action (DPA)",6,0,2,0,8
1925515,1526839,2025-03-25,Senate,"Senate Appropriations Committee Action (DP)",8,0,2,0,10
1925529,1487593,2025-02-12,House,"House Ways & Means Committee Action (DP)",5,4,0,0,9
1925529,1490885,2025-02-17,House,"House Rules Committee Action (C&P)",7,0,0,1,8
1925529,1499092,2025-02-25,House,"House - Third Reading",45,15,0,0,60
1925529,1509743,2025-03-10,Senate,"Senate Finance Committee Action (DP)",4,3,0,0,7
1925529,1520393,2025-03-18,Senate,"Senate Appropriations Committee Action (DP)",6,4,0,0,10
1925544,1479331,2025-02-03,Senate,"Senate Military Affairs and Border Security Committee Action (DP)",7,0,0,0,7
1925544,1484884,2025-02-10,Senate,"Senate Rules Committee Action (PFC)",0,0,0,0,0
1925544,1502207,2025-02-27,Senate,"Senate - Third Reading",28,0,2,0,30
1925544,1519109,2025-03-17,House,"House Public Safety & Law Enforcement Committee Action (DP)",13,1,0,1,15
1925544,1524719,2025-03-24,House,"House Rules Committee Action (C&P)",8,0,0,0,8
1925544,1549041,2025-04-15,House,"House - Third Reading",51,1,8,0,60
1925550,1490232,2025-02-14,House,"House Natural Resources, Energy & Water Committee Action (DPA)",5,3,1,1,10
1925550,1497227,2025-02-24,House,"House Rules Committee Action (C&P)",7,0,0,1,8
1925550,1499446,2025-02-25,House,"House - Committee of the Whole (DPA)",0,0,0,0,0
1925550,1500664,2025-02-26,House,"House - Third Reading",33,27,0,0,60
1925550,1520518,2025-03-18,Senate,"Senate Natural Resources Committee Action (DP)",4,3,1,0,8
1925550,1525287,2025-03-24,Senate,"Senate Rules Committee Action (PFC)",0,0,0,0,0
1925550,1551152,2025-04-16,Senate,"Senate - Third Reading",16,13,1,0,30
1925580,1493018,2025-02-19,House,"House Government Committee Action (DP)",4,3,0,0,7
1925580,1497295,2025-02-24,House,"House Rules Committee Action (C&P)",4,3,0,1,8
1925580,1499945,2025-02-26,House,"House - Committee of the Whole (DP)",0,0,0,0,0
1925580,1503493,2025-03-03,House,"House - Third Reading",32,26,2,0,60
1925580,1521003,2025-03-19,Senate,"Senate Government Committee Action (DP)",4,3,0,0,7
1925587,1485372,2025-02-10,House,"House Public Safety & Law Enforcement Committee Action (DP)",13,1,1,0,15
1925593,1495724,2025-02-20,House,"House Natural Resources, Energy & Water Committee Action (DPA/SE)",4,3,0,3,10
1925593,1497383,2025-02-24,House,"House Rules Committee Action (C&P)",7,0,0,1,8
1925593,1498805,2025-02-25,House,"House - Committee of the Whole (DPA)",0,0,0,0,0
1925593,1500907,2025-02-26,House,"House - Third Reading",33,27,0,0,60
1925593,1527934,2025-03-25,Senate,"Senate Natural Resources Committee Action (DPA)",4,3,1,0,8
1925593,1531348,2025-03-31,Senate,"Senate Rules Committee Action (PFC)",0,0,0,0,0
1925593,1544234,2025-04-10,Senate,"Senate - Committee of the Whole (DPA)",0,0,0,0,0
1925593,1549775,2025-04-16,Senate,"Senate - Third Reading",16,14,0,0,30
1925593,1559238,2025-04-28,House,"House - Concurrence",0,0,0,0,0
1925593,1559239,2025-04-28,House,"House - Third Reading",32,23,5,0,60
1925599,1485554,2025-02-10,House,"House Land, Agriculture & Rural Affairs Committee Action (DPA)",5,2,0,2,9
1925599,1499310,2025-02-25,House,"House Rules Committee Action (C&P)",7,0,0,1,8
1925599,1500119,2025-02-26,House,"House - Committee of the Whole (DPA)",0,0,0,0,0
1925599,1504584,2025-03-04,House,"House - Third Reading",30,28,2,0,60
1925599,1505328,2025-03-04,House,"House - Reconsider Third Reading",0,0,0,0,0
1925604,1482495,2025-02-05,Senate,"Senate Public Safety Committee Action (DP)",7,0,0,0,7
1925604,1487246,2025-02-11,Senate,"Senate Appropriations Committee Action (DP)",6,3,1,0,10
1925604,1491157,2025-02-17,Senate,"Senate Rules Committee Action (PFC)",0,0,0,0,0
1925604,1501517,2025-02-27,Senate,"Senate - Third Reading",24,4,2,0,30
1925604,1516760,2025-03-12,House,"House Appropriations Committee Action (DP)",13,1,0,4,18
1925615,1475884,2025-01-28,House,"House Natural Resources, Energy & Water Committee Action (DP)",6,4,0,0,10
1925615,1479248,2025-02-03,House,"House Rules Committee Action (C&P)",8,0,0,0,8
1925615,1487133,2025-02-11,House,"House - Third Reading",35,23,2,0,60
1925615,1527950,2025-03-25,Senate,"Senate Natural Resources Committee Action (DPA)",4,3,1,0,8
1925615,1531370,2025-03-31,Senate,"Senate Rules Committee Action (PFC)",0,0,0,0,0
1925615,1556305,2025-04-23,Senate,"Senate - Committee of the Whole (DPA)",0,0,0,0,0
1925615,1560790,2025-04-29,Senate,"Senate - Third Reading",16,12,2,0,30
1925615,1565991,2025-05-06,House,"House - Concurrence",0,0,0,0,0
1925615,1565992,2025-05-06,House,"House - Third Reading",32,22,6,0,60
1925623,1480461,2025-02-04,House,"House Education Committee Action (DP)",6,4,0,2,12
1925623,1485128,2025-02-10,House,"House Rules Committee Action (C&P)",8,0,0,0,8
1925623,1493369,2025-02-19,House,"House - Committee of the Whole (DP)",0,0,0,0,0
1925623,1495032,2025-02-20,House,"House - Third Reading",33,25,2,0,60
1925623,1522677,2025-03-19,Senate,"Senate Education Committee Action (DPA)",7,0,0,0,7
1925623,1524789,2025-03-24,Senate,"Senate Rules Committee Action (PFC)",0,0,0,0,0
1925623,1545841,2025-03-19,Senate,"Senate Education-Archived and Renamed Education and Transportation as of 04/01/2025 Committee Action (DPA)",7,0,0,0,7
1925623,1553661,2025-04-22,Senate,"Senate - Committee of the Whole (DPA)",0,0,0,0,0
1925623,1561987,2025-04-30,Senate,"Senate - Committee of the Whole (DPA)",0,0,0,0,0
1925623,1566226,2025-05-06,Senate,"Senate - Third Reading",18,10,2,0,30
1925623,1567200,2025-05-07,House,"House - Concurrence",0,0,0,0,0
1925623,1567201,2025-05-07,House,"House - Third Reading",58,0,2,0,60
1925655,1487522,2025-02-12,House,"House Ways & Means Committee Action (DPA)",5,4,0,0,9
1925655,1490983,2025-02-17,House,"House Rules Committee Action (C&P)",7,0,0,1,8
1925655,1494769,2025-02-20,House,"House - Committee of the Whole (DPA)",0,0,0,0,0
1925698,1496130,2025-02-20,House,"House Government Committee Action (DPA)",4,3,0,0,7
1925698,1497490,2025-02-24,House,"House Rules Committee Action (C&P)",7,0,0,1,8
1925698,1499908,2025-02-26,House,"House - Committee of the Whole (DPA)",0,0,0,0,0
1925698,1516277,2025-03-12,House,"Motion Motion by Representative Carbone that pursuant to House Rule 12(P), HB2442 be calendared for an Additional Committee of the Whole for purposes of further amending. Motion passed v/v.",0,0,0,0,0
1925698,1516278,2025-03-12,House,"House - Committee of the Whole (DPA)",0,0,0,0,0
1925698,1519962,2025-03-18,House,"House - Third Reading",31,27,2,0,60
1925707,1480677,2025-02-05,House,"House Judiciary Committee Action (HELD)",0,0,0,0,0
1925713,1485759,2025-02-10,House,"House Public Safety & Law Enforcement Committee Action (DP)",9,6,0,0,15
1925713,1497682,2025-02-24,House,"House Appropriations Committee Action (DP)",12,6,0,0,18
1925713,1500710,2025-02-25,House,"House Rules Committee Action (C&P)",7,0,0,1,8
1925713,1503205,2025-03-03,House,"House - Committee of the Whole (DP)",0,0,0,0,0
1925713,1506200,2025-03-05,House,"House - Third Reading",33,25,2,0,60
1925713,1519157,2025-03-17,Senate,"Senate Military Affairs and Border Security Committee Action (DP)",4,2,1,0,7
1925713,1526692,2025-03-25,Senate,"Senate Appropriations Committee Action (DP)",5,2,3,0,10
1925719,1485475,2025-02-10,House,"House Health & Human Services Committee Action (W/D)",0,0,0,0,0
1925719,1493151,2025-02-19,House,"House Government Committee Action (DPA/SE)",6,0,1,0,7
1925719,1503509,2025-03-03,House,"House Judiciary Committee Action (W/D)",0,0,0,0,0
1925725,1489226,2025-02-13,House,"House Health & Human Services Committee Action (DPA)",10,2,0,0,12
1925725,1497341,2025-02-24,House,"House Rules Committee Action (C&P)",7,0,0,1,8
1925725,1498839,2025-02-25,House,"House - Committee of the Whole (DPA)",0,0,0,0,0
1925725,1500492,2025-02-26,House,"House - Third Reading",45,15,0,0,60
1925725,1521048,2025-03-19,Senate,"Senate Health and Human Services Committee Action (DP)",6,1,0,0,7
1925725,1524828,2025-03-24,Senate,"Senate Rules Committee Action (PFC)",0,0,0,0,0
1925725,1566409,2025-05-06,Senate,"Senate - Third Reading",23,5,2,0,30
1925739,1479167,2025-02-03,Senate,"Senate Finance Committee Action (DP)",6,0,1,0,7
1925739,1487242,2025-02-11,Senate,"Senate Appropriations Committee Action (DP)",9,0,1,0,10
1925739,1491629,2025-02-17,Senate,"Senate Rules Committee Action (PFC)",0,0,0,0,0
1925739,1501565,2025-02-27,Senate,"Senate - Third Reading",25,3,2,0,30
1925739,1527853,2025-03-26,House,"House Ways & Means Committee Action (DP)",7,0,0,2,9
1925744,1497811,2025-02-24,House,"House Appropriations Committee Action (DP)",12,0,5,1,18
1925744,1500352,2025-02-25,House,"House Rules Committee Action (C&P)",7,0,0,1,8
1925744,1505520,2025-03-04,House,"House - Third Reading",58,0,2,0,60
1925744,1521624,2025-03-19,Senate,"Senate Public Safety Committee Action (DP)",5,0,2,0,7
1925744,1532647,2025-04-01,Senate,"Senate Appropriations Committee Action (DPA/SE)",10,0,0,0,10
1925751,1487477,2025-02-12,House,"House Judiciary Committee Action (DPA)",6,3,0,0,9
1925751,1490970,2025-02-17,House,"House Rules Committee Action (C&P)",7,0,0,1,8
1925751,1498673,2025-02-25,House,"House - Committee of the Whole (DPA)",0,0,0,0,0
1925751,1500368,2025-02-26,House,"House - Third Reading",32,27,1,0,60
1925751,1528055,2025-03-26,Senate,"Senate Government Committee Action (DPA/SE)",4,3,0,0,7
1925756,1491605,2025-02-17,House,"House Health & Human Services Committee Action (DPA)",12,0,0,0,12
1925756,1497280,2025-02-24,House,"House Rules Committee Action (C&P)",7,0,0,1,8
1925756,1501419,2025-02-27,House,"House - Committee of the Whole (DPA)",0,0,0,0,0
1925756,1504739,2025-03-04,House,"House - Third Reading",58,0,2,0,60
1925756,1521139,2025-03-19,Senate,"Senate Health and Human Services Committee Action (DP)",7,0,0,0,7
1925756,1524744,2025-03-24,Senate,"Senate Rules Committee Action (PFC)",0,0,0,0,0
1925756,1543885,2025-04-10,Senate,"Senate - Third Reading",29,0,1,0,30
1925760,1487247,2025-02-11,House,"House Education Committee Action (DPA)",10,2,0,0,12
1925760,1497899,2025-02-24,House,"House Appropriations Committee Action (HELD)",0,0,0,0,0
1925766,1482320,2025-02-05,House,"House Federalism, Military Affairs & Elections Committee Action (DP)",4,3,0,0,7
1925766,1498552,2025-02-25,House,"House Rules Committee Action (C&P)",7,0,0,1,8
1925766,1499893,2025-02-26,House,"House - Committee of the Whole (DP)",0,0,0,0,0
1925766,1506024,2025-03-05,House,"House - Third Reading",33,24,3,0,60
1925766,1528583,2025-03-26,Senate,"Senate Judiciary and Elections Committee Action (DP)",4,3,0,0,7
1925766,1531228,2025-03-31,Senate,"Senate Rules Committee Action (PFC)",0,0,0,0,0
1925766,1554056,2025-04-22,Senate,"Senate - Committee of the Whole (DP)",0,0,0,0,0
1925766,1560493,2025-04-29,Senate,"Senate - Third Reading",17,11,2,0,30
1925771,1487540,2025-02-12,House,"House Ways & Means Committee Action (DISC/HELD)",0,0,0,0,0
1925771,1493491,2025-02-19,House,"House Ways & Means Committee Action (DPA)",5,4,0,0,9
1925771,1497250,2025-02-24,House,"House Rules Committee Action (C&P)",7,0,0,1,8
1925771,1498732,2025-02-25,House,"House - Committee of the Whole (DPA)",0,0,0,0,0
1925771,1500452,2025-02-26,House,"House - Third Reading",31,29,0,0,60
1925771,1509728,2025-03-10,Senate,"Senate Finance Committee Action (DPA)",4,3,0,0,7
1925771,1518828,2025-03-17,Senate,"Senate Rules Committee Action (PFC)",0,0,0,0,0
1925771,1554133,2025-04-22,Senate,"Senate - Committee of the Whole (DPA)",0,0,0,0,0
1925771,1560549,2025-04-29,Senate,"Senate - Third Reading",17,11,2,0,30
1925771,1566193,2025-05-06,House,"House - Concurrence",0,0,0,0,0
1925771,1566194,2025-05-06,House,"House - Third Reading",33,21,6,0,60
1925820,1492074,2025-02-18,House,"House Regulatory Oversight Committee Action (HELD)",0,0,0,0,0
1925848,1487298,2025-02-12,House,"House Judiciary Committee Action (DPA)",9,0,0,0,9
1925848,1490887,2025-02-17,House,"House Rules Committee Action (C&P)",7,0,0,1,8
1925848,1494754,2025-02-20,House,"House - Committee of the Whole (RET ON CAL)",0,0,0,0,0
1925848,1497506,2025-02-24,House,"House - Committee of the Whole (RET ON CAL)",0,0,0,0,0
1925848,1498644,2025-02-25,House,"House - Committee of the Whole (DPA)",0,0,0,0,0
1925848,1500736,2025-02-26,House,"House - Third Reading",56,1,3,0,60
1925932,1486405,2025-02-11,House,"House Regulatory Oversight Committee Action (DP)",3,2,0,0,5
1925932,1491151,2025-02-17,House,"House Rules Committee Action (C&P)",7,0,0,1,8
1925932,1495746,2025-02-20,House,"House - Committee of the Whole (DPA)",0,0,0,0,0
1925932,1499336,2025-02-25,House,"House - Third Reading",33,27,0,0,60
1926044,1493146,2025-02-19,House,"House Ways & Means Committee Action (DP)",9,0,0,0,9
1926044,1498054,2025-02-24,House,"House Rules Committee Action (C&P)",7,0,0,1,8
1926044,1500198,2025-02-26,House,"House - Committee of the Whole (DP)",0,0,0,0,0
1926044,1501368,2025-02-27,House,"House - Third Reading",57,0,3,0,60
1926044,1511921,2025-03-10,Senate,"Senate Finance Committee Action (DP)",6,1,0,0,7
1926072,1487312,2025-02-12,House,"House Judiciary Committee Action (DP)",9,0,0,0,9
1926072,1490990,2025-02-17,House,"House Rules Committee Action (C&P)",7,0,0,1,8
1926072,1494844,2025-02-20,House,"House - Committee of the Whole (RET ON CAL)",0,0,0,0,0
1926072,1498703,2025-02-25,House,"House - Committee of the Whole (DPA)",0,0,0,0,0
1926072,1500409,2025-02-26,House,"House - Third Reading",58,0,2,0,60
1926072,1516251,2025-03-12,Senate,"Senate Judiciary and Elections Committee Action (DP)",4,3,0,0,7
1926072,1518781,2025-03-17,Senate,"Senate Rules Committee Action (PFC)",0,0,0,0,0
1926072,1550194,2025-04-16,Senate,"Senate - Third Reading",22,7,1,0,30
1926100,1482398,2025-02-05,House,"House Federalism, Military Affairs & Elections Committee Action (HELD)",0,0,0,0,0
1926100,1488057,2025-02-12,House,"House Federalism, Military Affairs & Elections Committee Action (DP)",4,3,0,0,7
1926100,1491369,2025-02-17,House,"House Rules Committee Action (C&P)",7,0,0,1,8
1926100,1495225,2025-02-20,House,"House - Third Reading",33,26,1,0,60
1926128,1488129,2025-02-12,House,"House Judiciary Committee Action (DP)",9,0,0,0,9
1926128,1490933,2025-02-17,House,"House Rules Committee Action (C&P)",7,0,0,1,8
1926128,1494757,2025-02-20,House,"Motion Motion by Representative Carbone that pursuant to House Rule 12(P), HB2657 be calendared for an Additional Committee of the Whole for purposes of further amending. Motion passed v/v.",0,0,0,0,0
1926128,1494758,2025-02-20,House,"House - Committee of the Whole (DPA)",0,0,0,0,0
1926128,1501193,2025-02-27,House,"House - Third Reading",56,0,4,0,60
1926128,1521512,2025-03-19,Senate,"Senate Judiciary and Elections Committee Action (DP)",6,0,1,0,7
1926128,1524811,2025-03-24,Senate,"Senate Rules Committee Action (PFC)",0,0,0,0,0
1926128,1544184,2025-04-10,Senate,"Senate - Committee of the Whole (DP)",0,0,0,0,0
1926128,1549826,2025-04-16,Senate,"Senate - Third Reading",30,0,0,0,30
1926156,1486393,2025-02-11,House,"House Regulatory Oversight Committee Action (DP)",3,2,0,0,5
1926156,1490915,2025-02-17,House,"House Rules Committee Action (C&P)",5,2,0,1,8
1926156,1495251,2025-02-20,House,"House - Third Reading",32,26,2,0,60
1926184,1482309,2025-02-05,House,"House Federalism, Military Affairs & Elections Committee Action (HELD)",0,0,0,0,0
1926184,1488005,2025-02-12,House,"House Federalism, Military Affairs & Elections Committee Action (DP)",4,3,0,0,7
1926184,1491356,2025-02-17,House,"House Rules Committee Action (C&P)",7,0,0,1,8
1926184,1494709,2025-02-20,House,"House - Committee of the Whole (DP)",0,0,0,0,0
1926184,1499121,2025-02-25,House,"House - Third Reading",33,27,0,0,60
1926184,1516315,2025-03-12,Senate,"Senate Judiciary and Elections Committee Action (DP)",4,3,0,0,7
1926184,1518810,2025-03-17,Senate,"Senate Rules Committee Action (PFC)",0,0,0,0,0
1926184,1555351,2025-04-23,Senate,"Senate - Committee of the Whole (DP)",0,0,0,0,0
1926184,1560513,2025-04-29,Senate,"Senate - Third Reading",17,11,2,0,30
1926212,1479855,2025-02-04,House,"House Commerce Committee Action (DP)",7,3,0,0,10
1926212,1497306,2025-02-24,House,"House Rules Committee Action (C&P)",7,0,0,1,8
1926212,1506065,2025-03-05,House,"House - Committee of the Whole (DP)",0,0,0,0,0
1926212,1507391,2025-03-06,House,"House - Third Reading",23,31,6,0,60
1926212,1507392,2025-03-06,House,"House - Reconsider Third Reading",0,0,0,0,0
1926309,1493828,2025-02-19,House,"House Federalism, Military Affairs & Elections Committee Action (DP)",4,2,1,0,7
1926309,1497316,2025-02-24,House,"House Rules Committee Action (C&P)",7,0,0,1,8
1926309,1499736,2025-02-26,House,"House - Committee of the Whole (DP)",0,0,0,0,0
1926309,1503436,2025-03-03,House,"House - Third Reading",32,26,2,0,60
1926309,1521562,2025-03-19,Senate,"Senate Judiciary and Elections Committee Action (DP)",4,3,0,0,7
1926337,1480860,2025-02-05,House,"House Judiciary Committee Action (DPA)",6,3,0,0,9
1926337,1484820,2025-02-10,House,"House Rules Committee Action (C&P)",8,0,0,0,8
1926337,1491534,2025-02-17,House,"House - Committee of the Whole (DPA)",0,0,0,0,0
1926337,1494249,2025-02-19,House,"House - Third Reading",33,26,1,0,60
1926365,1492657,2025-02-18,House,"House Commerce Committee Action (DPA/SE)",9,0,0,1,10
1926365,1497313,2025-02-24,House,"House Rules Committee Action (C&P)",7,0,0,1,8
1926365,1498770,2025-02-25,House,"House - Committee of the Whole (DPA)",0,0,0,0,0
1926365,1500487,2025-02-26,House,"House - Third Reading",35,22,3,0,60
1926365,1525789,2025-03-24,Senate,"Senate Finance Committee Action (HELD)",0,0,0,0,0
1926393,1482337,2025-02-05,House,"House Federalism, Military Affairs & Elections Committee Action (HELD)",0,0,0,0,0
1926393,1488039,2025-02-12,House,"House Federalism, Military Affairs & Elections Committee Action (DP)",4,2,1,0,7
1926393,1490996,2025-02-17,House,"House Rules Committee Action (C&P)",7,0,0,1,8
1926393,1494796,2025-02-20,House,"House - Committee of the Whole (DP)",0,0,0,0,0
1926393,1499234,2025-02-25,House,"House - Third Reading",33,27,0,0,60
1926393,1516275,2025-03-12,Senate,"Senate Judiciary and Elections Committee Action (DP)",4,3,0,0,7
1926393,1518826,2025-03-17,Senate,"Senate Rules Committee Action (PFC)",0,0,0,0,0
1926393,1549899,2025-04-16,Senate,"Senate - Third Reading",17,12,1,0,30
1926449,1480060,2025-02-04,House,"House Regulatory Oversight Committee Action (HELD)",0,0,0,0,0
1926504,1479714,2025-02-04,House,"House Commerce Committee Action (DP)",10,0,0,0,10
1926504,1484983,2025-02-10,House,"House Rules Committee Action (C&P)",8,0,0,0,8
1931161,1480209,2025-02-04,House,"House Education Committee Action (DP)",6,4,0,2,12
1931161,1484966,2025-02-10,House,"House Rules Committee Action (C&P)",8,0,0,0,8
1931161,1493374,2025-02-19,House,"House - Committee of the Whole (DP)",0,0,0,0,0
1931161,1495037,2025-02-20,House,"House - Third Reading",33,26,1,0,60
1931161,1528082,2025-03-26,Senate,"Senate Education Committee Action (DP)",4,3,0,0,7
1931161,1531344,2025-03-31,Senate,"Senate Rules Committee Action (PFC)",0,0,0,0,0
1931161,1545632,2025-03-26,Senate,"Senate Education-Archived and Renamed Education and Transportation as of 04/01/2025 Committee Action (DP)",4,3,0,0,7
1931183,1479982,2025-02-04,House,"House Education Committee Action (DP)",6,4,0,2,12
1931183,1484893,2025-02-10,House,"House Rules Committee Action (C&P)",8,0,0,0,8
1931183,1493346,2025-02-19,House,"House - Committee of the Whole (DP)",0,0,0,0,0
1931183,1498969,2025-02-25,House,"House - Third Reading",33,27,0,0,60
1931183,1522722,2025-03-19,Senate,"Senate Education Committee Action (DP)",4,3,0,0,7
1931183,1524729,2025-03-24,Senate,"Senate Rules Committee Action (PFC)",0,0,0,0,0
1931183,1545891,2025-03-19,Senate,"Senate Education-Archived and Renamed Education and Transportation as of 04/01/2025 Committee Action (DP)",4,3,0,0,7
1931183,1550041,2025-04-16,Senate,"Senate - Third Reading",17,12,1,0,30
1931198,1495632,2025-02-20,Senate,"Senate Regulatory Affairs and Government Efficiency Committee Action (DPA/SE)",6,0,1,0,7
1931198,1497589,2025-02-24,Senate,"Senate Rules Committee Action (PFC)",0,0,0,0,0
1931198,1500362,2025-02-26,Senate,"Senate - Committee of the Whole (DPA)",0,0,0,0,0
1931198,1501705,2025-02-27,Senate,"Senate - Third Reading",24,5,1,0,30
1931198,1526717,2025-03-25,House,"House Commerce Committee Action (DP)",10,0,0,0,10
1931198,1532450,2025-04-01,House,"House Rules Committee Action (C&P)",7,0,0,1,8
1931198,1547168,2025-04-14,House,"House - Committee of the Whole (DP)",0,0,0,0,0
1931198,1564949,2025-05-05,House,"Motion Motion by Representative Way that pursuant to House Rule 12(P), SB1182 be calendared for an Additional Committee of the Whole for purposes of further amending. Motion passed v/v.",0,0,0,0,0
1931198,1564950,2025-05-05,House,"House - Committee of the Whole (DPA)",0,0,0,0,0
1931198,1567143,2025-05-07,House,"House - Third Reading",51,7,2,0,60
1931198,1567588,2025-05-07,Senate,"Senate - Concurrence",0,0,0,0,0
1931198,1567589,2025-05-07,Senate,"Senate - Third Reading",23,3,4,0,30
1931259,1494583,2025-02-19,Senate,"Senate Judiciary and Elections Committee Action (DPA/SE)",6,1,0,0,7
1931259,1497509,2025-02-24,Senate,"Senate Rules Committee Action (PFC)",0,0,0,0,0
1931259,1518524,2025-03-17,Senate,"Senate - Committee of the Whole (DPA)",0,0,0,0,0
1931259,1519031,2025-03-17,Senate,"Senate - Third Reading",15,12,2,0,29
1931259,1519032,2025-03-17,Senate,"Senate - Reconsider Third Reading",15,10,4,0,29
1931259,1521381,2025-03-19,Senate,"Senate - Third Reading",18,9,2,0,29
1931259,1531577,2025-03-31,House,"House Appropriations Committee Action (DPA)",11,5,2,0,18
1931259,1547268,2025-04-14,House,"House Rules Committee Action (C&P)",8,0,0,0,8
1931259,1553347,2025-04-22,House,"House - Committee of the Whole (RET ON CAL)",0,0,0,0,0
1931259,1559756,2025-04-29,House,"House - Committee of the Whole (RET ON CAL)",0,0,0,0,0
1931259,1563755,2025-05-01,House,"House - Committee of the Whole (DPA)",0,0,0,0,0
1931259,1567030,2025-05-07,House,"Motion Motion by Representative Carbone that pursuant to House Rule 12(P), SB1198 be calendared for an Additional Committee of the Whole for purposes of further amending. Motion passed v/v.",0,0,0,0,0
1931259,1567031,2025-05-07,House,"House - Committee of the Whole (DPA)",0,0,0,0,0
1931390,1482356,2025-02-05,Senate,"Senate Judiciary and Elections Committee Action (DP)",4,3,0,0,7
1931390,1485103,2025-02-10,Senate,"Senate Rules Committee Action (PFC)",0,0,0,0,0
1931404,1493286,2025-02-19,House,"House Government Committee Action (FAILED)",2,5,0,0,7
1931425,1485802,2025-02-10,House,"House Public Safety & Law Enforcement Committee Action (DP)",15,0,0,0,15
1931480,1493882,2025-02-19,House,"House Federalism, Military Affairs & Elections Committee Action (DP)",7,0,0,0,7
1931480,1497340,2025-02-24,House,"House Rules Committee Action (C&P)",7,0,0,1,8
1931480,1499756,2025-02-26,House,"House - Committee of the Whole (DP)",0,0,0,0,0
1931480,1503512,2025-03-03,House,"House - Third Reading",57,0,3,0,60
1931480,1521634,2025-03-19,Senate,"Senate Judiciary and Elections Committee Action (DP)",5,2,0,0,7
1931480,1524739,2025-03-24,Senate,"Senate Rules Committee Action (PFC)",0,0,0,0,0
1931480,1543639,2025-04-10,Senate,"Senate - Committee of the Whole (DP)",0,0,0,0,0
1931480,1551122,2025-04-17,Senate,"Senate - Committee of the Whole (DPA)",0,0,0,0,0
1931480,1561919,2025-04-30,Senate,"Senate - Third Reading",23,4,3,0,30
1931480,1565996,2025-05-06,House,"House - Concurrence",0,0,0,0,0
1931480,1565997,2025-05-06,House,"House - Third Reading",52,3,5,0,60
1931514,1493653,2025-02-19,Senate,"Senate Government Committee Action (HELD)",0,0,0,0,0
1931514,1496835,2025-02-20,Senate,"Senate Government Committee Action (FAILED)",3,3,1,0,7
1931590,1493959,2025-02-19,House,"House Federalism, Military Affairs & Elections Committee Action (DP)",7,0,0,0,7
1931590,1497245,2025-02-24,House,"House Rules Committee Action (C&P)",7,0,0,1,8
1931590,1499932,2025-02-26,House,"House - Committee of the Whole (DP)",0,0,0,0,0
1931590,1501367,2025-02-27,House,"House - Third Reading",57,0,3,0,60
1931590,1516261,2025-03-12,Senate,"Senate Judiciary and Elections Committee Action (DP)",7,0,0,0,7
1931590,1518913,2025-03-17,Senate,"Senate Rules Committee Action (PFC)",0,0,0,0,0
1931590,1525096,2025-03-24,Senate,"Senate - Third Reading",27,0,2,0,29
1931604,1491718,2025-02-17,Senate,"Senate Finance Committee Action (DPA)",5,2,0,0,7
1931604,1497525,2025-02-24,Senate,"Senate Rules Committee Action (PFC)",0,0,0,0,0
1931604,1500298,2025-02-26,Senate,"Senate - Committee of the Whole (DPA)",0,0,0,0,0
1931604,1501672,2025-02-27,Senate,"Senate - Third Reading",17,12,1,0,30
1931632,1487305,2025-02-12,House,"House Government Committee Action (DPA)",4,3,0,0,7
1931632,1491002,2025-02-17,House,"House Rules Committee Action (C&P)",7,0,0,1,8
1931632,1498648,2025-02-25,House,"House - Committee of the Whole (DPA)",0,0,0,0,0
1931632,1500281,2025-02-26,House,"House - Third Reading",33,27,0,0,60
1931632,1528625,2025-03-26,Senate,"Senate Judiciary and Elections Committee Action (DP)",4,3,0,0,7
1931632,1531227,2025-03-31,Senate,"Senate Rules Committee Action (PFC)",0,0,0,0,0
1931632,1555560,2025-04-23,Senate,"Senate - Committee of the Whole (DPA)",0,0,0,0,0
1931632,1562174,2025-04-30,Senate,"Senate - Third Reading",27,0,3,0,30
1931632,1565589,2025-05-06,House,"House - Concurrence",0,0,0,0,0
1931632,1565590,2025-05-06,House,"House - Third Reading",35,19,6,0,60
1931656,1491713,2025-02-17,Senate,"Senate Military Affairs and Border Security Committee Action (DPA)",4,3,0,0,7
1931656,1494683,2025-02-18,Senate,"Senate Appropriations Committee Action (W/D)",0,0,0,0,0
1931656,1497605,2025-02-24,Senate,"Senate Rules Committee Action (PFC)",4,3,0,0,7
1931656,1500396,2025-02-26,Senate,"Senate - Committee of the Whole (DPA)",0,0,0,0,0
1931656,1501761,2025-02-27,Senate,"Senate - Third Reading",17,12,1,0,30
1931656,1527667,2025-03-26,House,"House Government Committee Action (DP)",4,3,0,0,7
1931656,1531206,2025-03-31,House,"House Rules Committee Action (C&P)",7,0,0,1,8
1931656,1538677,2025-04-07,House,"House - Committee of the Whole (DP)",0,0,0,0,0
1931656,1544215,2025-04-10,House,"House - Third Reading",33,26,1,0,60
1931695,1492761,2025-02-18,House,"House Public Safety & Law Enforcement Committee Action (W/D)",0,0,0,0,0
1931695,1495996,2025-02-19,House,"House Science & Technology Committee Action (HELD)",0,0,0,0,0
1931829,1485305,2025-02-10,Senate,"Senate Finance Committee Action (DPA/SE)",7,0,0,0,7
1931829,1490925,2025-02-17,Senate,"Senate Rules Committee Action (PFC)",0,0,0,0,0
1931829,1499120,2025-02-25,Senate,"Senate - Committee of the Whole (DPA)",0,0,0,0,0
1931829,1499852,2025-02-26,Senate,"Senate - Third Reading",29,0,1,0,30
1931829,1514027,2025-03-11,House,"House Commerce Committee Action (DP)",8,2,0,0,10
1931829,1532460,2025-04-01,House,"House Rules Committee Action (C&P)",7,0,0,1,8
1931829,1541832,2025-04-09,House,"House - Committee of the Whole (DP)",0,0,0,0,0
1931829,1548848,2025-04-15,House,"House - Third Reading",52,0,8,0,60
1931944,1493013,2025-02-19,House,"House Ways & Means Committee Action (DP)",8,0,1,0,9
1931944,1497323,2025-02-24,House,"House Rules Committee Action (C&P)",7,0,0,1,8
1931944,1500515,2025-02-26,House,"House - Third Reading",55,2,3,0,60
1931944,1519495,2025-03-17,Senate,"Senate Finance Committee Action (DP)",5,2,0,0,7
1932173,1480190,2025-02-04,Senate,"Senate Appropriations Committee Action (DP)",9,0,1,0,10
1932173,1484977,2025-02-10,Senate,"Senate Rules Committee Action (PFC)",0,0,0,0,0
1932173,1501601,2025-02-27,Senate,"Senate - Third Reading",25,4,1,0,30
1932173,1518562,2025-03-17,House,"House Health & Human Services Committee Action (DP)",12,0,0,0,12
1932173,1521770,2025-03-19,House,"House Appropriations Committee Action (DPA)",15,2,0,1,18
1932287,1486795,2025-02-11,Senate,"Senate Natural Resources Committee Action (DP)",5,3,0,0,8
1932287,1490952,2025-02-17,Senate,"Senate Rules Committee Action (PFC)",0,0,0,0,0
1932287,1509179,2025-03-10,Senate,"Senate - Committee of the Whole (DPA)",0,0,0,0,0
1932287,1517020,2025-03-13,Senate,"Senate - Third Reading",16,12,2,0,30
1932287,1525189,2025-03-24,House,"House Land, Agriculture & Rural Affairs Committee Action (DP)",5,3,1,0,9
1932287,1531350,2025-03-31,House,"House Rules Committee Action (C&P)",7,0,0,1,8
1932287,1534350,2025-04-02,House,"House - Committee of the Whole (RET ON CAL)",0,0,0,0,0
1932405,1476242,2025-01-29,Senate,"Senate Health and Human Services Committee Action (DP)",7,0,0,0,7
1932405,1480108,2025-02-04,Senate,"Senate Appropriations Committee Action (DP)",9,0,1,0,10
1932405,1485045,2025-02-10,Senate,"Senate Rules Committee Action (PFC)",0,0,0,0,0
1932405,1501586,2025-02-27,Senate,"Senate - Third Reading",25,3,2,0,30
1932405,1518600,2025-03-17,House,"House Health & Human Services Committee Action (DP)",12,0,0,0,12
1932405,1528118,2025-03-26,House,"House Appropriations Committee Action (DP)",15,0,0,3,18
1932518,1482193,2025-02-05,Senate,"Senate Education Committee Action (HELD)",0,0,0,0,0
1932518,1488253,2025-02-12,Senate,"Senate Education Committee Action (DPA/SE)",6,0,1,0,7
1932518,1495884,2025-02-20,Senate,"Senate Appropriations Committee Action (W/D)",0,0,0,0,0
1932518,1497648,2025-02-24,Senate,"Senate Rules Committee Action (PFC)",0,0,0,0,0
1932518,1500660,2025-02-26,Senate,"Senate - Committee of the Whole (DPA)",0,0,0,0,0
1932518,1501721,2025-02-27,Senate,"Senate - Third Reading",29,0,1,0,30
1932518,1545920,2025-02-12,Senate,"Senate Education-Archived and Renamed Education and Transportation as of 04/01/2025 Committee Action (DPA/SE)",6,0,1,0,7
1932633,1482264,2025-02-05,Senate,"Senate Public Safety Committee Action (DP)",7,0,0,0,7
1932633,1484924,2025-02-10,Senate,"Senate Rules Committee Action (PFC)",0,0,0,0,0
1932633,1499583,2025-02-25,Senate,"Senate - Committee of the Whole (DPA)",0,0,0,0,0
1932633,1499819,2025-02-26,Senate,"Senate - Third Reading",16,13,1,0,30
1932633,1528143,2025-03-26,House,"House Transportation & Infrastructure Committee Action (DPA/SE)",4,2,0,1,7
1932749,1482378,2025-02-05,Senate,"Senate Regulatory Affairs and Government Efficiency Committee Action (DPA)",5,2,0,0,7
1932749,1484928,2025-02-10,Senate,"Senate Rules Committee Action (PFC)",0,0,0,0,0
1932749,1498937,2025-02-25,Senate,"Senate - Committee of the Whole (RETAINED)",0,0,0,0,0
1932749,1501528,2025-02-27,Senate,"Senate - Committee of the Whole (DPA)",0,0,0,0,0
1932749,1503700,2025-03-03,Senate,"Senate - Third Reading",22,7,1,0,30
1932749,1519051,2025-03-17,House,"House Health & Human Services Committee Action (DP)",7,5,0,0,12
1932749,1524852,2025-03-24,House,"House Rules Committee Action (C&P)",8,0,0,0,8
1932749,1548598,2025-04-15,House,"House - Committee of the Whole (DP)",0,0,0,0,0
1932863,1480432,2025-02-04,Senate,"Senate Appropriations Committee Action (DP)",8,1,1,0,10
1932863,1484969,2025-02-10,Senate,"Senate Rules Committee Action (PFC)",0,0,0,0,0
1932863,1502173,2025-02-27,Senate,"Senate - Third Reading",26,3,1,0,30
1932863,1512423,2025-03-10,House,"House Land, Agriculture & Rural Affairs Committee Action (DP)",5,3,0,1,9
1932863,1547887,2025-04-14,House,"House Rules Committee Action (C&P)",8,0,0,0,8
1932977,1476562,2025-01-29,House,"House Federalism, Military Affairs & Elections Committee Action (DPA)",4,3,0,0,7
1932977,1478845,2025-02-03,House,"House Rules Committee Action (C&P)",8,0,0,0,8
1932977,1493795,2025-02-19,House,"House - Committee of the Whole (DPA)",0,0,0,0,0
1932977,1499246,2025-02-25,House,"House - Third Reading",33,27,0,0,60
1934070,1491324,2025-02-17,House,"House Land, Agriculture & Rural Affairs Committee Action (DP)",8,0,0,1,9
1934070,1497414,2025-02-24,House,"House Rules Committee Action (C&P)",7,0,0,1,8
1934070,1500895,2025-02-26,House,"House - Third Reading",47,9,4,0,60
1934070,1514865,2025-03-11,Senate,"Senate Natural Resources Committee Action (HELD)",0,0,0,0,0
1934305,1477268,2025-01-30,Senate,"Senate Judiciary and Elections Committee Action (W/D)",0,0,0,0,0
1934305,1495510,2025-02-20,Senate,"Senate Regulatory Affairs and Government Efficiency Committee Action (DPA)",4,2,1,0,7
1934305,1497531,2025-02-24,Senate,"Senate Rules Committee Action (PFC)",0,0,0,0,0
1934305,1509238,2025-03-10,Senate,"Senate - Committee of the Whole (DPA)",0,0,0,0,0
1934305,1517076,2025-03-13,Senate,"Senate - Third Reading",27,1,2,0,30
1934305,1527543,2025-03-26,House,"House Judiciary Committee Action (DPA)",8,0,0,1,9
1934605,1479085,2025-02-03,Senate,"Senate Finance Committee Action (DP)",6,0,1,0,7
1934605,1485169,2025-02-10,Senate,"Senate Rules Committee Action (PFC)",0,0,0,0,0
1934678,1482262,2025-02-05,Senate,"Senate Public Safety Committee Action (DP)",7,0,0,0,7
1934678,1485009,2025-02-10,Senate,"Senate Rules Committee Action (PFC)",0,0,0,0,0
1934678,1501588,2025-02-27,Senate,"Senate - Third Reading",29,0,1,0,30
1934678,1520898,2025-03-19,House,"House Government Committee Action (DP)",6,0,0,1,7
1934678,1524812,2025-03-24,House,"House Rules Committee Action (C&P)",8,0,0,0,8
1934678,1547240,2025-04-14,House,"House - Third Reading",54,2,4,0,60
1934749,1486586,2025-02-11,House,"House Education Committee Action (DP)",12,0,0,0,12
1934749,1498556,2025-02-25,House,"House Rules Committee Action (C&P)",7,0,0,1,8
1934749,1503377,2025-03-03,House,"House - Third Reading",54,4,2,0,60
1934749,1527962,2025-03-26,Senate,"Senate Education Committee Action (DPA)",6,0,1,0,7
1934749,1532632,2025-04-01,Senate,"Senate Appropriations Committee Action (DP)",8,0,2,0,10
1934749,1545552,2025-03-26,Senate,"Senate Education-Archived and Renamed Education and Transportation as of 04/01/2025 Committee Action (DPA)",6,0,1,0,7
1934823,1487520,2025-02-12,Senate,"Senate Health and Human Services Committee Action (DPA)",6,0,1,0,7
1934823,1490853,2025-02-17,Senate,"Senate Rules Committee Action (PFC)",0,0,0,0,0
1934823,1504374,2025-03-04,Senate,"Senate - Committee of the Whole (DPA)",0,0,0,0,0
1934823,1507183,2025-03-06,Senate,"Senate - Third Reading",27,0,3,0,30
1934823,1519101,2025-03-17,House,"House Health & Human Services Committee Action (DPA)",11,0,0,1,12
1934823,1524874,2025-03-24,House,"House Rules Committee Action (C&P)",8,0,0,0,8
1934823,1528797,2025-03-27,House,"House - Committee of the Whole (DPA)",0,0,0,0,0
1934823,1543939,2025-04-10,House,"House - Third Reading",58,0,2,0,60
1934823,1548718,2025-04-15,Senate,"Senate - Concurrence",0,0,0,0,0
1934823,1548719,2025-04-15,Senate,"Senate - Third Reading",30,0,0,0,30
1934969,1485156,2025-02-10,Senate,"Senate Federalism Committee Action (DPA)",7,0,0,0,7
1934969,1491627,2025-02-17,Senate,"Senate Rules Committee Action (PFC)",0,0,0,0,0
1934969,1499337,2025-02-25,Senate,"Senate - Committee of the Whole (DPA)",0,0,0,0,0
1934969,1500636,2025-02-26,Senate,"Senate - Third Reading",29,0,1,0,30
1934969,1516729,2025-03-12,House,"House Federalism, Military Affairs & Elections Committee Action (DP)",7,0,0,0,7
1934969,1519170,2025-03-17,House,"House Rules Committee Action (C&P)",8,0,0,0,8
1934969,1522097,2025-03-19,House,"House - Third Reading",57,0,3,0,60
1935042,1487702,2025-02-12,House,"House Judiciary Committee Action (DPA)",6,3,0,0,9
1935042,1490638,2025-02-12,House,"House Judiciary Committee Action (DP)",6,3,0,0,9
1935042,1491077,2025-02-17,House,"House Rules Committee Action (C&P)",7,0,0,1,8
1935042,1494840,2025-02-20,House,"House - Third Reading",41,17,2,0,60
1935042,1507472,2025-03-05,Senate,"Senate Judiciary and Elections Committee Action (DP)",7,0,0,0,7
1935042,1518783,2025-03-17,Senate,"Senate Rules Committee Action (PFC)",0,0,0,0,0
1935042,1531331,2025-03-31,Senate,"Senate - Committee of the Whole (DPA)",0,0,0,0,0
1935042,1561961,2025-04-30,Senate,"Senate - Committee of the Whole (DPA)",0,0,0,0,0
1935042,1561962,2025-04-30,Senate,"Senate - Third Reading",26,0,4,0,30
1935042,1565492,2025-05-06,House,"House - Concurrence",0,0,0,0,0
1935042,1565985,2025-05-06,House,"House - Third Reading",44,11,5,0,60
1935114,1480710,2025-02-05,Senate,"Senate Government Committee Action (DPA)",4,3,0,0,7
1935114,1485038,2025-02-10,Senate,"Senate Rules Committee Action (PFC)",0,0,0,0,0
1935114,1495168,2025-02-20,Senate,"Senate - Committee of the Whole (DPA)",0,0,0,0,0
1935114,1495169,2025-02-20,Senate,"Senate - Third Reading",17,12,1,0,30
1935114,1520989,2025-03-19,House,"House Ways & Means Committee Action (DP)",5,4,0,0,9
1935256,1488101,2025-02-12,Senate,"Senate Judiciary and Elections Committee Action (HELD)",0,0,0,0,0
1935324,1479204,2025-02-03,Senate,"Senate Finance Committee Action (DP)",6,0,1,0,7
1935324,1484914,2025-02-10,Senate,"Senate Rules Committee Action (PFC)",0,0,0,0,0
1935324,1499073,2025-02-25,Senate,"Senate - Committee of the Whole (DP)",0,0,0,0,0
1935324,1499832,2025-02-26,Senate,"Senate - Third Reading",24,5,1,0,30
1935324,1521801,2025-03-19,House,"House Ways & Means Committee Action (DP)",5,2,2,0,9
1935324,1524881,2025-03-24,House,"House Rules Committee Action (C&P)",8,0,0,0,8
1935324,1531458,2025-03-31,House,"House - Committee of the Whole (DP)",0,0,0,0,0
1935324,1564398,2025-05-01,House,"House - Third Reading",40,18,2,0,60
1935365,1488040,2025-02-12,Senate,"Senate Education Committee Action (DP)",5,2,0,0,7
1935365,1492805,2025-02-18,Senate,"Senate Appropriations Committee Action (DP)",6,2,2,0,10
1935365,1497856,2025-02-24,Senate,"Senate Rules Committee Action (PFC)",0,0,0,0,0
1935365,1500180,2025-02-26,Senate,"Senate - Committee of the Whole (DP)",0,0,0,0,0
1935365,1501614,2025-02-27,Senate,"Senate - Third Reading",18,11,1,0,30
1935365,1521545,2025-03-19,House,"House Education Committee Action (W/D)",0,0,0,0,0
1935365,1526661,2025-03-25,House,"House Public Safety & Law Enforcement Committee Action (W/D)",0,0,0,0,0
1935365,1531643,2025-03-31,House,"House Appropriations Committee Action (DPA/SE)",15,3,0,0,18
1935365,1545549,2025-02-12,Senate,"Senate Education-Archived and Renamed Education and Transportation as of 04/01/2025 Committee Action (DP)",5,2,0,0,7
1935365,1547310,2025-04-14,House,"House Rules Committee Action (C&P)",8,0,0,0,8
1935365,1553348,2025-04-22,House,"House - Committee of the Whole (DPA)",0,0,0,0,0
1935397,1495661,2025-02-19,Senate,"Senate Judiciary and Elections Committee Action (DP)",7,0,0,0,7
1935397,1498049,2025-02-24,Senate,"Senate Rules Committee Action (PFC)",0,0,0,0,0
1935397,1501466,2025-02-27,Senate,"Senate - Third Reading",25,4,1,0,30
1935397,1528196,2025-03-26,House,"House Judiciary Committee Action (DP)",7,1,0,1,9
1935430,1480720,2025-02-05,Senate,"Senate Government Committee Action (DP)",4,3,0,0,7
1935430,1485077,2025-02-10,Senate,"Senate Rules Committee Action (PFC)",0,0,0,0,0
1935430,1495151,2025-02-20,Senate,"Senate - Committee of the Whole (DPA)",0,0,0,0,0
1935430,1495152,2025-02-20,Senate,"Senate - Third Reading",17,12,1,0,30
1935463,1479055,2025-02-03,Senate,"Senate Finance Committee Action (DP)",5,0,2,0,7
1935463,1484948,2025-02-10,Senate,"Senate Rules Committee Action (PFC)",0,0,0,0,0
1935463,1498975,2025-02-25,Senate,"Senate - Committee of the Whole (DP)",0,0,0,0,0
1935463,1500075,2025-02-26,Senate,"Senate - Third Reading",29,0,1,0,30
1935463,1520927,2025-03-19,House,"House Ways & Means Committee Action (DP)",8,1,0,0,9
1935463,1524863,2025-03-24,House,"House Rules Committee Action (C&P)",8,0,0,0,8
1935463,1528735,2025-03-27,House,"House - Committee of the Whole (DP)",0,0,0,0,0
1935463,1528736,2025-03-27,House,"House - Representative Crews  to include the Crews floor amendment",26,30,4,0,60
1935463,1538507,2025-04-07,House,"Motion Motion by Representative Carbone that pursuant to House Rule 12(P), SB1224 be calendared for an Additional Committee of the Whole for purposes of further amending. Motion passed v/v.",0,0,0,0,0
1935463,1538508,2025-04-07,House,"House - Committee of the Whole (DPA)",0,0,0,0,0
1935463,1548684,2025-04-15,House,"House - Third Reading",52,0,8,0,60
1935463,1560270,2025-04-29,Senate,"Senate - Concurrence",0,0,0,0,0
1935463,1560271,2025-04-29,Senate,"Senate - Third Reading",28,0,2,0,30
1935497,1496076,2025-02-20,Senate,"Senate Regulatory Affairs and Government Efficiency Committee Action (DPA/SE)",4,2,1,0,7
1935497,1497687,2025-02-24,Senate,"Senate Rules Committee Action (PFC)",0,0,0,0,0
1935497,1500141,2025-02-26,Senate,"Senate - Committee of the Whole (DPA)",0,0,0,0,0
1935497,1501755,2025-02-27,Senate,"Senate - Third Reading",17,12,1,0,30
1935497,1520086,2025-03-18,House,"House Regulatory Oversight Committee Action (DP)",3,2,0,0,5
1935497,1524835,2025-03-24,House,"House Rules Committee Action (C&P)",8,0,0,0,8
1935497,1534204,2025-04-02,House,"House - Committee of the Whole (RET ON CAL)",0,0,0,0,0
1935529,1482312,2025-02-05,Senate,"Senate Regulatory Affairs and Government Efficiency Committee Action (DP)",5,2,0,0,7
1935529,1485002,2025-02-10,Senate,"Senate Rules Committee Action (PFC)",0,0,0,0,0
1935529,1506159,2025-03-05,Senate,"Senate - Committee of the Whole (DPA)",0,0,0,0,0
1935529,1506160,2025-03-05,Senate,"Senate - Third Reading",16,13,1,0,30
1935529,1526727,2025-03-25,House,"House Commerce Committee Action (DPA)",5,4,1,0,10
1935529,1538483,2025-04-07,House,"House Rules Committee Action (C&P)",7,0,0,1,8
1935563,1486449,2025-02-11,House,"House Natural Resources, Energy & Water Committee Action (DP)",10,0,0,0,10
1935563,1491622,2025-02-17,House,"House Rules Committee Action (C&P)",7,0,0,1,8
1935563,1495578,2025-02-20,House,"House - Third Reading",59,0,1,0,60
1935563,1520275,2025-03-18,Senate,"Senate Natural Resources Committee Action (DP)",8,0,0,0,8
1935563,1524717,2025-03-24,Senate,"Senate Rules Committee Action (PFC)",0,0,0,0,0
1935563,1529173,2025-03-27,Senate,"Senate - Third Reading",19,7,3,0,29
1935594,1480726,2025-02-05,Senate,"Senate Health and Human Services Committee Action (DP)",6,0,1,0,7
1935594,1486918,2025-02-11,Senate,"Senate Appropriations Committee Action (DP)",7,3,0,0,10
1935594,1490859,2025-02-17,Senate,"Senate Rules Committee Action (PFC)",0,0,0,0,0
1935594,1503672,2025-03-03,Senate,"Senate - Committee of the Whole (DPA)",0,0,0,0,0
1935594,1506338,2025-03-05,Senate,"Senate - Third Reading",23,6,1,0,30
1935594,1525062,2025-03-24,House,"House Health & Human Services Committee Action (DPA)",7,4,0,1,12
1935594,1531615,2025-03-31,House,"House Appropriations Committee Action (DPA)",10,8,0,0,18
1935594,1547257,2025-04-14,House,"House Rules Committee Action (C&P)",8,0,0,0,8
1935594,1553630,2025-04-22,House,"House - Committee of the Whole (DPA)",0,0,0,0,0
1935662,1482240,2025-02-05,Senate,"Senate Public Safety Committee Action (HELD)",0,0,0,0,0
1935662,1494121,2025-02-19,Senate,"Senate Public Safety Committee Action (DPA/SE)",4,1,2,0,7
1935662,1497913,2025-02-24,Senate,"Senate Rules Committee Action (PFC)",0,0,0,0,0
1935662,1500733,2025-02-26,Senate,"Senate - Committee of the Whole (DPA)",0,0,0,0,0
1935662,1501713,2025-02-27,Senate,"Senate - Third Reading",17,12,1,0,30
1935662,1518566,2025-03-17,House,"House Public Safety & Law Enforcement Committee Action (DP)",13,0,0,2,15
1935662,1524937,2025-03-24,House,"House Rules Committee Action (C&P)",8,0,0,0,8
1935662,1529101,2025-03-27,House,"House - Third Reading",57,0,3,0,60
1935694,1482256,2025-02-05,Senate,"Senate Judiciary and Elections Committee Action (DPA)",4,3,0,0,7
1935694,1484925,2025-02-10,Senate,"Senate Rules Committee Action (PFC)",0,0,0,0,0
1935694,1499060,2025-02-25,Senate,"Senate - Committee of the Whole (DPA)",0,0,0,0,0
1935694,1500190,2025-02-26,Senate,"Senate - Third Reading",17,12,1,0,30
1935694,1527637,2025-03-26,House,"House Judiciary Committee Action (DP)",4,2,2,1,9
1935694,1538451,2025-04-07,House,"House Rules Committee Action (C&P)",7,0,0,1,8
1935694,1541600,2025-04-09,House,"House - Committee of the Whole (DP)",0,0,0,0,0
1935764,1488967,2025-02-12,Senate,"Senate Judiciary and Elections Committee Action (W/D)",0,0,0,0,0
1935764,1495230,2025-02-20,Senate,"Senate Regulatory Affairs and Government Efficiency Committee Action (DPA)",7,0,0,0,7
1935764,1497541,2025-02-24,Senate,"Senate Rules Committee Action (PFC)",0,0,0,0,0
1935764,1516958,2025-03-13,Senate,"Senate - Committee of the Whole (DPA)",0,0,0,0,0
1935764,1518752,2025-03-17,Senate,"Senate - Third Reading",22,4,3,0,29
1935764,1527283,2025-03-26,House,"House Judiciary Committee Action (HELD)",0,0,0,0,0
1935797,1494610,2025-02-19,Senate,"Senate Education Committee Action (DPA)",5,2,0,0,7
1935797,1497568,2025-02-24,Senate,"Senate Rules Committee Action (PFC)",0,0,0,0,0
1935797,1500395,2025-02-26,Senate,"Senate - Committee of the Whole (DPA)",0,0,0,0,0
1935797,1501732,2025-02-27,Senate,"Senate - Third Reading",17,12,1,0,30
1935797,1528083,2025-03-26,House,"House Science & Technology Committee Action (DP)",4,3,0,2,9
1935797,1545762,2025-02-19,Senate,"Senate Education-Archived and Renamed Education and Transportation as of 04/01/2025 Committee Action (DPA)",5,2,0,0,7
1935797,1547297,2025-04-14,House,"House Rules Committee Action (C&P)",8,0,0,0,8
1935830,1482334,2025-02-05,Senate,"Senate Education Committee Action (DPA)",6,0,1,0,7
1935830,1484974,2025-02-10,Senate,"Senate Rules Committee Action (PFC)",0,0,0,0,0
1935830,1495079,2025-02-20,Senate,"Senate - Committee of the Whole (DPA)",0,0,0,0,0
1935830,1495080,2025-02-20,Senate,"Senate - Third Reading",25,4,1,0,30
1935830,1504881,2025-03-04,House,"House Education Committee Action (DP)",9,0,0,3,12
1935830,1509282,2025-03-10,House,"House Rules Committee Action (C&P)",6,0,0,2,8
1935830,1517155,2025-03-13,House,"House - Third Reading",52,3,5,0,60
1935830,1545635,2025-02-05,Senate,"Senate Education-Archived and Renamed Education and Transportation as of 04/01/2025 Committee Action (DPA)",6,0,1,0,7
1935861,1494597,2025-02-19,Senate,"Senate Education Committee Action (DPA)",4,3,0,0,7
1935861,1499390,2025-02-25,Senate,"Senate Appropriations Committee Action (DP)",7,3,0,0,10
1935861,1503556,2025-03-03,Senate,"Senate Rules Committee Action (PFC)",0,0,0,0,0
1935861,1507886,2025-03-06,Senate,"Senate - Committee of the Whole (DPA)",0,0,0,0,0
1935861,1517090,2025-03-13,Senate,"Senate - Third Reading",16,12,2,0,30
1935861,1527575,2025-03-26,House,"House Judiciary Committee Action (DPA/SE)",7,1,0,1,9
1935861,1545653,2025-02-19,Senate,"Senate Education-Archived and Renamed Education and Transportation as of 04/01/2025 Committee Action (DPA)",4,3,0,0,7
1935898,1493463,2025-02-19,Senate,"Senate Government Committee Action (DP)",6,1,0,0,7
1935898,1498079,2025-02-24,Senate,"Senate Rules Committee Action (PFC)",0,0,0,0,0
1935898,1501745,2025-02-27,Senate,"Senate - Third Reading",25,4,1,0,30
1935898,1516734,2025-03-12,House,"House Land, Agriculture & Rural Affairs Committee Action (W/D)",0,0,0,0,0
1935898,1527243,2025-03-26,House,"House Judiciary Committee Action (DP)",9,0,0,0,9
1935898,1547888,2025-04-14,House,"House Rules Committee Action (C&P)",8,0,0,0,8
1935898,1553092,2025-04-21,House,"House - Committee of the Whole (DP)",0,0,0,0,0
1935898,1561848,2025-04-30,House,"House - Third Reading",45,5,10,0,60
1935929,1495384,2025-02-19,Senate,"Senate Education Committee Action (DPA/SE)",4,3,0,0,7
1935929,1498394,2025-02-24,Senate,"Senate Rules Committee Action (PFC)",0,0,0,0,0
1935929,1546491,2025-02-19,Senate,"Senate Education-Archived and Renamed Education and Transportation as of 04/01/2025 Committee Action (DPA/SE)",4,3,0,0,7
1935960,1480683,2025-02-05,Senate,"Senate Health and Human Services Committee Action (DP)",7,0,0,0,7
1935960,1485047,2025-02-10,Senate,"Senate Rules Committee Action (PFC)",0,0,0,0,0
1935960,1497793,2025-02-24,Senate,"Senate - Committee of the Whole (DPA)",0,0,0,0,0
1935960,1497794,2025-02-24,Senate,"Senate - Third Reading",30,0,0,0,30
1935960,1503711,2025-03-03,House,"House Health & Human Services Committee Action (DP)",11,1,0,0,12
1935960,1509497,2025-03-10,House,"House Rules Committee Action (C&P)",6,0,0,2,8
1935994,1493544,2025-02-18,Senate,"Senate Natural Resources Committee Action (DPA/SE)",4,3,1,0,8
1935994,1497910,2025-02-24,Senate,"Senate Rules Committee Action (PFC)",0,0,0,0,0
1935994,1501670,2025-02-27,Senate,"Senate - Committee of the Whole (DPA)",0,0,0,0,0
1935994,1507230,2025-03-06,Senate,"Senate - Third Reading",17,10,3,0,30
1935994,1526682,2025-03-25,House,"House Natural Resources, Energy & Water Committee Action (DP)",6,4,0,0,10
1935994,1531423,2025-03-31,House,"House Rules Committee Action (C&P)",7,0,0,1,8
1935994,1534428,2025-04-02,House,"House - Committee of the Whole (DPA)",0,0,0,0,0
1935994,1549906,2025-04-16,House,"House - Third Reading",33,25,2,0,60
1936061,1479809,2025-02-04,House,"House Natural Resources, Energy & Water Committee Action (DP)",7,2,1,0,10
1936061,1485052,2025-02-10,House,"House Rules Committee Action (C&P)",8,0,0,0,8
1936061,1492426,2025-02-18,House,"House - Committee of the Whole (RET ON CAL)",0,0,0,0,0
1936061,1509106,2025-03-10,House,"House - Committee of the Whole (RET ON CAL)",0,0,0,0,0
1936061,1513862,2025-03-11,House,"House - Committee of the Whole (DPA)",0,0,0,0,0
1936061,1516123,2025-03-12,House,"House - Third Reading",35,21,4,0,60
1936061,1527244,2025-03-25,Senate,"Senate Natural Resources Committee Action (DP)",4,3,1,0,8
1936061,1530874,2025-03-31,Senate,"Senate Rules Committee Action (PFC)",0,0,0,0,0
1936061,1565565,2025-05-06,Senate,"Senate - Committee of the Whole (DPA)",0,0,0,0,0
1936061,1565566,2025-05-06,Senate,"Senate - Third Reading",17,11,2,0,30
1936061,1567290,2025-05-07,House,"House - Concurrence",0,0,0,0,0
1936061,1567291,2025-05-07,House,"House - Third Reading",43,15,2,0,60
1936095,1482430,2025-02-05,Senate,"Senate Regulatory Affairs and Government Efficiency Committee Action (DP)",4,3,0,0,7
1936095,1484985,2025-02-10,Senate,"Senate Rules Committee Action (PFC)",0,0,0,0,0
1936095,1501187,2025-02-27,Senate,"Senate - Committee of the Whole (RETAINED)",0,0,0,0,0
1936095,1503261,2025-03-03,Senate,"Senate - Committee of the Whole (DPA)",0,0,0,0,0
1936095,1506396,2025-03-05,Senate,"Senate - Third Reading",16,13,1,0,30
1936095,1520512,2025-03-18,House,"House Health & Human Services Committee Action (W/D)",0,0,0,0,0
1936095,1526650,2025-03-25,House,"House Commerce Committee Action (DPA)",9,0,1,0,10
1936095,1547312,2025-04-14,House,"House Rules Committee Action (C&P)",8,0,0,0,8
1936095,1552706,2025-04-21,House,"House - Committee of the Whole (DPA)",0,0,0,0,0
1936095,1565032,2025-05-05,House,"House - Third Reading",14,43,3,0,60
1936127,1495640,2025-02-19,Senate,"Senate Judiciary and Elections Committee Action (DP)",7,0,0,0,7
1936127,1498344,2025-02-24,Senate,"Senate Rules Committee Action (PFC)",0,0,0,0,0
1936127,1501285,2025-02-27,Senate,"Senate - Committee of the Whole (RETAINED)",0,0,0,0,0
1936127,1507928,2025-03-06,Senate,"Senate - Committee of the Whole (DP)",0,0,0,0,0
1936127,1517535,2025-03-13,Senate,"Senate - Third Reading",18,10,2,0,30
1936127,1527684,2025-03-26,House,"House Judiciary Committee Action (DPA/SE)",7,2,0,0,9
1936127,1547262,2025-04-14,House,"House Rules Committee Action (C&P)",8,0,0,0,8
1936127,1549991,2025-04-16,House,"House - Committee of the Whole (DPA)",0,0,0,0,0
1936127,1555094,2025-04-23,House,"House - Third Reading",19,40,1,0,60
1936127,1555095,2025-04-23,House,"House - Reconsider Third Reading",0,0,0,0,0
1936127,1567311,2025-05-07,House,"House - Third Reading",37,21,2,0,60
1936226,1495512,2025-02-20,Senate,"Senate Regulatory Affairs and Government Efficiency Committee Action (DP)",4,3,0,0,7
1936226,1497588,2025-02-24,Senate,"Senate Rules Committee Action (PFC)",0,0,0,0,0
1936293,1480758,2025-02-05,Senate,"Senate Health and Human Services Committee Action (DP)",6,1,0,0,7
1936293,1485027,2025-02-10,Senate,"Senate Rules Committee Action (PFC)",0,0,0,0,0
1936293,1497816,2025-02-24,Senate,"Senate - Committee of the Whole (DP)",0,0,0,0,0
1936293,1497817,2025-02-24,Senate,"Senate - Third Reading",18,12,0,0,30
1936327,1476271,2025-01-29,House,"House Judiciary Committee Action (DP)",6,3,0,0,9
1936327,1478759,2025-02-03,House,"House Rules Committee Action (C&P)",8,0,0,0,8
1936327,1491140,2025-02-17,House,"House - Committee of the Whole (DP)",0,0,0,0,0
1936327,1493782,2025-02-19,House,"House - Third Reading",31,28,1,0,60
1936327,1520991,2025-03-19,Senate,"Senate Regulatory Affairs and Government Efficiency Committee Action (DP)",4,2,1,0,7
1936327,1524764,2025-03-24,Senate,"Senate Rules Committee Action (PFC)",0,0,0,0,0
1936327,1567381,2025-05-07,Senate,"Senate - Committee of the Whole (DP)",0,0,0,0,0
1936327,1567382,2025-05-07,Senate,"Senate - Third Reading",13,12,5,0,30
1936450,1482327,2025-02-05,Senate,"Senate Education Committee Action (DP)",6,0,1,0,7
1936450,1485036,2025-02-10,Senate,"Senate Rules Committee Action (PFC)",0,0,0,0,0
1936450,1501553,2025-02-27,Senate,"Senate - Third Reading",28,1,1,0,30
1936450,1520276,2025-03-18,House,"House Education Committee Action (DPA/SE)",11,1,0,0,12
1936450,1524840,2025-03-24,House,"House Rules Committee Action (C&P)",8,0,0,0,8
1936450,1528737,2025-03-27,House,"House - Committee of the Whole (DPA)",0,0,0,0,0
1936450,1528738,2025-03-27,House,"House - Representative Kolodin  to show the bill failed to pass",20,36,4,0,60
1936450,1545812,2025-02-05,Senate,"Senate Education-Archived and Renamed Education and Transportation as of 04/01/2025 Committee Action (DP)",6,0,1,0,7
1936818,1479807,2025-02-04,House,"House Natural Resources, Energy & Water Committee Action (DP)",6,4,0,0,10
1936818,1484785,2025-02-10,House,"House Rules Committee Action (C&P)",8,0,0,0,8
1936818,1492696,2025-02-18,House,"House - Committee of the Whole (DPA)",0,0,0,0,0
1936818,1495920,2025-02-20,House,"House - Third Reading",33,26,1,0,60
1936818,1515561,2025-03-11,Senate,"Senate Natural Resources Committee Action (DP)",5,2,1,0,8
1936818,1519240,2025-03-17,Senate,"Senate Rules Committee Action (PFC)",0,0,0,0,0
1936818,1551106,2025-04-16,Senate,"Senate - Third Reading",17,12,1,0,30
1937173,1493022,2025-02-19,House,"House Judiciary Committee Action (DP)",6,2,0,1,9
1937173,1497237,2025-02-24,House,"House Rules Committee Action (C&P)",4,3,0,1,8
1937173,1498678,2025-02-25,House,"House - Committee of the Whole (RET ON CAL)",0,0,0,0,0
1937173,1500364,2025-02-26,House,"House - Committee of the Whole (DPA)",0,0,0,0,0
1937173,1505004,2025-03-04,House,"House - Third Reading",32,26,2,0,60
1937173,1521471,2025-03-19,Senate,"Senate Judiciary and Elections Committee Action (DP)",4,3,0,0,7
1937193,1494299,2025-02-19,Senate,"Senate Public Safety Committee Action (DP)",6,1,0,0,7
1937193,1498412,2025-02-24,Senate,"Senate Rules Committee Action (PFC)",0,0,0,0,0
1937272,1479091,2025-02-03,Senate,"Senate Finance Committee Action (DP)",4,3,0,0,7
1937272,1484894,2025-02-10,Senate,"Senate Rules Committee Action (PFC)",0,0,0,0,0
1937272,1498939,2025-02-25,Senate,"Senate - Committee of the Whole (DP)",0,0,0,0,0
1937272,1500098,2025-02-26,Senate,"Senate - Third Reading",17,11,2,0,30
1937272,1521080,2025-03-19,House,"House Ways & Means Committee Action (DP)",5,4,0,0,9
1937307,1482323,2025-02-05,Senate,"Senate Education Committee Action (DP)",4,2,1,0,7
1937307,1484955,2025-02-10,Senate,"Senate Rules Committee Action (PFC)",4,2,1,0,7
1937307,1494991,2025-02-20,Senate,"Senate - Committee of the Whole (DP)",0,0,0,0,0
1937307,1494992,2025-02-20,Senate,"Senate - Third Reading",17,12,1,0,30
1937307,1514297,2025-03-11,House,"House Education Committee Action (DPA)",7,5,0,0,12
1937307,1518794,2025-03-17,House,"House Rules Committee Action (C&P)",0,0,0,0,0
1937307,1523030,2025-03-20,House,"House - Committee of the Whole (DPA)",0,0,0,0,0
1937307,1523031,2025-03-20,House,"House - Representative Marquez  to show the bill failed to pass",23,30,7,0,60
1937307,1545822,2025-02-05,Senate,"Senate Education-Archived and Renamed Education and Transportation as of 04/01/2025 Committee Action (DP)",4,2,1,0,7
1937307,1547283,2025-04-14,House,"House - Third Reading",31,25,4,0,60
1937330,1487474,2025-02-12,House,"House Government Committee Action (DP)",4,3,0,0,7
1937330,1491376,2025-02-17,House,"House Rules Committee Action (C&P)",7,0,0,1,8
1937330,1494700,2025-02-20,House,"House - Committee of the Whole (DP)",0,0,0,0,0
1937330,1499057,2025-02-25,House,"House - Third Reading",33,27,0,0,60
1937330,1521213,2025-03-19,Senate,"Senate Government Committee Action (DP)",4,3,0,0,7
1937388,1479072,2025-02-03,Senate,"Senate Military Affairs and Border Security Committee Action (DP)",4,3,0,0,7
1937388,1484990,2025-02-10,Senate,"Senate Rules Committee Action (PFC)",0,0,0,0,0
1937388,1499072,2025-02-25,Senate,"Senate - Committee of the Whole (DP)",0,0,0,0,0
1937388,1500188,2025-02-26,Senate,"Senate - Third Reading",17,12,1,0,30
1937388,1509700,2025-03-10,House,"House Health & Human Services Committee Action (DP)",6,4,0,2,12
1937388,1518858,2025-03-17,House,"House Rules Committee Action (C&P)",8,0,0,0,8
1937388,1527622,2025-03-26,House,"House - Committee of the Whole (DP)",0,0,0,0,0
1937388,1565150,2025-05-05,House,"House - Third Reading",32,25,3,0,60
1937415,1482814,2025-02-05,Senate,"Senate Education Committee Action (DP)",4,2,1,0,7
1937415,1484763,2025-02-10,Senate,"Senate Rules Committee Action (PFC)",0,0,0,0,0
1937415,1495475,2025-02-20,Senate,"Senate - Committee of the Whole (DPA)",0,0,0,0,0
1937415,1495476,2025-02-20,Senate,"Senate - Third Reading",18,11,1,0,30
1937415,1505079,2025-03-04,House,"House Education Committee Action (DISC/HELD)",0,0,0,0,0
1937415,1515326,2025-03-11,House,"House Education Committee Action (DP)",7,5,0,0,12
1937415,1519200,2025-03-17,House,"House Rules Committee Action (C&P)",8,0,0,0,8
1937415,1523018,2025-03-20,House,"House - Committee of the Whole (DP)",0,0,0,0,0
1937415,1545850,2025-02-05,Senate,"Senate Education-Archived and Renamed Education and Transportation as of 04/01/2025 Committee Action (DP)",4,2,1,0,7
1937415,1549772,2025-04-16,House,"House - Third Reading",28,30,2,0,60
1937415,1550402,2025-04-16,House,"House - Reconsider Third Reading",0,0,0,0,0
1937479,1492434,2025-02-17,Senate,"Senate Finance Committee Action (DPA/SE)",6,1,0,0,7
1937479,1503799,2025-03-03,Senate,"Senate Rules Committee Action (PFC)",0,0,0,0,0
1937571,1492903,2025-02-18,Senate,"Senate Appropriations Committee Action (DPA/SE)",8,1,1,0,10
1937571,1498082,2025-02-24,Senate,"Senate Rules Committee Action (PFC)",0,0,0,0,0
1937571,1500155,2025-02-26,Senate,"Senate - Committee of the Whole (DPA)",0,0,0,0,0
1937571,1501593,2025-02-27,Senate,"Senate - Third Reading",24,4,1,1,30
1937571,1518833,2025-03-17,House,"House Health & Human Services Committee Action (DP)",7,5,0,0,12
1937571,1523217,2025-03-20,House,"House Appropriations Committee Action (W/D)",0,0,0,0,0
1937571,1527689,2025-03-26,House,"House Government Committee Action (HELD)",0,0,0,0,0
1937600,1478946,2025-02-03,Senate,"Senate Finance Committee Action (DP)",6,0,1,0,7
1937600,1485016,2025-02-10,Senate,"Senate Rules Committee Action (PFC)",0,0,0,0,0
1937600,1501542,2025-02-27,Senate,"Senate - Third Reading",29,0,1,0,30
1937600,1515855,2025-03-12,House,"House Ways & Means Committee Action (DP)",7,0,0,2,9
1937600,1518890,2025-03-17,House,"House Rules Committee Action (C&P)",8,0,0,0,8
1937600,1525051,2025-03-24,House,"House - Committee of the Whole (DPA)",0,0,0,0,0
1937600,1526558,2025-03-25,House,"House - Third Reading",55,3,2,0,60
1937600,1567042,2025-05-07,House,"House - Third Reading",58,0,2,0,60
1937621,1478697,2025-02-03,House,"House Rules Committee Action (DP/C&P)",5,3,0,0,8
1937682,1487518,2025-02-12,House,"House Judiciary Committee Action (DP)",7,0,2,0,9
1937682,1490940,2025-02-17,House,"House Rules Committee Action (C&P)",7,0,0,1,8
1937682,1494798,2025-02-20,House,"House - Committee of the Whole (DPA)",0,0,0,0,0
1937682,1499217,2025-02-25,House,"House - Third Reading",34,26,0,0,60
1937682,1516304,2025-03-12,Senate,"Senate Judiciary and Elections Committee Action (FAILED)",3,4,0,0,7
1937746,1488612,2025-02-12,Senate,"Senate Public Safety Committee Action (DPA)",5,2,0,0,7
1937746,1490906,2025-02-17,Senate,"Senate Rules Committee Action (PFC)",0,0,0,0,0
1937858,1480700,2025-02-05,Senate,"Senate Government Committee Action (DP)",4,3,0,0,7
1937858,1484905,2025-02-10,Senate,"Senate Rules Committee Action (PFC)",0,0,0,0,0
1937858,1495017,2025-02-20,Senate,"Senate - Committee of the Whole (DP)",0,0,0,0,0
1937858,1495018,2025-02-20,Senate,"Senate - Third Reading",17,12,1,0,30
1937858,1528987,2025-03-27,House,"House Government Committee Action (DP)",4,3,0,0,7
1937858,1532437,2025-04-01,House,"House Rules Committee Action (C&P)",7,0,0,1,8
1937858,1541394,2025-04-09,House,"House - Committee of the Whole (DP)",0,0,0,0,0
1937858,1550159,2025-04-16,House,"House - Third Reading",33,25,2,0,60
1937888,1495645,2025-02-19,Senate,"Senate Judiciary and Elections Committee Action (DP)",4,2,1,0,7
1937888,1499680,2025-02-25,Senate,"Senate Appropriations Committee Action (DP)",8,2,0,0,10
1937888,1503536,2025-03-03,Senate,"Senate Rules Committee Action (PFC)",0,0,0,0,0
1937888,1507554,2025-03-06,Senate,"Senate - Committee of the Whole (DPA)",0,0,0,0,0
1937888,1517243,2025-03-13,Senate,"Senate - Third Reading",16,11,3,0,30
1937888,1525167,2025-03-24,House,"House Health & Human Services Committee Action (DP)",8,3,0,1,12
1937921,1482308,2025-02-05,Senate,"Senate Judiciary and Elections Committee Action (DP)",4,3,0,0,7
1937921,1484970,2025-02-10,Senate,"Senate Rules Committee Action (PFC)",0,0,0,0,0
1937921,1498972,2025-02-25,Senate,"Senate - Committee of the Whole (DP)",0,0,0,0,0
1937921,1500080,2025-02-26,Senate,"Senate - Third Reading",17,12,1,0,30
1937921,1516257,2025-03-12,House,"House Federalism, Military Affairs & Elections Committee Action (DP)",4,3,0,0,7
1937944,1482722,2025-02-05,Senate,"Senate Natural Resources Committee Action (HELD)",0,0,0,0,0
1937978,1488824,2025-02-13,Senate,"Senate Finance Committee Action (W/D)",0,0,0,0,0
1937978,1499263,2025-02-25,Senate,"Senate Appropriations Committee Action (DPA/SE)",10,0,0,0,10
1937978,1503973,2025-03-03,Senate,"Senate Rules Committee Action (PFC)",0,0,0,0,0
1937978,1508220,2025-03-06,Senate,"Senate - Committee of the Whole (DPA)",0,0,0,0,0
1937978,1517591,2025-03-13,Senate,"Senate - Third Reading",26,1,3,0,30
1937978,1525701,2025-03-24,House,"House Land, Agriculture & Rural Affairs Committee Action (DP)",7,1,0,1,9
1937978,1531346,2025-03-31,House,"House Appropriations Committee Action (DP)",18,0,0,0,18
1938008,1480420,2025-02-04,House,"House Regulatory Oversight Committee Action (DP)",3,2,0,0,5
1938008,1485106,2025-02-10,House,"House Rules Committee Action (C&P)",5,3,0,0,8
1938008,1491313,2025-02-17,House,"House - Third Reading",33,26,1,0,60
1938008,1506317,2025-03-05,Senate,"Senate Public Safety Committee Action (DP)",4,2,1,0,7
1938036,1486834,2025-02-11,House,"House Commerce Committee Action (DP)",10,0,0,0,10
1938036,1490904,2025-02-17,House,"House Rules Committee Action (C&P)",7,0,0,1,8
1938036,1497867,2025-02-24,House,"House - Committee of the Whole (DP)",0,0,0,0,0
1938036,1499123,2025-02-25,House,"House - Third Reading",45,15,0,0,60
1938296,1491410,2025-02-17,Senate,"Senate Federalism Committee Action (DPA/SE)",4,2,1,0,7
1938296,1503578,2025-03-03,Senate,"Senate Rules Committee Action (PFC)",5,4,0,0,9
1938296,1507499,2025-03-06,Senate,"Senate - Committee of the Whole (DPA)",0,0,0,0,0
1938296,1517241,2025-03-13,Senate,"Senate - Third Reading",16,12,2,0,30
1938296,1526398,2025-03-25,House,"House Natural Resources, Energy & Water Committee Action (DP)",5,3,0,2,10
1938296,1547882,2025-04-14,House,"House Rules Committee Action (C&P)",8,0,0,0,8
1938296,1552795,2025-04-21,House,"House - Committee of the Whole (RET ON CAL)",0,0,0,0,0
1938396,1495672,2025-02-19,Senate,"Senate Judiciary and Elections Committee Action (DPA/SE)",4,2,1,0,7
1938396,1497869,2025-02-24,Senate,"Senate Rules Committee Action (PFC)",7,0,0,0,7
1938396,1501734,2025-02-27,Senate,"Senate - Committee of the Whole (DPA)",0,0,0,0,0
1938396,1507294,2025-03-06,Senate,"Senate - Third Reading",15,12,3,0,30
1938396,1507954,2025-03-06,Senate,"Senate - Reconsider Third Reading",0,0,0,0,0
1938396,1519073,2025-03-17,Senate,"Senate - Third Reading",13,13,3,0,29
1938590,1482556,2025-02-05,Senate,"Senate Public Safety Committee Action (DP)",7,0,0,0,7
1938590,1485025,2025-02-10,Senate,"Senate Rules Committee Action (PFC)",0,0,0,0,0
1938590,1495029,2025-02-20,Senate,"Senate - Committee of the Whole (DP)",0,0,0,0,0
1938590,1495030,2025-02-20,Senate,"Senate - Third Reading",21,8,1,0,30
1938590,1527625,2025-03-26,House,"House Judiciary Committee Action (DP)",6,3,0,0,9
1938590,1547362,2025-04-14,House,"House Rules Committee Action (C&P)",8,0,0,0,8
1938590,1553748,2025-04-22,House,"House - Committee of the Whole (DP)",0,0,0,0,0
1938688,1479190,2025-02-03,Senate,"Senate Military Affairs and Border Security Committee Action (DP)",7,0,0,0,7
1938688,1485377,2025-02-10,Senate,"Senate Rules Committee Action (PFC)",0,0,0,0,0
1938688,1502178,2025-02-27,Senate,"Senate - Third Reading",25,4,1,0,30
1938688,1528274,2025-03-26,House,"House Federalism, Military Affairs & Elections Committee Action (DP)",7,0,0,0,7
1938688,1539105,2025-04-07,House,"House Rules Committee Action (C&P)",7,0,0,1,8
1938688,1541755,2025-04-09,House,"House - Committee of the Whole (DPA)",0,0,0,0,0
1938688,1567221,2025-05-07,House,"Motion Motion by Representative Carbone that pursuant to House Rule 12(P), SB1281 be calendared for an Additional Committee of the Whole for purposes of further amending. Motion passed v/v.",0,0,0,0,0
1938688,1567222,2025-05-07,House,"House - Committee of the Whole (DPA)",0,0,0,0,0
1938786,1485118,2025-02-10,Senate,"Senate Federalism Committee Action (DPA/SE)",6,1,0,0,7
1938786,1491459,2025-02-17,Senate,"Senate Rules Committee Action (PFC)",0,0,0,0,0
1938884,1482642,2025-02-05,Senate,"Senate Judiciary and Elections Committee Action (DP)",4,3,0,0,7
1938884,1484904,2025-02-10,Senate,"Senate Rules Committee Action (PFC)",0,0,0,0,0
1938884,1503214,2025-03-03,Senate,"Senate - Committee of the Whole (DPA)",0,0,0,0,0
1938884,1506326,2025-03-05,Senate,"Senate - Third Reading",17,12,1,0,30
1938884,1528101,2025-03-26,House,"House Federalism, Military Affairs & Elections Committee Action (DPA)",4,3,0,0,7
1938884,1538466,2025-04-07,House,"House Rules Committee Action (C&P)",7,0,0,1,8
1938884,1547218,2025-04-14,House,"House - Committee of the Whole (DPA)",0,0,0,0,0
1938884,1549942,2025-04-16,House,"House - Third Reading",33,25,2,0,60
1938884,1560100,2025-04-29,Senate,"Senate - Concurrence",0,0,0,0,0
1938884,1560101,2025-04-29,Senate,"Senate - Third Reading",16,12,2,0,30
1940070,1480130,2025-02-04,Senate,"Senate Appropriations Committee Action (DPA)",9,0,1,0,10
1940070,1485239,2025-02-10,Senate,"Senate Rules Committee Action (PFC)",0,0,0,0,0
1940070,1507883,2025-03-06,Senate,"Senate - Committee of the Whole (DPA)",0,0,0,0,0
1940070,1517164,2025-03-13,Senate,"Senate - Third Reading",25,2,3,0,30
1940070,1525090,2025-03-24,House,"House Land, Agriculture & Rural Affairs Committee Action (DP)",7,1,0,1,9
1940227,1493773,2025-02-19,Senate,"Senate Public Safety Committee Action (DPA)",7,0,0,0,7
1940227,1498042,2025-02-24,Senate,"Senate Rules Committee Action (PFC)",0,0,0,0,0
1940227,1507851,2025-03-06,Senate,"Senate - Committee of the Whole (DPA)",0,0,0,0,0
1940227,1517120,2025-03-13,Senate,"Senate - Third Reading",11,17,2,0,30
1940384,1488611,2025-02-12,Senate,"Senate Public Safety Committee Action (DP)",5,2,0,0,7
1940384,1492695,2025-02-18,Senate,"Senate Appropriations Committee Action (HELD)",0,0,0,0,0
1940540,1482401,2025-02-05,Senate,"Senate Judiciary and Elections Committee Action (DP)",4,3,0,0,7
1940540,1484972,2025-02-10,Senate,"Senate Rules Committee Action (PFC)",0,0,0,0,0
1940540,1499013,2025-02-25,Senate,"Senate - Committee of the Whole (DP)",0,0,0,0,0
1940540,1500143,2025-02-26,Senate,"Senate - Third Reading",17,12,1,0,30
1940540,1521613,2025-03-19,House,"House Federalism, Military Affairs & Elections Committee Action (FAILED)",3,3,0,1,7
1940700,1487554,2025-02-12,Senate,"Senate Health and Human Services Committee Action (HELD)",0,0,0,0,0
1940700,1493443,2025-02-19,Senate,"Senate Health and Human Services Committee Action (DPA/SE)",6,0,1,0,7
1940700,1497613,2025-02-24,Senate,"Senate Rules Committee Action (PFC)",0,0,0,0,0
1940700,1503243,2025-03-03,Senate,"Senate - Committee of the Whole (DPA)",0,0,0,0,0
1940700,1506351,2025-03-05,Senate,"Senate - Third Reading",29,0,1,0,30
1940700,1519083,2025-03-17,House,"House Health & Human Services Committee Action (DP)",11,0,0,1,12
1940700,1524834,2025-03-24,House,"House Rules Committee Action (C&P)",8,0,0,0,8
1940700,1528754,2025-03-27,House,"House - Committee of the Whole (RET ON CAL)",0,0,0,0,0
1940700,1543836,2025-04-10,House,"House - Committee of the Whole (DPA)",0,0,0,0,0
1940700,1547425,2025-04-14,House,"House - Third Reading",54,0,6,0,60
1940700,1560126,2025-04-29,Senate,"Senate - Concurrence",0,0,0,0,0
1940700,1560127,2025-04-29,Senate,"Senate - Third Reading",29,0,1,0,30
1940856,1482257,2025-02-05,Senate,"Senate Regulatory Affairs and Government Efficiency Committee Action (DP)",6,0,1,0,7
1940856,1485631,2025-02-10,Senate,"Senate Rules Committee Action (PFC)",0,0,0,0,0
1940856,1497972,2025-02-24,Senate,"Senate - Committee of the Whole (DPA)",0,0,0,0,0
1940856,1497973,2025-02-24,Senate,"Senate - Third Reading",28,2,0,0,30
1940856,1516229,2025-03-12,House,"House Government Committee Action (DP)",7,0,0,0,7
1940856,1518604,2025-03-17,House,"House Rules Committee Action (C&P)",8,0,0,0,8
1940856,1521437,2025-03-19,House,"House - Third Reading",57,0,3,0,60
1941170,1492244,2025-02-17,Senate,"Senate Finance Committee Action (DPA)",6,1,0,0,7
1941170,1498224,2025-02-24,Senate,"Senate Rules Committee Action (PFC)",0,0,0,0,0
1941170,1500634,2025-02-26,Senate,"Senate - Committee of the Whole (RETAINED)",0,0,0,0,0
1941170,1503601,2025-03-03,Senate,"Senate - Committee of the Whole (RETAINED)",0,0,0,0,0
1941170,1507896,2025-03-06,Senate,"Senate - Committee of the Whole (DPA)",0,0,0,0,0
1941170,1517308,2025-03-13,Senate,"Senate - Third Reading",24,3,3,0,30
1941170,1525675,2025-03-24,House,"House Public Safety & Law Enforcement Committee Action (DPA)",12,1,1,1,15
1941170,1547872,2025-04-14,House,"House Rules Committee Action (C&P)",8,0,0,0,8
1941170,1550550,2025-04-16,House,"House - Committee of the Whole (RET ON CAL)",0,0,0,0,0
1941170,1563437,2025-05-01,House,"House - Committee of the Whole (DPA)",0,0,0,0,0
1941170,1563438,2025-05-01,House,"House - Representative Marquez to exclude the Marshall flr amendment",21,37,2,0,60
1941170,1564945,2025-05-05,House,"House - Third Reading",35,22,3,0,60
1941170,1567254,2025-05-07,Senate,"Senate - Concurrence",0,0,0,0,0
1941170,1567255,2025-05-07,Senate,"Senate - Third Reading",21,5,4,0,30
1941330,1482958,2025-02-05,House,"House Science & Technology Committee Action (DPA)",8,0,0,1,9
1941330,1485644,2025-02-10,House,"House Rules Committee Action (C&P)",8,0,0,0,8
1941330,1491672,2025-02-17,House,"House - Committee of the Whole (DPA)",0,0,0,0,0
1941330,1494068,2025-02-19,House,"House - Third Reading",58,1,1,0,60
1941330,1509763,2025-03-10,Senate,"Senate Military Affairs and Border Security Committee Action (HELD)",0,0,0,0,0
1941863,1482380,2025-02-05,Senate,"Senate Judiciary and Elections Committee Action (DPA)",4,3,0,0,7
1941863,1485070,2025-02-10,Senate,"Senate Rules Committee Action (PFC)",0,0,0,0,0
1941863,1499089,2025-02-25,Senate,"Senate - Committee of the Whole (DPA)",0,0,0,0,0
1941863,1500219,2025-02-26,Senate,"Senate - Third Reading",18,11,1,0,30
1941863,1520992,2025-03-19,House,"House Judiciary Committee Action (DP)",5,2,1,1,9
1941863,1532423,2025-04-01,House,"House Rules Committee Action (C&P)",7,0,0,1,8
1941863,1541671,2025-04-09,House,"House - Committee of the Whole (DP)",0,0,0,0,0
1941863,1547335,2025-04-14,House,"Motion Motion by Representative Carbone that pursuant to House Rule 12(P), SB1295 be calendared for an Additional Committee of the Whole for purposes of further amending. Motion passed v/v.",0,0,0,0,0
1941863,1547336,2025-04-14,House,"House - Committee of the Whole (DPA)",0,0,0,0,0
1941863,1551295,2025-04-17,House,"Motion Motion by Representative Carbone that pursuant to House Rule 12(P), SB1295 be calendared for an Additional Committee of the Whole for purposes of further amending. Motion passed v/v.",0,0,0,0,0
1941863,1551296,2025-04-17,House,"House - Committee of the Whole (DPA)",0,0,0,0,0
1941863,1565057,2025-05-05,House,"House - Third Reading",40,17,3,0,60
1941863,1567316,2025-05-07,Senate,"Senate - Concurrence",0,0,0,0,0
1941863,1567317,2025-05-07,Senate,"Senate - Third Reading",20,6,4,0,30
1941951,1494595,2025-02-19,Senate,"Senate Education Committee Action (DPA)",7,0,0,0,7
1941951,1499389,2025-02-25,Senate,"Senate Appropriations Committee Action (DP)",10,0,0,0,10
1941951,1503387,2025-03-03,Senate,"Senate Rules Committee Action (PFC)",0,0,0,0,0
1941951,1507774,2025-03-06,Senate,"Senate - Committee of the Whole (DPA)",0,0,0,0,0
1941951,1517059,2025-03-13,Senate,"Senate - Third Reading",23,4,3,0,30
1941951,1526685,2025-03-25,House,"House Education Committee Action (DP)",12,0,0,0,12
1941951,1545627,2025-02-19,Senate,"Senate Education-Archived and Renamed Education and Transportation as of 04/01/2025 Committee Action (DPA)",7,0,0,0,7
1942042,1485386,2025-02-10,Senate,"Senate Military Affairs and Border Security Committee Action (DPA)",4,3,0,0,7
1942042,1490911,2025-02-17,Senate,"Senate Rules Committee Action (PFC)",0,0,0,0,0
1942042,1501198,2025-02-27,Senate,"Senate - Committee of the Whole (DPA)",0,0,0,0,0
1942042,1503706,2025-03-03,Senate,"Senate - Third Reading",18,11,1,0,30
1942042,1525092,2025-03-24,House,"House Public Safety & Law Enforcement Committee Action (DP)",8,6,0,1,15
1942042,1532445,2025-04-01,House,"House Rules Committee Action (C&P)",7,0,0,1,8
1942042,1541737,2025-04-09,House,"House - Committee of the Whole (DP)",0,0,0,0,0
1942042,1563653,2025-05-01,House,"House - Third Reading",10,48,2,0,60
1942326,1485384,2025-02-10,Senate,"Senate Military Affairs and Border Security Committee Action (DP)",4,3,0,0,7
1942326,1492916,2025-02-18,Senate,"Senate Appropriations Committee Action (DP)",6,2,2,0,10
1942326,1498179,2025-02-24,Senate,"Senate Rules Committee Action (PFC)",0,0,0,0,0
1942326,1500916,2025-02-26,Senate,"Senate - Committee of the Whole (DP)",0,0,0,0,0
1942326,1503329,2025-03-03,Senate,"Senate - Third Reading",17,12,1,0,30
1942326,1530054,2025-03-27,House,"House Public Safety & Law Enforcement Committee Action (W/D)",0,0,0,0,0
1942326,1531558,2025-03-31,House,"House Appropriations Committee Action (DPA/SE)",11,6,1,0,18
1942381,1485805,2025-02-10,Senate,"Senate Finance Committee Action (DP)",5,2,0,0,7
1942381,1491189,2025-02-17,Senate,"Senate Rules Committee Action (PFC)",0,0,0,0,0
1942381,1499153,2025-02-25,Senate,"Senate - Committee of the Whole (DPA)",0,0,0,0,0
1942381,1500289,2025-02-26,Senate,"Senate - Third Reading",18,11,1,0,30
1942381,1528103,2025-03-26,House,"House Federalism, Military Affairs & Elections Committee Action (W/D)",0,0,0,0,0
1942381,1531256,2025-03-31,House,"House Appropriations Committee Action (DPA/SE)",11,7,0,0,18
1942381,1538149,2025-04-07,House,"House Rules Committee Action (C&P)",7,0,0,1,8
1942381,1563642,2025-05-01,House,"House - Committee of the Whole (DPA)",0,0,0,0,0
1942381,1565762,2025-05-06,House,"House - Third Reading",31,23,6,0,60
1942381,1567225,2025-05-07,Senate,"Senate - Concurrence",0,0,0,0,0
1942381,1567226,2025-05-07,Senate,"Senate - Third Reading",17,9,4,0,30
1942441,1491750,2025-02-17,Senate,"Senate Finance Committee Action (DPA)",5,1,1,0,7
1942441,1498406,2025-02-24,Senate,"Senate Rules Committee Action (PFC)",0,0,0,0,0
1942502,1480852,2025-02-05,House,"House Ways & Means Committee Action (DP)",8,0,0,1,9
1942502,1484912,2025-02-10,House,"House Rules Committee Action (C&P)",8,0,0,0,8
1942502,1489103,2025-02-13,House,"House - Third Reading",54,0,6,0,60
1942502,1497787,2025-02-24,Senate,"Motion HB 2688 substituted for SB 1222. Motion carried.",0,0,0,0,0
1942502,1497788,2025-02-24,Senate,"Senate - Third Reading",30,0,0,0,30
1942562,1495495,2025-02-20,Senate,"Senate Regulatory Affairs and Government Efficiency Committee Action (DP)",4,3,0,0,7
1942562,1497590,2025-02-24,Senate,"Senate Rules Committee Action (PFC)",0,0,0,0,0
1942562,1500369,2025-02-26,Senate,"Senate - Committee of the Whole (DP)",0,0,0,0,0
1942562,1503619,2025-03-03,Senate,"Senate - Third Reading",17,12,1,0,30
1942562,1520289,2025-03-18,House,"House Commerce Committee Action (DPA)",6,4,0,0,10
1942562,1524872,2025-03-24,House,"House Rules Committee Action (C&P)",8,0,0,0,8
1942562,1527783,2025-03-26,House,"House - Committee of the Whole (DPA)",0,0,0,0,0
1942562,1547246,2025-04-14,House,"House - Third Reading",32,23,5,0,60
1942562,1559975,2025-04-29,Senate,"Senate - Concurrence",0,0,0,0,0
1942562,1559976,2025-04-29,Senate,"Senate - Third Reading",17,12,1,0,30
1942621,1487977,2025-02-12,Senate,"Senate Education Committee Action (DP)",4,3,0,0,7
1942621,1490898,2025-02-17,Senate,"Senate Rules Committee Action (PFC)",0,0,0,0,0
1942621,1501208,2025-02-27,Senate,"Senate - Committee of the Whole (DP)",0,0,0,0,0
1942621,1503622,2025-03-03,Senate,"Senate - Third Reading",17,12,1,0,30
1942621,1520013,2025-03-18,House,"House Education Committee Action (DP)",7,4,1,0,12
1942621,1545541,2025-02-12,Senate,"Senate Education-Archived and Renamed Education and Transportation as of 04/01/2025 Committee Action (DP)",4,3,0,0,7
1942682,1480105,2025-02-04,Senate,"Senate Natural Resources Committee Action (DP)",7,1,0,0,8
1942682,1486927,2025-02-11,Senate,"Senate Appropriations Committee Action (DPA)",10,0,0,0,10
1942682,1490998,2025-02-17,Senate,"Senate Rules Committee Action (PFC)",0,0,0,0,0
1942682,1501254,2025-02-27,Senate,"Senate - Committee of the Whole (DPA)",0,0,0,0,0
1942682,1503417,2025-03-03,Senate,"Senate - Third Reading",26,3,1,0,30
1942682,1518630,2025-03-17,House,"House Land, Agriculture & Rural Affairs Committee Action (HELD)",0,0,0,0,0
1942682,1525150,2025-03-24,House,"House Land, Agriculture & Rural Affairs Committee Action (DP)",6,3,0,0,9
1942682,1528121,2025-03-26,House,"House Appropriations Committee Action (DPA)",12,3,2,1,18
1942744,1493266,2025-02-19,Senate,"Senate Health and Human Services Committee Action (DP)",6,0,1,0,7
1942744,1499400,2025-02-25,Senate,"Senate Appropriations Committee Action (DP)",10,0,0,0,10
1942744,1503244,2025-03-03,Senate,"Senate Rules Committee Action (PFC)",0,0,0,0,0
1942744,1507698,2025-03-06,Senate,"Senate - Committee of the Whole (DP)",0,0,0,0,0
1942744,1517403,2025-03-13,Senate,"Senate - Third Reading",25,2,3,0,30
1942804,1491690,2025-02-17,House,"House Public Safety & Law Enforcement Committee Action (HELD)",0,0,0,0,0
1942804,1495242,2025-02-20,House,"House Public Safety & Law Enforcement Committee Action (DPA/SE)",12,0,0,3,15
1942804,1497281,2025-02-24,House,"House Rules Committee Action (C&P)",7,0,0,1,8
1942804,1501431,2025-02-27,House,"House - Committee of the Whole (DPA)",0,0,0,0,0
1942804,1504771,2025-03-04,House,"House - Third Reading",56,2,2,0,60
1942804,1525796,2025-03-24,Senate,"Senate Finance Committee Action (DPA)",6,1,0,0,7
1942804,1531199,2025-03-31,Senate,"Senate Rules Committee Action (PFC)",0,0,0,0,0
1942804,1556949,2025-04-24,Senate,"Senate - Committee of the Whole (DPA)",0,0,0,0,0
1942804,1565776,2025-05-06,Senate,"Senate - Committee of the Whole (DPA)",0,0,0,0,0
1942804,1565777,2025-05-06,Senate,"Senate - Third Reading",27,1,2,0,30
1942804,1567046,2025-05-07,House,"House - Concurrence",0,0,0,0,0
1942804,1567494,2025-05-07,House,"House - Third Reading",57,0,3,0,60
1942881,1482165,2025-02-05,Senate,"Senate Health and Human Services Committee Action (DP)",6,1,0,0,7
1942881,1485557,2025-02-10,Senate,"Senate Rules Committee Action (PFC)",0,0,0,0,0
1942881,1501273,2025-02-27,Senate,"Senate - Committee of the Whole (DP)",0,0,0,0,0
1942881,1504554,2025-03-04,Senate,"Senate - Third Reading",20,7,3,0,30
1942881,1519091,2025-03-17,House,"House Health & Human Services Committee Action (DP)",12,0,0,0,12
1942881,1532424,2025-04-01,House,"House Rules Committee Action (C&P)",7,0,0,1,8
1942881,1538658,2025-04-07,House,"House - Committee of the Whole (DP)",0,0,0,0,0
1942881,1548787,2025-04-15,House,"House - Third Reading",42,10,8,0,60
1942890,1480692,2025-02-05,Senate,"Senate Government Committee Action (DP)",4,3,0,0,7
1942890,1484936,2025-02-10,Senate,"Senate Rules Committee Action (PFC)",4,2,1,0,7
1942890,1495041,2025-02-20,Senate,"Senate - Committee of the Whole (DPA)",0,0,0,0,0
1942890,1495042,2025-02-20,Senate,"Senate - Third Reading",17,12,1,0,30
1942900,1487249,2025-02-11,House,"House Natural Resources, Energy & Water Committee Action (HELD)",0,0,0,0,0
1942900,1492877,2025-02-18,House,"House Natural Resources, Energy & Water Committee Action (DPA)",6,4,0,0,10
1942900,1497428,2025-02-24,House,"House Rules Committee Action (C&P)",7,0,0,1,8
1942900,1499881,2025-02-26,House,"House - Committee of the Whole (DPA)",0,0,0,0,0
1942900,1514486,2025-03-11,House,"Motion Motion by Representative Carbone that pursuant to House Rule 12(P), HCR2046 be calendared for an Additional Committee of the Whole for purposes of further amending. Motion passed v/v.",0,0,0,0,0
1942900,1514487,2025-03-11,House,"House - Committee of the Whole (DPA)",0,0,0,0,0
1942900,1516308,2025-03-12,House,"House - Third Reading",32,23,5,0,60
1942900,1527259,2025-03-25,Senate,"Senate Natural Resources Committee Action (DP)",4,3,1,0,8
1942900,1531173,2025-03-31,Senate,"Senate Rules Committee Action (PFC)",0,0,0,0,0
1942900,1557022,2025-04-24,Senate,"Senate - Committee of the Whole (DP)",0,0,0,0,0
1942900,1565882,2025-05-06,Senate,"Senate - Third Reading",17,11,2,0,30
1942912,1489183,2025-02-12,Senate,"Senate Public Safety Committee Action (DP)",5,0,2,0,7
1942912,1491148,2025-02-17,Senate,"Senate Rules Committee Action (PFC)",0,0,0,0,0
1942912,1499131,2025-02-25,Senate,"Senate - Committee of the Whole (DP)",0,0,0,0,0
1942912,1500845,2025-02-26,Senate,"Senate - Third Reading",22,7,1,0,30
1942912,1516750,2025-03-12,House,"House Transportation & Infrastructure Committee Action (DP)",6,0,0,1,7
1942912,1519148,2025-03-17,House,"House Rules Committee Action (C&P)",8,0,0,0,8
1942912,1522068,2025-03-19,House,"House - Third Reading",45,12,3,0,60
1942921,1490431,2025-02-14,House,"House Natural Resources, Energy & Water Committee Action (DPA)",9,0,0,1,10
1942921,1497325,2025-02-24,House,"House Rules Committee Action (C&P)",7,0,0,1,8
1942921,1501057,2025-02-27,House,"House - Committee of the Whole (DPA)",0,0,0,0,0
1942921,1509305,2025-03-10,House,"House - Third Reading",50,6,4,0,60
1942921,1527274,2025-03-25,Senate,"Senate Natural Resources Committee Action (DP)",7,0,1,0,8
1942921,1531202,2025-03-31,Senate,"Senate Rules Committee Action (PFC)",0,0,0,0,0
1942921,1555570,2025-04-23,Senate,"Senate - Committee of the Whole (DP)",0,0,0,0,0
1942921,1562147,2025-04-30,Senate,"Senate - Third Reading",27,0,3,0,30
1942947,1488605,2025-02-12,Senate,"Senate Public Safety Committee Action (DP)",6,0,1,0,7
1942947,1491428,2025-02-17,Senate,"Senate Rules Committee Action (PFC)",0,0,0,0,0
1942947,1499250,2025-02-25,Senate,"Senate - Committee of the Whole (DPA)",0,0,0,0,0
1942947,1500353,2025-02-26,Senate,"Senate - Third Reading",29,0,1,0,30
1942947,1516217,2025-03-12,House,"House Transportation & Infrastructure Committee Action (DP)",6,0,0,1,7
1942947,1519232,2025-03-17,House,"House Rules Committee Action (C&P)",8,0,0,0,8
1942947,1524805,2025-03-24,House,"House - Third Reading",55,2,3,0,60
1942955,1491660,2025-02-17,House,"House Public Safety & Law Enforcement Committee Action (HELD)",0,0,0,0,0
1942955,1496022,2025-02-20,House,"House Public Safety & Law Enforcement Committee Action (DP)",13,0,0,2,15
1942955,1497403,2025-02-24,House,"House Rules Committee Action (C&P)",7,0,0,1,8
1942955,1500387,2025-02-26,House,"House - Third Reading",59,0,1,0,60
1942955,1522196,2025-03-19,Senate,"Senate Public Safety Committee Action (DP)",5,0,2,0,7
1942955,1525240,2025-03-24,Senate,"Senate Rules Committee Action (PFC)",0,0,0,0,0
1942955,1564420,2025-05-01,Senate,"Senate - Third Reading",11,11,8,0,30
1942955,1566335,2025-05-06,Senate,"Senate - Reconsider Third Reading",0,0,0,0,0
1942955,1566336,2025-05-06,Senate,"Senate - Third Reading",24,4,2,0,30
1942964,1488602,2025-02-12,Senate,"Senate Public Safety Committee Action (DP)",6,0,1,0,7
1942964,1492626,2025-02-18,Senate,"Senate Appropriations Committee Action (DP)",9,0,1,0,10
1942964,1497540,2025-02-24,Senate,"Senate Rules Committee Action (PFC)",0,0,0,0,0
1942964,1501300,2025-02-27,Senate,"Senate - Third Reading",24,5,1,0,30
1942964,1518599,2025-03-17,House,"House Public Safety & Law Enforcement Committee Action (DP)",9,4,1,1,15
1942964,1528073,2025-03-26,House,"House Appropriations Committee Action (DP)",14,3,0,1,18
1942975,1485209,2025-02-10,Senate,"Senate Finance Committee Action (DP)",4,3,0,0,7
1942975,1491617,2025-02-17,Senate,"Senate Rules Committee Action (PFC)",0,0,0,0,0
1942975,1499355,2025-02-25,Senate,"Senate - Committee of the Whole (DP)",0,0,0,0,0
1942975,1500257,2025-02-26,Senate,"Senate - Third Reading",17,12,1,0,30
1942975,1527902,2025-03-26,House,"House Ways & Means Committee Action (DP)",5,2,0,2,9
1942989,1487204,2025-02-11,Senate,"Senate Natural Resources Committee Action (HELD)",0,0,0,0,0
1942989,1492946,2025-02-18,Senate,"Senate Natural Resources Committee Action (DP)",4,3,1,0,8
1942989,1498396,2025-02-24,Senate,"Senate Rules Committee Action (PFC)",0,0,0,0,0
1942989,1507508,2025-03-06,Senate,"Senate - Committee of the Whole (RETAINED)",0,0,0,0,0
1943008,1480047,2025-02-04,House,"House Natural Resources, Energy & Water Committee Action (DP)",6,4,0,0,10
1943008,1484965,2025-02-10,House,"House Rules Committee Action (C&P)",8,0,0,0,8
1943008,1492527,2025-02-18,House,"House - Committee of the Whole (DPA)",0,0,0,0,0
1943008,1495828,2025-02-20,House,"House - Third Reading",35,24,1,0,60
1943008,1514682,2025-03-11,Senate,"Senate Natural Resources Committee Action (DP)",5,2,1,0,8
1943008,1518901,2025-03-17,Senate,"Senate Rules Committee Action (PFC)",0,0,0,0,0
1943008,1565960,2025-05-06,Senate,"Senate - Third Reading",17,11,2,0,30
1943032,1487969,2025-02-12,Senate,"Senate Judiciary and Elections Committee Action (DPA)",4,2,1,0,7
1943032,1490886,2025-02-17,Senate,"Senate Rules Committee Action (PFC)",0,0,0,0,0
1943032,1499143,2025-02-25,Senate,"Senate - Committee of the Whole (DPA)",0,0,0,0,0
1943032,1500284,2025-02-26,Senate,"Senate - Third Reading",17,12,1,0,30
1943032,1515794,2025-03-12,House,"House Judiciary Committee Action (HELD)",0,0,0,0,0
1943032,1521009,2025-03-19,House,"House Judiciary Committee Action (DP)",7,1,1,0,9
1943032,1547302,2025-04-14,House,"House Rules Committee Action (C&P)",8,0,0,0,8
1943032,1558869,2025-04-28,House,"House - Committee of the Whole (DP)",0,0,0,0,0
1943032,1565001,2025-05-05,House,"House - Third Reading",34,23,3,0,60
1943040,1493500,2025-02-19,Senate,"Senate Health and Human Services Committee Action (DP)",7,0,0,0,7
1943040,1499398,2025-02-25,Senate,"Senate Appropriations Committee Action (DPA)",10,0,0,0,10
1943040,1503180,2025-03-03,Senate,"Senate Rules Committee Action (PFC)",0,0,0,0,0
1943040,1507642,2025-03-06,Senate,"Senate - Committee of the Whole (DPA)",0,0,0,0,0
1943040,1517314,2025-03-13,Senate,"Senate - Third Reading",24,3,3,0,30
1943040,1525088,2025-03-24,House,"House Health & Human Services Committee Action (DP)",11,0,0,1,12
1943040,1531204,2025-03-31,House,"House Appropriations Committee Action (DP)",16,2,0,0,18
1943054,1486908,2025-02-11,Senate,"Senate Natural Resources Committee Action (DP)",5,3,0,0,8
1943054,1490981,2025-02-17,Senate,"Senate Rules Committee Action (PFC)",0,0,0,0,0
1943054,1499199,2025-02-25,Senate,"Senate - Committee of the Whole (DP)",0,0,0,0,0
1943054,1500338,2025-02-26,Senate,"Senate - Third Reading",17,12,1,0,30
1943054,1514471,2025-03-11,House,"House Natural Resources, Energy & Water Committee Action (DP)",5,4,0,1,10
1943054,1518798,2025-03-17,House,"House Rules Committee Action (C&P)",8,0,0,0,8
1943054,1521341,2025-03-19,House,"House - Committee of the Whole (DPA)",0,0,0,0,0
1943054,1531167,2025-03-31,House,"House - Third Reading",31,25,4,0,60
1943054,1548851,2025-04-15,Senate,"Senate - Concurrence",0,0,0,0,0
1943054,1548852,2025-04-15,Senate,"Senate - Third Reading",17,13,0,0,30
1943064,1486819,2025-02-11,Senate,"Senate Appropriations Committee Action (DP)",9,0,1,0,10
1943064,1490968,2025-02-17,Senate,"Senate Rules Committee Action (PFC)",0,0,0,0,0
1943064,1501280,2025-02-27,Senate,"Senate - Third Reading",27,2,1,0,30
1943064,1520894,2025-03-19,House,"House Judiciary Committee Action (DP)",7,0,1,1,9
1943073,1488265,2025-02-12,Senate,"Senate Government Committee Action (DP)",4,3,0,0,7
1943073,1491194,2025-02-17,Senate,"Senate Rules Committee Action (PFC)",0,0,0,0,0
1943081,1495947,2025-02-20,Senate,"Senate Regulatory Affairs and Government Efficiency Committee Action (DP)",6,1,0,0,7
1943081,1498404,2025-02-24,Senate,"Senate Rules Committee Action (PFC)",0,0,0,0,0
1943081,1501455,2025-02-27,Senate,"Senate - Committee of the Whole (RETAINED)",0,0,0,0,0
1943081,1503500,2025-03-03,Senate,"Senate - Committee of the Whole (RETAINED)",0,0,0,0,0
1943081,1507389,2025-03-06,Senate,"Senate - Committee of the Whole (DPA)",0,0,0,0,0
1943081,1517154,2025-03-13,Senate,"Senate - Third Reading",27,1,2,0,30
1943081,1528104,2025-03-26,House,"House Transportation & Infrastructure Committee Action (DP)",4,0,2,1,7
1943081,1547273,2025-04-14,House,"House Rules Committee Action (C&P)",8,0,0,0,8
1943081,1552543,2025-04-21,House,"Motion Motion by Representative Carbone that pursuant to House Rule 12(P), SB1307 be calendared for an Additional Committee of the Whole for purposes of further amending. Motion passed v/v.",0,0,0,0,0
1943081,1552544,2025-04-21,House,"House - Committee of the Whole (DPA)",0,0,0,0,0
1943081,1563753,2025-05-01,House,"House - Third Reading",44,12,4,0,60
1943081,1567434,2025-05-07,Senate,"Senate - Concurrence",0,0,0,0,0
1943081,1567435,2025-05-07,Senate,"Senate - Third Reading",25,1,4,0,30
1943094,1479019,2025-02-03,House,"House Health & Human Services Committee Action (DP)",9,3,0,0,12
1943094,1485011,2025-02-10,House,"House Rules Committee Action (C&P)",8,0,0,0,8
1943094,1491289,2025-02-17,House,"House - Third Reading",39,20,1,0,60
1943094,1521015,2025-03-19,Senate,"Senate Health and Human Services Committee Action (DPA)",4,3,0,0,7
1943094,1524785,2025-03-24,Senate,"Senate Rules Committee Action (PFC)",0,0,0,0,0
1943094,1543967,2025-04-10,Senate,"Senate - Committee of the Whole (DPA)",0,0,0,0,0
1943094,1549698,2025-04-16,Senate,"Senate - Third Reading",16,14,0,0,30
1943094,1558975,2025-04-28,House,"House - Concurrence",0,0,0,0,0
1943094,1558976,2025-04-28,House,"House - Third Reading",32,23,5,0,60
1943107,1488092,2025-02-12,Senate,"Senate Judiciary and Elections Committee Action (DPA)",6,0,1,0,7
1943107,1490864,2025-02-17,Senate,"Senate Rules Committee Action (PFC)",0,0,0,0,0
1943107,1501196,2025-02-27,Senate,"Senate - Committee of the Whole (RETAINED)",0,0,0,0,0
1943107,1501197,2025-02-27,Senate,"Senate - Committee of the Whole (DPA)",0,0,0,0,0
1943107,1504555,2025-03-04,Senate,"Senate - Third Reading",26,1,3,0,30
1943107,1521531,2025-03-19,House,"House Federalism, Military Affairs & Elections Committee Action (HELD)",4,1,1,1,7
1943107,1524292,2025-03-20,House,"House Federalism, Military Affairs & Elections Committee Action (W/D)",4,1,1,1,7
1943107,1527714,2025-03-26,House,"House Government Committee Action (HELD)",0,0,0,0,0
1943107,1530310,2025-03-27,House,"House Government Committee Action (DP)",5,2,0,0,7
1943107,1547292,2025-04-14,House,"House Rules Committee Action (C&P)",8,0,0,0,8
1943107,1563975,2025-05-01,House,"House - Third Reading",43,15,2,0,60
1943116,1479080,2025-02-03,House,"House Land, Agriculture & Rural Affairs Committee Action (DP)",6,2,0,1,9
1943137,1480541,2025-02-05,Senate,"Senate Health and Human Services Committee Action (DPA)",6,0,1,0,7
1943137,1485142,2025-02-10,Senate,"Senate Rules Committee Action (PFC)",0,0,0,0,0
1943137,1503309,2025-03-03,Senate,"Senate - Committee of the Whole (DPA)",0,0,0,0,0
1943137,1506410,2025-03-05,Senate,"Senate - Third Reading",28,1,1,0,30
1943137,1519074,2025-03-17,House,"House Health & Human Services Committee Action (DP)",12,0,0,0,12
1943137,1524888,2025-03-24,House,"House Rules Committee Action (C&P)",8,0,0,0,8
1943137,1558911,2025-04-28,House,"House - Third Reading",42,14,4,0,60
1943146,1485374,2025-02-10,Senate,"Senate Finance Committee Action (DP)",4,3,0,0,7
1943146,1490987,2025-02-17,Senate,"Senate Rules Committee Action (PFC)",0,0,0,0,0
1943146,1499163,2025-02-25,Senate,"Senate - Committee of the Whole (DP)",0,0,0,0,0
1943146,1500343,2025-02-26,Senate,"Senate - Third Reading",17,10,3,0,30
1943146,1527529,2025-03-26,House,"House Ways & Means Committee Action (DP)",5,2,0,2,9
1943152,1480755,2025-02-05,Senate,"Senate Health and Human Services Committee Action (DP)",6,0,1,0,7
1943152,1486468,2025-02-11,Senate,"Senate Appropriations Committee Action (DP)",10,0,0,0,10
1943152,1490914,2025-02-17,Senate,"Senate Rules Committee Action (PFC)",0,0,0,0,0
1943152,1501621,2025-02-27,Senate,"Senate - Third Reading",26,3,1,0,30
1943152,1509729,2025-03-10,House,"House Health & Human Services Committee Action (DP)",10,1,0,1,12
1943152,1528046,2025-03-26,House,"House Appropriations Committee Action (DP)",15,2,0,1,18
1943829,1492362,2025-02-18,House,"House Commerce Committee Action (DPA)",10,0,0,0,10
1943829,1497318,2025-02-24,House,"House Rules Committee Action (C&P)",7,0,0,1,8
1943829,1499981,2025-02-26,House,"House - Committee of the Whole (RET ON CAL)",0,0,0,0,0
1943829,1501463,2025-02-27,House,"House - Committee of the Whole (DPA)",0,0,0,0,0
1943829,1504539,2025-03-04,House,"House - Third Reading",55,3,2,0,60
1943888,1482362,2025-02-05,House,"House Transportation & Infrastructure Committee Action (DPA)",4,2,1,0,7
1943888,1484942,2025-02-10,House,"House Rules Committee Action (C&P)",8,0,0,0,8
1943888,1493367,2025-02-19,House,"House - Committee of the Whole (DPA)",0,0,0,0,0
1943888,1506253,2025-03-05,House,"Motion Motion by Representative Carbone that pursuant to House Rule 12(P), HB2696 be calendared for an Additional Committee of the Whole for purposes of further amending. Motion passed v/v.

",0,0,0,0,0
1943888,1506254,2025-03-05,House,"House - Committee of the Whole (DPA)",0,0,0,0,0
1943888,1509610,2025-03-10,House,"House - Third Reading",32,24,4,0,60
1943888,1528064,2025-03-26,Senate,"Senate Public Safety Committee Action (DP)",5,2,0,0,7
1943942,1487431,2025-02-12,Senate,"Senate Government Committee Action (DP)",4,3,0,0,7
1943942,1490965,2025-02-17,Senate,"Senate Rules Committee Action (PFC)",0,0,0,0,0
1943942,1499103,2025-02-25,Senate,"Senate - Committee of the Whole (DP)",0,0,0,0,0
1943942,1500202,2025-02-26,Senate,"Senate - Third Reading",17,12,1,0,30
1943942,1528145,2025-03-26,House,"House Science & Technology Committee Action (FAILED)",3,4,0,2,9
1943942,1528146,2025-03-26,House,"House Science & Technology Committee Action (DP ON RECON)",4,3,0,2,9
1943942,1532462,2025-04-01,House,"House Rules Committee Action (C&P)",7,0,0,1,8
1943942,1541942,2025-04-09,House,"House - Committee of the Whole (DP)",0,0,0,0,0
1943942,1565135,2025-05-05,House,"House - Third Reading",33,24,3,0,60
1943970,1487521,2025-02-12,Senate,"Senate Health and Human Services Committee Action (DP)",7,0,0,0,7
1943970,1490994,2025-02-17,Senate,"Senate Rules Committee Action (PFC)",0,0,0,0,0
1943970,1501291,2025-02-27,Senate,"Senate - Third Reading",25,4,1,0,30
1943970,1520472,2025-03-18,House,"House Health & Human Services Committee Action (W/D)",0,0,0,0,0
1943970,1527282,2025-03-26,House,"House Government Committee Action (DPA/SE)",6,1,0,0,7
1943970,1547267,2025-04-14,House,"House Rules Committee Action (C&P)",8,0,0,0,8
1943970,1549951,2025-04-16,House,"House - Committee of the Whole (DPA)",0,0,0,0,0
1943970,1559206,2025-04-28,House,"House - Third Reading",45,11,4,0,60
1943996,1482180,2025-02-05,Senate,"Senate Government Committee Action (DP)",4,3,0,0,7
1943996,1485739,2025-02-10,Senate,"Senate Rules Committee Action (PFC)",0,0,0,0,0
1943996,1495323,2025-02-20,Senate,"Senate - Committee of the Whole (DP)",0,0,0,0,0
1943996,1495324,2025-02-20,Senate,"Senate - Third Reading",18,11,1,0,30
1944023,1477239,2025-01-30,House,"House Transportation & Infrastructure Committee Action (W/D)",0,0,0,0,0
1944076,1487439,2025-02-12,Senate,"Senate Government Committee Action (DPA)",7,0,0,0,7
1944076,1491624,2025-02-17,Senate,"Senate Rules Committee Action (PFC)",0,0,0,0,0
1944076,1499456,2025-02-25,Senate,"Senate - Committee of the Whole (DPA)",0,0,0,0,0
1944076,1500947,2025-02-26,Senate,"Senate - Third Reading",28,0,2,0,30
1944106,1488112,2025-02-12,Senate,"Senate Judiciary and Elections Committee Action (DPA)",4,2,1,0,7
1944106,1490905,2025-02-17,Senate,"Senate Rules Committee Action (PFC)",0,0,0,0,0
1944106,1499158,2025-02-25,Senate,"Senate - Committee of the Whole (DPA)",0,0,0,0,0
1944106,1506228,2025-03-05,Senate,"Senate - Committee of the Whole (RETAINED)",0,0,0,0,0
1944132,1485436,2025-02-10,Senate,"Senate Finance Committee Action (DP)",4,3,0,0,7
1944132,1491557,2025-02-17,Senate,"Senate Rules Committee Action (PFC)",0,0,0,0,0
1944132,1499590,2025-02-25,Senate,"Senate - Committee of the Whole (DP)",0,0,0,0,0
1944132,1500921,2025-02-26,Senate,"Senate - Third Reading",17,12,1,0,30
1944132,1516077,2025-03-12,House,"House Ways & Means Committee Action (DP)",5,4,0,0,9
1944158,1492558,2025-02-18,House,"House Education Committee Action (DP)",6,5,0,1,12
1944158,1497390,2025-02-24,House,"House Rules Committee Action (C&P)",7,0,0,1,8
1944158,1501543,2025-02-27,House,"House - Committee of the Whole (DP)",0,0,0,0,0
1944158,1506353,2025-03-05,House,"House - Third Reading",32,25,3,0,60
1944158,1528256,2025-03-26,Senate,"Senate Education Committee Action (DP)",4,3,0,0,7
1944158,1530861,2025-03-31,Senate,"Senate Rules Committee Action (PFC)",0,0,0,0,0
1944158,1545597,2025-03-26,Senate,"Senate Education-Archived and Renamed Education and Transportation as of 04/01/2025 Committee Action (DP)",4,3,0,0,7
1944158,1565994,2025-05-06,Senate,"Senate - Committee of the Whole (DP)",0,0,0,0,0
1944158,1565995,2025-05-06,Senate,"Senate - Third Reading",17,11,2,0,30
1944215,1493480,2025-02-19,Senate,"Senate Health and Human Services Committee Action (DP)",7,0,0,0,7
1944215,1497582,2025-02-24,Senate,"Senate Rules Committee Action (PFC)",0,0,0,0,0
1944215,1507705,2025-03-06,Senate,"Senate - Committee of the Whole (DPA)",0,0,0,0,0
1944215,1516972,2025-03-13,Senate,"Senate - Third Reading",28,0,2,0,30
1944215,1525038,2025-03-24,House,"House Health & Human Services Committee Action (DPA)",11,0,0,1,12
1944215,1532449,2025-04-01,House,"House Rules Committee Action (C&P)",7,0,0,1,8
1944215,1536098,2025-04-03,House,"House - Committee of the Whole (DPA)",0,0,0,0,0
1944215,1541854,2025-04-09,House,"House - Third Reading",44,11,5,0,60
1944215,1548376,2025-04-15,Senate,"Senate - Concurrence",0,0,0,0,0
1944215,1548943,2025-04-15,Senate,"Senate - Third Reading",29,1,0,0,30
1944242,1488047,2025-02-12,Senate,"Senate Education Committee Action (DP)",4,3,0,0,7
1944242,1490988,2025-02-17,Senate,"Senate Rules Committee Action (PFC)",0,0,0,0,0
1944242,1499210,2025-02-25,Senate,"Senate - Committee of the Whole (DP)",0,0,0,0,0
1944242,1545900,2025-02-12,Senate,"Senate Education-Archived and Renamed Education and Transportation as of 04/01/2025 Committee Action (DP)",4,3,0,0,7
1944266,1492621,2025-02-18,House,"House Education Committee Action (DPA/SE)",6,2,4,0,12
1944266,1498562,2025-02-25,House,"House Rules Committee Action (C&P)",7,0,0,1,8
1944400,1494578,2025-02-19,Senate,"Senate Education Committee Action (DPA/SE)",4,3,0,0,7
1944400,1497558,2025-02-24,Senate,"Senate Rules Committee Action (PFC)",0,0,0,0,0
1944400,1545612,2025-02-19,Senate,"Senate Education-Archived and Renamed Education and Transportation as of 04/01/2025 Committee Action (DPA/SE)",4,3,0,0,7
1944455,1485482,2025-02-10,Senate,"Senate Military Affairs and Border Security Committee Action (DP)",7,0,0,0,7
1944455,1490846,2025-02-17,Senate,"Senate Rules Committee Action (PFC)",0,0,0,0,0
1944455,1506089,2025-03-05,Senate,"Senate - Committee of the Whole (DPA)",0,0,0,0,0
1944455,1507769,2025-03-06,Senate,"Senate - Third Reading",23,2,5,0,30
1944455,1528332,2025-03-26,House,"House Transportation & Infrastructure Committee Action (DP)",5,0,1,1,7
1944455,1547889,2025-04-14,House,"House Rules Committee Action (C&P)",8,0,0,0,8
1944455,1552739,2025-04-21,House,"House - Committee of the Whole (DPA)",0,0,0,0,0
1944455,1559112,2025-04-28,House,"Motion Motion by Representative Willoughby that pursuant to House Rule 12(P), SB1332 be calendared for an Additional Committee of the Whole for purposes of further amending. Motion passed v/v.",0,0,0,0,0
1944455,1559113,2025-04-28,House,"House - Committee of the Whole (DPA)",0,0,0,0,0
1944455,1559114,2025-04-28,House,"House - Motion Representative Kolodin  to show the bill do not pass - failed by s/v 7-42",0,0,0,0,0
1944455,1564404,2025-05-01,House,"House - Third Reading",42,13,5,0,60
1944480,1477853,2025-01-30,House,"House Transportation & Infrastructure Committee Action (W/D)",0,0,0,0,0
1944531,1488070,2025-02-12,House,"House Judiciary Committee Action (DPA)",6,3,0,0,9
1944531,1491467,2025-02-17,House,"House Rules Committee Action (C&P)",7,0,0,1,8
1944531,1498620,2025-02-25,House,"House - Committee of the Whole (DPA)",0,0,0,0,0
1944531,1500183,2025-02-26,House,"House - Third Reading",33,27,0,0,60
1944590,1479795,2025-02-04,House,"House Commerce Committee Action (DPA)",8,1,1,0,10
1944590,1485026,2025-02-10,House,"House Rules Committee Action (C&P)",8,0,0,0,8
1944590,1499083,2025-02-25,House,"House - Committee of the Whole (DPA)",0,0,0,0,0
1944590,1500200,2025-02-26,House,"House - Third Reading",35,25,0,0,60
1944590,1525794,2025-03-24,Senate,"Senate Finance Committee Action (DPA)",4,3,0,0,7
1944612,1482158,2025-02-05,Senate,"Senate Regulatory Affairs and Government Efficiency Committee Action (DPA)",4,3,0,0,7
1944612,1485622,2025-02-10,Senate,"Senate Rules Committee Action (PFC)",0,0,0,0,0
1944612,1497917,2025-02-24,Senate,"Senate - Committee of the Whole (RETAINED)",0,0,0,0,0
1944612,1503811,2025-03-03,Senate,"Senate - Committee of the Whole (DPA)",0,0,0,0,0
1944612,1517603,2025-03-13,Senate,"Senate - Committee of the Whole (DPA)",0,0,0,0,0
1944612,1519162,2025-03-17,Senate,"Senate - Third Reading",17,10,2,0,29
1944612,1527174,2025-03-25,House,"House Commerce Committee Action (DPA)",6,3,0,1,10
1944612,1547290,2025-04-14,House,"House Rules Committee Action (C&P)",8,0,0,0,8
1944612,1550006,2025-04-16,House,"House - Committee of the Whole (DPA)",0,0,0,0,0
1944612,1567301,2025-05-07,House,"House - Third Reading",44,14,2,0,60
1944612,1567302,2025-05-07,Senate,"Senate - Concurrence",0,0,0,0,0
1944612,1567303,2025-05-07,Senate,"Senate - Third Reading",23,3,4,0,30
1944636,1482370,2025-02-05,Senate,"Senate Regulatory Affairs and Government Efficiency Committee Action (DPA)",5,2,0,0,7
1944636,1484961,2025-02-10,Senate,"Senate Rules Committee Action (PFC)",4,2,1,0,7
1944657,1488093,2025-02-12,Senate,"Senate Education Committee Action (DP)",6,0,1,0,7
1944657,1490871,2025-02-17,Senate,"Senate Rules Committee Action (PFC)",0,0,0,0,0
1944657,1499165,2025-02-25,Senate,"Senate - Committee of the Whole (DP)",0,0,0,0,0
1944657,1500293,2025-02-26,Senate,"Senate - Third Reading",28,0,2,0,30
1944657,1520029,2025-03-18,House,"House Education Committee Action (DPA)",11,0,0,1,12
1944657,1524860,2025-03-24,House,"House Rules Committee Action (C&P)",8,0,0,0,8
1944657,1528742,2025-03-27,House,"House - Committee of the Whole (DPA)",0,0,0,0,0
1944657,1545868,2025-02-12,Senate,"Senate Education-Archived and Renamed Education and Transportation as of 04/01/2025 Committee Action (DP)",6,0,1,0,7
1944657,1547373,2025-04-14,House,"House - Third Reading",55,0,5,0,60
1944657,1560175,2025-04-29,Senate,"Senate - Concurrence",0,0,0,0,0
1944657,1560176,2025-04-29,Senate,"Senate - Third Reading",29,0,1,0,30
1944680,1488027,2025-02-12,Senate,"Senate Judiciary and Elections Committee Action (HELD)",0,0,0,0,0
1944680,1490754,2025-02-12,Senate,"Senate Judiciary and Elections Committee Action (DISC/HELD)",0,0,0,0,0
1944705,1495484,2025-02-19,Senate,"Senate Education Committee Action (DP)",4,3,0,0,7
1944705,1499502,2025-02-25,Senate,"Senate Appropriations Committee Action (DP)",6,4,0,0,10
1944705,1503620,2025-03-03,Senate,"Senate Rules Committee Action (PFC)",0,0,0,0,0
1944705,1509666,2025-03-10,Senate,"Senate - Committee of the Whole (DPA)",0,0,0,0,0
1944705,1517586,2025-03-13,Senate,"Senate - Third Reading",17,10,3,0,30
1944705,1526330,2025-03-25,House,"House Education Committee Action (HELD)",0,0,0,0,0
1944705,1529561,2025-03-26,House,"House Education Committee Action (W/D)",0,0,0,0,0
1944705,1546513,2025-02-19,Senate,"Senate Education-Archived and Renamed Education and Transportation as of 04/01/2025 Committee Action (DP)",4,3,0,0,7
1944728,1488627,2025-02-12,Senate,"Senate Public Safety Committee Action (DP)",7,0,0,0,7
1944728,1491214,2025-02-17,Senate,"Senate Rules Committee Action (PFC)",0,0,0,0,0
1944728,1501353,2025-02-27,Senate,"Senate - Third Reading",25,4,1,0,30
1944728,1521875,2025-03-19,House,"House Transportation & Infrastructure Committee Action (DP)",6,0,0,1,7
1944728,1547896,2025-04-14,House,"House Rules Committee Action (C&P)",8,0,0,0,8
1944728,1563723,2025-05-01,House,"House - Third Reading",37,17,6,0,60
1944752,1487556,2025-02-12,Senate,"Senate Health and Human Services Committee Action (HELD)",0,0,0,0,0
1944752,1493450,2025-02-19,Senate,"Senate Health and Human Services Committee Action (DPA)",6,1,0,0,7
1944752,1497538,2025-02-24,Senate,"Senate Rules Committee Action (PFC)",0,0,0,0,0
1944752,1503312,2025-03-03,Senate,"Senate - Committee of the Whole (DPA)",0,0,0,0,0
1944752,1506501,2025-03-05,Senate,"Senate - Third Reading",18,11,1,0,30
1944752,1528384,2025-03-26,House,"House Transportation & Infrastructure Committee Action (DPA/SE)",4,2,0,1,7
1944775,1493719,2025-02-19,Senate,"Senate Government Committee Action (HELD)",0,0,0,0,0
1944775,1496653,2025-02-20,Senate,"Senate Government Committee Action (DP)",5,1,1,0,7
1944775,1498219,2025-02-24,Senate,"Senate Rules Committee Action (PFC)",0,0,0,0,0
1944822,1479132,2025-02-03,House,"House Federalism, Military Affairs & Elections Committee Action (DPA)",4,3,0,0,7
1944822,1479638,2025-02-04,House,"House - Committee of the Whole (RET ON CAL)",0,0,0,0,0
1944822,1482635,2025-02-04,House,"House Rules Committee Action (C&P)",5,0,0,3,8
1944822,1486544,2025-02-11,House,"House - Committee of the Whole (DPA)",0,0,0,0,0
1944822,1486545,2025-02-11,House,"House - Representative Garcia to include the Garcia SUB floor amendment",26,32,2,0,60
1944822,1487656,2025-02-12,House,"House - Motion Motion by Representative Carbone that pursuant to House Rule 12(P), HB2703 be calendared for an Additional Committee of the Whole for purposes of further amending. Motion passed v/v.",0,0,0,0,0
1944822,1487657,2025-02-12,House,"House - Committee of the Whole (DPA)",0,0,0,0,0
1944822,1487658,2025-02-12,House,"House - Representative Garcia motion to amend the additional COW report to include Garcia Floor amendment and exclude Kolodin SUB floor amendment",27,32,1,0,60
1944822,1487659,2025-02-12,House,"House - Third Reading",32,27,1,0,60
1944822,1489029,2025-02-13,Senate,"Motion HB 2703 substituted for SB 1011. Motion carried.",0,0,0,0,0
1944822,1489031,2025-02-13,Senate,"Senate - Third Reading",16,10,4,0,30
1944844,1488105,2025-02-12,Senate,"Senate Judiciary and Elections Committee Action (DP)",6,0,1,0,7
1944844,1490903,2025-02-17,Senate,"Senate Rules Committee Action (PFC)",0,0,0,0,0
1944844,1501608,2025-02-27,Senate,"Senate - Third Reading",29,0,1,0,30
1944844,1527292,2025-03-26,House,"House Government Committee Action (DP)",7,0,0,0,7
1944844,1547285,2025-04-14,House,"House Rules Committee Action (C&P)",8,0,0,0,8
1944844,1561910,2025-04-30,House,"House - Third Reading",52,0,8,0,60
1944869,1495525,2025-02-20,Senate,"Senate Regulatory Affairs and Government Efficiency Committee Action (DPA)",7,0,0,0,7
1944869,1497594,2025-02-24,Senate,"Senate Rules Committee Action (PFC)",0,0,0,0,0
1944869,1509176,2025-03-10,Senate,"Senate - Committee of the Whole (DPA)",0,0,0,0,0
1944869,1517012,2025-03-13,Senate,"Senate - Third Reading",17,11,2,0,30
1944869,1531499,2025-03-31,House,"House Appropriations Committee Action (DPA)",11,7,0,0,18
1944891,1480613,2025-02-05,Senate,"Senate Government Committee Action (DP)",4,3,0,0,7
1944891,1484781,2025-02-10,Senate,"Senate Rules Committee Action (PFC)",0,0,0,0,0
1944891,1494846,2025-02-20,Senate,"Senate - Committee of the Whole (DP)",0,0,0,0,0
1944891,1494847,2025-02-20,Senate,"Senate - Third Reading",17,12,1,0,30
1944914,1493412,2025-02-19,Senate,"Senate Health and Human Services Committee Action (DP)",7,0,0,0,7
1944914,1499362,2025-02-25,Senate,"Senate Appropriations Committee Action (DP)",8,2,0,0,10
1944914,1503517,2025-03-03,Senate,"Senate Rules Committee Action (PFC)",0,0,0,0,0
1944914,1507487,2025-03-06,Senate,"Senate - Committee of the Whole (DPA)",0,0,0,0,0
1944914,1517291,2025-03-13,Senate,"Senate - Third Reading",21,6,3,0,30
1944914,1525107,2025-03-24,House,"House Health & Human Services Committee Action (DPA)",10,1,0,1,12
1944914,1547325,2025-04-14,House,"House Rules Committee Action (C&P)",8,0,0,0,8
1944914,1553339,2025-04-22,House,"House - Committee of the Whole (DPA)",0,0,0,0,0
1944938,1487511,2025-02-12,Senate,"Senate Health and Human Services Committee Action (DP)",7,0,0,0,7
1944938,1491570,2025-02-17,Senate,"Senate Rules Committee Action (PFC)",0,0,0,0,0
1944938,1503913,2025-03-03,Senate,"Senate - Committee of the Whole (DPA)",0,0,0,0,0
1944938,1505989,2025-03-05,Senate,"Senate - Third Reading",29,0,1,0,30
1944938,1519138,2025-03-17,House,"House Health & Human Services Committee Action (DP)",12,0,0,0,12
1944938,1524904,2025-03-24,House,"House Rules Committee Action (C&P)",8,0,0,0,8
1944938,1547393,2025-04-14,House,"House - Third Reading",55,0,5,0,60
1944960,1482690,2025-02-05,Senate,"Senate Regulatory Affairs and Government Efficiency Committee Action (DP)",7,0,0,0,7
1944960,1484956,2025-02-10,Senate,"Senate Rules Committee Action (PFC)",0,0,0,0,0
1944960,1498248,2025-02-24,Senate,"Senate - Committee of the Whole (DP)",0,0,0,0,0
1944960,1498249,2025-02-24,Senate,"Senate - Third Reading",29,1,0,0,30
1944960,1515838,2025-03-12,House,"House Government Committee Action (DP)",4,3,0,0,7
1944960,1518580,2025-03-17,House,"House Rules Committee Action (C&P)",8,0,0,0,8
1944960,1531434,2025-03-31,House,"House - Committee of the Whole (DPA)",0,0,0,0,0
1944960,1551213,2025-04-16,House,"House - Third Reading",45,13,2,0,60
1944960,1560738,2025-04-29,Senate,"Senate - Concurrence",0,0,0,0,0
1944960,1560739,2025-04-29,Senate,"Senate - Third Reading",28,1,1,0,30
1945030,1487558,2025-02-12,Senate,"Senate Health and Human Services Committee Action (DP)",7,0,0,0,7
1945030,1492633,2025-02-18,Senate,"Senate Appropriations Committee Action (DP)",8,0,2,0,10
1945030,1497534,2025-02-24,Senate,"Senate Rules Committee Action (PFC)",0,0,0,0,0
1945030,1509216,2025-03-10,Senate,"Senate - Third Reading",24,3,3,0,30
1945054,1487591,2025-02-12,Senate,"Senate Health and Human Services Committee Action (DP)",7,0,0,0,7
1945054,1490881,2025-02-17,Senate,"Senate Rules Committee Action (PFC)",0,0,0,0,0
1945054,1501605,2025-02-27,Senate,"Senate - Third Reading",29,0,1,0,30
1945054,1509699,2025-03-10,House,"House Health & Human Services Committee Action (DP)",10,0,0,2,12
1945054,1518756,2025-03-17,House,"House Rules Committee Action (C&P)",8,0,0,0,8
1945054,1525001,2025-03-24,House,"House - Third Reading",51,6,3,0,60
1945076,1493200,2025-02-19,Senate,"Senate Judiciary and Elections Committee Action (W/D)",0,0,0,0,0
1945076,1499427,2025-02-25,Senate,"Senate Appropriations Committee Action (DPA/SE)",10,0,0,0,10
1945076,1503494,2025-03-03,Senate,"Senate Rules Committee Action (PFC)",0,0,0,0,0
1945076,1518541,2025-03-17,Senate,"Senate - Committee of the Whole (DPA)",0,0,0,0,0
1945076,1518542,2025-03-17,Senate,"Senate - Third Reading",24,3,2,0,29
1945076,1525595,2025-03-24,House,"House Land, Agriculture & Rural Affairs Committee Action (DPA/SE)",6,3,0,0,9
1945076,1532451,2025-04-01,House,"House Rules Committee Action (C&P)",7,0,0,1,8
1945076,1536096,2025-04-03,House,"House - Committee of the Whole (RET ON CAL)",0,0,0,0,0
1945076,1550140,2025-04-16,House,"House - Committee of the Whole (DPA)",0,0,0,0,0
1945076,1564124,2025-05-01,House,"House - Third Reading",14,44,2,0,60
1945076,1564125,2025-05-01,House,"House - Reconsider Third Reading",0,0,0,0,0
1945095,1494567,2025-02-19,Senate,"Senate Judiciary and Elections Committee Action (DPA)",4,3,0,0,7
1945095,1497513,2025-02-24,Senate,"Senate Rules Committee Action (PFC)",0,0,0,0,0
1945095,1501247,2025-02-27,Senate,"Senate - Committee of the Whole (DPA)",0,0,0,0,0
1945095,1504424,2025-03-04,Senate,"Senate - Third Reading",16,10,4,0,30
1945095,1527629,2025-03-26,House,"House Judiciary Committee Action (DP)",5,3,1,0,9
1945095,1547333,2025-04-14,House,"House Rules Committee Action (C&P)",8,0,0,0,8
1945095,1567335,2025-05-07,House,"House - Third Reading",33,25,2,0,60
1945914,1485510,2025-02-10,Senate,"Senate Finance Committee Action (W/D)",0,0,0,0,0
1945914,1491805,2025-02-17,Senate,"Senate Military Affairs and Border Security Committee Action (DP)",7,0,0,0,7
1945914,1497848,2025-02-24,Senate,"Senate Rules Committee Action (PFC)",0,0,0,0,0
1946021,1488102,2025-02-12,Senate,"Senate Judiciary and Elections Committee Action (HELD)",0,0,0,0,0
1946041,1491726,2025-02-17,Senate,"Senate Finance Committee Action (DP)",5,2,0,0,7
1946041,1497651,2025-02-24,Senate,"Senate Rules Committee Action (PFC)",0,0,0,0,0
1946041,1501415,2025-02-27,Senate,"Senate - Third Reading",17,12,1,0,30
1946041,1520343,2025-03-18,House,"House Commerce Committee Action (DP)",6,4,0,0,10
1946041,1524893,2025-03-24,House,"House Rules Committee Action (C&P)",8,0,0,0,8
1946041,1533148,2025-04-01,House,"House - Committee of the Whole (DP)",0,0,0,0,0
1946041,1551009,2025-04-17,House,"Motion Motion by Representative Carbone that pursuant to House Rule 12(P), SB1373 be calendared for an Additional Committee of the Whole for purposes of further amending. Motion passed v/v.",0,0,0,0,0
1946041,1551010,2025-04-17,House,"House - Committee of the Whole (DPA)",0,0,0,0,0
1946041,1558978,2025-04-28,House,"House - Third Reading",37,19,4,0,60
1946041,1565555,2025-05-06,Senate,"Senate - Concurrence",0,0,0,0,0
1946041,1565556,2025-05-06,Senate,"Senate - Third Reading",17,11,2,0,30
1946064,1487555,2025-02-12,Senate,"Senate Government Committee Action (DP)",5,2,0,0,7
1946064,1490900,2025-02-17,Senate,"Senate Rules Committee Action (PFC)",0,0,0,0,0
1946064,1499146,2025-02-25,Senate,"Senate - Committee of the Whole (DP)",0,0,0,0,0
1946064,1500266,2025-02-26,Senate,"Senate - Third Reading",21,7,2,0,30
1946064,1520772,2025-03-19,House,"House Government Committee Action (DP)",4,3,0,0,7
1946064,1524815,2025-03-24,House,"House Rules Committee Action (C&P)",8,0,0,0,8
1946064,1533077,2025-04-01,House,"House - Committee of the Whole (DPA)",0,0,0,0,0
1946064,1551353,2025-04-17,House,"House - Third Reading",32,25,3,0,60
1946064,1560289,2025-04-29,Senate,"Senate - Concurrence",0,0,0,0,0
1946064,1560290,2025-04-29,Senate,"Senate - Third Reading",29,0,1,0,30
1946085,1488938,2025-02-12,Senate,"Senate Public Safety Committee Action (DP)",5,0,2,0,7
1946085,1492821,2025-02-18,Senate,"Senate Appropriations Committee Action (HELD)",0,0,0,0,0
1946107,1493312,2025-02-19,Senate,"Senate Government Committee Action (DP)",7,0,0,0,7
1946107,1497968,2025-02-24,Senate,"Senate Rules Committee Action (PFC)",0,0,0,0,0
1946107,1501318,2025-02-27,Senate,"Senate - Third Reading",26,3,1,0,30
1946107,1520748,2025-03-19,House,"House Government Committee Action (DPA)",7,0,0,0,7
1946107,1524851,2025-03-24,House,"House Rules Committee Action (C&P)",8,0,0,0,8
1946107,1528757,2025-03-27,House,"House - Committee of the Whole (DPA)",0,0,0,0,0
1946107,1547209,2025-04-14,House,"House - Third Reading",53,2,5,0,60
1946107,1560039,2025-04-29,Senate,"Senate - Concurrence",0,0,0,0,0
1946107,1560040,2025-04-29,Senate,"Senate - Third Reading",24,5,1,0,30
1946151,1485342,2025-02-10,Senate,"Senate Finance Committee Action (DP)",7,0,0,0,7
1946151,1490997,2025-02-17,Senate,"Senate Rules Committee Action (PFC)",0,0,0,0,0
1946151,1499207,2025-02-25,Senate,"Senate - Committee of the Whole (DP)",0,0,0,0,0
1946151,1500422,2025-02-26,Senate,"Senate - Third Reading",28,0,2,0,30
1946151,1515873,2025-03-12,House,"House Ways & Means Committee Action (DP)",7,0,0,2,9
1946173,1485320,2025-02-10,Senate,"Senate Finance Committee Action (HELD)",0,0,0,0,0
1946173,1491712,2025-02-17,Senate,"Senate Finance Committee Action (DPA)",4,3,0,0,7
1946173,1497572,2025-02-24,Senate,"Senate Rules Committee Action (PFC)",0,0,0,0,0
1946173,1500344,2025-02-26,Senate,"Senate - Committee of the Whole (DPA)",0,0,0,0,0
1946173,1506337,2025-03-05,Senate,"Senate - Committee of the Whole (DPA)",0,0,0,0,0
1946173,1507689,2025-03-06,Senate,"Senate - Third Reading",17,8,5,0,30
1946173,1520929,2025-03-19,House,"House Ways & Means Committee Action (DP)",5,4,0,0,9
1946173,1528117,2025-03-26,House,"House Appropriations Committee Action (DPA)",11,6,0,1,18
1946195,1488079,2025-02-12,House,"House Federalism, Military Affairs & Elections Committee Action (HELD)",0,0,0,0,0
1946195,1493920,2025-02-19,House,"House Federalism, Military Affairs & Elections Committee Action (FAILED)",3,4,0,0,7
1946236,1488000,2025-02-12,Senate,"Senate Judiciary and Elections Committee Action (HELD)",0,0,0,0,0
1946236,1494568,2025-02-19,Senate,"Senate Judiciary and Elections Committee Action (DPA)",4,3,0,0,7
1946236,1497560,2025-02-24,Senate,"Senate Rules Committee Action (PFC)",0,0,0,0,0
1946236,1503382,2025-03-03,Senate,"Senate - Committee of the Whole (DPA)",0,0,0,0,0
1946236,1506486,2025-03-05,Senate,"Senate - Third Reading",17,12,1,0,30
1946236,1528032,2025-03-26,House,"House Federalism, Military Affairs & Elections Committee Action (DP)",4,3,0,0,7
1946236,1538486,2025-04-07,House,"House Rules Committee Action (C&P)",7,0,0,1,8
1946236,1547341,2025-04-14,House,"House - Committee of the Whole (DPA)",0,0,0,0,0
1946236,1551339,2025-04-17,House,"House - Third Reading",32,25,3,0,60
1946236,1560293,2025-04-29,Senate,"Senate - Concurrence",0,0,0,0,0
1946236,1560294,2025-04-29,Senate,"Senate - Third Reading",17,12,1,0,30
1946263,1488607,2025-02-12,Senate,"Senate Public Safety Committee Action (DP)",6,0,1,0,7
1946263,1490869,2025-02-17,Senate,"Senate Rules Committee Action (PFC)",0,0,0,0,0
1946263,1499071,2025-02-25,Senate,"Senate - Committee of the Whole (DPA)",0,0,0,0,0
1946263,1500178,2025-02-26,Senate,"Senate - Third Reading",28,0,2,0,30
1946263,1521379,2025-03-19,House,"House Transportation & Infrastructure Committee Action (DPA/SE)",6,0,0,1,7
1946263,1524843,2025-03-24,House,"House Rules Committee Action (C&P)",8,0,0,0,8
1946263,1528760,2025-03-27,House,"House - Committee of the Whole (DPA)",0,0,0,0,0
1946263,1547431,2025-04-14,House,"House - Third Reading",52,3,5,0,60
1946263,1560261,2025-04-29,Senate,"Senate - Concurrence",0,0,0,0,0
1946263,1560262,2025-04-29,Senate,"Senate - Third Reading",29,0,1,0,30
1946329,1489492,2025-02-12,Senate,"Senate Public Safety Committee Action (DP)",6,0,1,0,7
1946329,1492919,2025-02-18,Senate,"Senate Appropriations Committee Action (DP)",7,2,1,0,10
1946329,1498046,2025-02-24,Senate,"Senate Rules Committee Action (PFC)",0,0,0,0,0
1946329,1507809,2025-03-06,Senate,"Senate - Committee of the Whole (DP)",0,0,0,0,0
1946329,1517574,2025-03-13,Senate,"Senate - Third Reading",18,10,2,0,30
1946329,1525619,2025-03-24,House,"House Public Safety & Law Enforcement Committee Action (FAILED)",7,7,0,1,15
1946329,1528448,2025-03-26,House,"House Public Safety & Law Enforcement Committee Action (W/D)",0,0,0,0,0
1946329,1531738,2025-03-31,House,"House Appropriations Committee Action (DP)",11,6,1,0,18
1946351,1487243,2025-02-11,Senate,"Senate Appropriations Committee Action (DP)",7,3,0,0,10
1946351,1490843,2025-02-17,Senate,"Senate Rules Committee Action (PFC)",0,0,0,0,0
1946351,1501905,2025-02-27,Senate,"Senate - Committee of the Whole (DPA)",0,0,0,0,0
1946351,1504864,2025-03-04,Senate,"Senate - Third Reading",16,10,4,0,30
1946373,1491872,2025-02-18,House,"House Health & Human Services Committee Action (W/D)",0,0,0,0,0
1946373,1495256,2025-02-20,House,"House Government Committee Action (DP)",7,0,0,0,7
1946373,1497346,2025-02-24,House,"House Rules Committee Action (C&P)",7,0,0,1,8
1946373,1501073,2025-02-27,House,"Motion Motion by Representative Carbone that pursuant to House Rule 12(P), HB2706 be calendared for an Additional Committee of the Whole for purposes of further amending. Motion passed v/v.",0,0,0,0,0
1946373,1501074,2025-02-27,House,"House - Committee of the Whole (DPA)",0,0,0,0,0
1946373,1505035,2025-03-04,House,"House - Third Reading",46,12,2,0,60
1946373,1521578,2025-03-19,Senate,"Senate Judiciary and Elections Committee Action (W/D)",0,0,0,0,0
1946373,1527715,2025-03-26,Senate,"Senate Health and Human Services Committee Action (DPA)",7,0,0,0,7
1946373,1532706,2025-04-01,Senate,"Senate Appropriations Committee Action (DP)",8,1,1,0,10
1946394,1487604,2025-02-12,Senate,"Senate Health and Human Services Committee Action (DPA)",5,0,2,0,7
1946394,1490967,2025-02-17,Senate,"Senate Rules Committee Action (PFC)",0,0,0,0,0
1946394,1501056,2025-02-27,Senate,"Senate - Committee of the Whole (DPA)",0,0,0,0,0
1946394,1504797,2025-03-04,Senate,"Senate - Third Reading",26,1,3,0,30
1946394,1525414,2025-03-24,House,"House Health & Human Services Committee Action (DP)",11,0,0,1,12
1946394,1531367,2025-03-31,House,"House Rules Committee Action (C&P)",7,0,0,1,8
1946394,1535739,2025-04-03,House,"House - Committee of the Whole (DP)",0,0,0,0,0
1946394,1561835,2025-04-30,House,"House - Third Reading",52,0,8,0,60
1946415,1489463,2025-02-12,Senate,"Senate Public Safety Committee Action (DP)",5,1,1,0,7
1946415,1492921,2025-02-18,Senate,"Senate Appropriations Committee Action (DP)",7,2,1,0,10
1946415,1498095,2025-02-24,Senate,"Senate Rules Committee Action (PFC)",0,0,0,0,0
1946415,1509720,2025-03-10,Senate,"Senate - Third Reading",16,11,3,0,30
1946415,1525490,2025-03-24,House,"House Public Safety & Law Enforcement Committee Action (DPA)",8,6,0,1,15
1946415,1531451,2025-03-31,House,"House Appropriations Committee Action (DP)",12,5,0,1,18
1946438,1485560,2025-02-10,House,"House - Third Reading",0,0,0,0,0
1946438,1485561,2025-02-10,Senate,"Senate - Third Reading",0,0,0,0,0
1946628,1477383,2025-01-30,House,"House - Third Reading",0,0,0,0,0
1946804,1494102,2025-02-19,Senate,"Senate Public Safety Committee Action (DP)",7,0,0,0,7
1946804,1498065,2025-02-24,Senate,"Senate Rules Committee Action (PFC)",0,0,0,0,0
1946804,1500905,2025-02-26,Senate,"Senate - Committee of the Whole (DPA)",0,0,0,0,0
1946804,1504627,2025-03-04,Senate,"Senate - Third Reading",23,4,3,0,30
1946804,1528068,2025-03-26,House,"House Government Committee Action (DP)",5,2,0,0,7
1946804,1547869,2025-04-14,House,"House Rules Committee Action (C&P)",8,0,0,0,8
1946980,1493556,2025-02-18,Senate,"Senate Natural Resources Committee Action (DPA/SE)",5,1,2,0,8
1946980,1498390,2025-02-24,Senate,"Senate Rules Committee Action (PFC)",0,0,0,0,0
1946980,1501726,2025-02-27,Senate,"Senate - Committee of the Whole (DPA)",0,0,0,0,0
1946980,1507725,2025-03-06,Senate,"Senate - Third Reading",17,10,3,0,30
1946980,1520240,2025-03-18,House,"House Natural Resources, Energy & Water Committee Action (DP)",5,4,0,1,10
1946980,1525484,2025-03-24,House,"House Rules Committee Action (C&P)",8,0,0,0,8
1946980,1527942,2025-03-26,House,"House - Committee of the Whole (DPA)",0,0,0,0,0
1946980,1551015,2025-04-17,House,"House - Third Reading",32,25,3,0,60
1947326,1494634,2025-02-19,Senate,"Senate Education Committee Action (DP)",7,0,0,0,7
1947326,1497584,2025-02-24,Senate,"Senate Rules Committee Action (PFC)",0,0,0,0,0
1947326,1501389,2025-02-27,Senate,"Senate - Third Reading",26,3,1,0,30
1947326,1525118,2025-03-24,House,"House Health & Human Services Committee Action (W/D)",0,0,0,0,0
1947326,1528042,2025-03-25,House,"House Education Committee Action (DP)",12,0,0,0,12
1947326,1545656,2025-02-19,Senate,"Senate Education-Archived and Renamed Education and Transportation as of 04/01/2025 Committee Action (DP)",7,0,0,0,7
1947326,1547278,2025-04-14,House,"House Rules Committee Action (C&P)",8,0,0,0,8
1947326,1567180,2025-05-07,House,"House - Third Reading",58,0,2,0,60
1947361,1495941,2025-02-20,Senate,"Senate Regulatory Affairs and Government Efficiency Committee Action (DPA/SE)",6,0,1,0,7
1947361,1498350,2025-02-24,Senate,"Senate Rules Committee Action (PFC)",0,0,0,0,0
1947361,1500561,2025-02-26,Senate,"Senate - Committee of the Whole (DPA)",0,0,0,0,0
1947361,1505398,2025-03-04,Senate,"Senate - Third Reading",19,8,3,0,30
1947361,1519093,2025-03-17,House,"House Health & Human Services Committee Action (DP)",12,0,0,0,12
1947361,1547894,2025-04-14,House,"House Rules Committee Action (C&P)",8,0,0,0,8
1947361,1562224,2025-04-30,House,"House - Third Reading",36,18,6,0,60
1947777,1491739,2025-02-17,Senate,"Senate Finance Committee Action (DPA)",4,3,0,0,7
1947777,1498327,2025-02-24,Senate,"Senate Rules Committee Action (PFC)",0,0,0,0,0
1947777,1505514,2025-03-04,Senate,"Senate - Committee of the Whole (RETAINED)",0,0,0,0,0
1947777,1508168,2025-03-06,Senate,"Senate - Committee of the Whole (RETAINED)",0,0,0,0,0
1948089,1493123,2025-02-19,House,"House Judiciary Committee Action (DP)",6,3,0,0,9
1948089,1497410,2025-02-24,House,"House Rules Committee Action (C&P)",7,0,0,1,8
1948265,1489616,2025-02-13,Senate,"Senate Regulatory Affairs and Government Efficiency Committee Action (DP)",6,0,1,0,7
1948265,1497656,2025-02-24,Senate,"Senate Rules Committee Action (PFC)",0,0,0,0,0
1948265,1501426,2025-02-27,Senate,"Senate - Third Reading",25,4,1,0,30
1948265,1514327,2025-03-11,House,"House Commerce Committee Action (HELD)",0,0,0,0,0
1948265,1517520,2025-03-12,House,"House Commerce Committee Action (W/D)",0,0,0,0,0
1948265,1521190,2025-03-19,House,"House Government Committee Action (DPA/SE)",6,0,0,1,7
1948265,1524818,2025-03-24,House,"House Rules Committee Action (C&P)",8,0,0,0,8
1948265,1528790,2025-03-27,House,"House - Committee of the Whole (DPA)",0,0,0,0,0
1948265,1535937,2025-04-03,House,"Motion Motion by Representative Carbone that pursuant to House Rule 12(P), SB1424 be calendared for an Additional Committee of the Whole for purposes of further amending. Motion passed v/v.",0,0,0,0,0
1948265,1535938,2025-04-03,House,"House - Committee of the Whole (RET ON CAL)",0,0,0,0,0
1948265,1538510,2025-04-07,House,"Motion Motion by Representative Carbone that pursuant to House Rule 12(P), SB1424 be calendared for an Additional Committee of the Whole for purposes of further amending. Motion passed v/v.",0,0,0,0,0
1948265,1538511,2025-04-07,House,"House - Committee of the Whole (DPA)",0,0,0,0,0
1948265,1541609,2025-04-09,House,"House - Third Reading",54,1,5,0,60
1948265,1548664,2025-04-15,Senate,"Senate - Concurrence",0,0,0,0,0
1948265,1548665,2025-04-15,Senate,"Senate - Third Reading",29,1,0,0,30
1948297,1486998,2025-02-11,Senate,"Senate Natural Resources Committee Action (DP)",5,2,1,0,8
1948297,1490883,2025-02-17,Senate,"Senate Rules Committee Action (PFC)",0,0,0,0,0
1948297,1498970,2025-02-25,Senate,"Senate - Committee of the Whole (RETAINED)",0,0,0,0,0
1948297,1504795,2025-03-04,Senate,"Senate - Committee of the Whole (RETAINED)",0,0,0,0,0
1948297,1507901,2025-03-06,Senate,"Senate - Committee of the Whole (DP)",0,0,0,0,0
1948297,1517171,2025-03-13,Senate,"Senate - Third Reading",17,11,2,0,30
1948297,1521536,2025-03-19,House,"House Land, Agriculture & Rural Affairs Committee Action (W/D)",0,0,0,0,0
1948297,1526645,2025-03-25,House,"House Natural Resources, Energy & Water Committee Action (HELD)",0,0,0,0,0
1948297,1529835,2025-03-27,House,"House Natural Resources, Energy & Water Committee Action (W/D)",0,0,0,0,0
1948297,1531239,2025-03-31,House,"House Appropriations Committee Action (DPA/SE)",11,7,0,0,18
1948297,1547305,2025-04-14,House,"House Rules Committee Action (C&P)",8,0,0,0,8
1948297,1549962,2025-04-16,House,"House - Committee of the Whole (DPA)",0,0,0,0,0
1948297,1563644,2025-05-01,House,"House - Third Reading",31,27,2,0,60
1948341,1487241,2025-02-11,Senate,"Senate Natural Resources Committee Action (DP)",6,0,2,0,8
1948341,1492672,2025-02-18,Senate,"Senate Appropriations Committee Action (DP)",9,0,1,0,10
1948341,1498389,2025-02-24,Senate,"Senate Rules Committee Action (PFC)",0,0,0,0,0
1948341,1511824,2025-03-10,Senate,"Senate - Third Reading",26,1,3,0,30
1948341,1520319,2025-03-18,House,"House Natural Resources, Energy & Water Committee Action (DP)",8,1,0,1,10
1948341,1527917,2025-03-26,House,"House Appropriations Committee Action (DPA/SE)",11,5,1,1,18
1948341,1547863,2025-04-14,House,"House Rules Committee Action (C&P)",8,0,0,0,8
1948341,1554071,2025-04-22,House,"House - Committee of the Whole (DPA)",0,0,0,0,0
1948341,1567249,2025-05-07,House,"House - Third Reading",42,16,2,0,60
1948366,1488255,2025-02-12,Senate,"Senate Judiciary and Elections Committee Action (DP)",4,2,1,0,7
1948411,1487551,2025-02-12,Senate,"Senate Health and Human Services Committee Action (DP)",7,0,0,0,7
1948411,1492661,2025-02-18,Senate,"Senate Appropriations Committee Action (DP)",8,1,1,0,10
1948411,1497602,2025-02-24,Senate,"Senate Rules Committee Action (PFC)",0,0,0,0,0
1948411,1507842,2025-03-06,Senate,"Senate - Committee of the Whole (DPA)",0,0,0,0,0
1948411,1517093,2025-03-13,Senate,"Senate - Third Reading",23,4,3,0,30
1948480,1488264,2025-02-12,Senate,"Senate Judiciary and Elections Committee Action (DP)",4,2,1,0,7
1948480,1490844,2025-02-17,Senate,"Senate Rules Committee Action (PFC)",4,2,1,0,7
1948480,1499202,2025-02-25,Senate,"Senate - Committee of the Whole (DP)",0,0,0,0,0
1948480,1500612,2025-02-26,Senate,"Senate - Third Reading",17,11,2,0,30
1948480,1527533,2025-03-26,House,"House Judiciary Committee Action (DP)",6,3,0,0,9
1948480,1547884,2025-04-14,House,"House Rules Committee Action (C&P)",8,0,0,0,8
1948480,1552585,2025-04-21,House,"House - Committee of the Whole (DP)",0,0,0,0,0
1948480,1564139,2025-05-01,House,"House - Third Reading",31,27,2,0,60
1948507,1487582,2025-02-12,Senate,"Senate Health and Human Services Committee Action (DPA)",7,0,0,0,7
1948507,1492656,2025-02-18,Senate,"Senate Appropriations Committee Action (DP)",8,0,2,0,10
1948507,1497522,2025-02-24,Senate,"Senate Rules Committee Action (PFC)",0,0,0,0,0
1948507,1507843,2025-03-06,Senate,"Senate - Committee of the Whole (DPA)",0,0,0,0,0
1948507,1517460,2025-03-13,Senate,"Senate - Third Reading",24,3,3,0,30
1948507,1531264,2025-03-31,House,"House Appropriations Committee Action (DP)",15,3,0,0,18
1948531,1485364,2025-02-10,Senate,"Senate Health and Human Services Committee Action (W/D)",0,0,0,0,0
1948552,1493918,2025-02-19,Senate,"Senate Public Safety Committee Action (DPA)",6,0,1,0,7
1948552,1499460,2025-02-25,Senate,"Senate Appropriations Committee Action (HELD)",0,0,0,0,0
1948579,1488389,2025-02-12,Senate,"Senate Judiciary and Elections Committee Action (DPA)",6,0,1,0,7
1948579,1490895,2025-02-17,Senate,"Senate Rules Committee Action (PFC)",0,0,0,0,0
1948579,1499136,2025-02-25,Senate,"Senate - Committee of the Whole (DPA)",0,0,0,0,0
1948579,1500321,2025-02-26,Senate,"Senate - Third Reading",28,0,2,0,30
1948579,1515799,2025-03-12,House,"House Judiciary Committee Action (DP)",9,0,0,0,9
1948579,1518848,2025-03-17,House,"House Rules Committee Action (C&P)",8,0,0,0,8
1948579,1559109,2025-04-28,House,"House - Third Reading",56,0,4,0,60
1948602,1489477,2025-02-12,Senate,"Senate Public Safety Committee Action (DP)",6,0,1,0,7
1948602,1492914,2025-02-18,Senate,"Senate Appropriations Committee Action (DP)",8,0,2,0,10
1948602,1498161,2025-02-24,Senate,"Senate Rules Committee Action (PFC)",0,0,0,0,0
1948602,1501464,2025-02-27,Senate,"Senate - Third Reading",27,2,1,0,30
1948602,1511903,2025-03-10,House,"House Public Safety & Law Enforcement Committee Action (DP)",12,0,2,1,15
1948602,1516744,2025-03-12,House,"House Appropriations Committee Action (HELD)",0,0,0,0,0
1948602,1522070,2025-03-19,House,"House Appropriations Committee Action (DPA)",18,0,0,0,18
1948625,1488476,2025-02-12,Senate,"Senate Education Committee Action (DP)",4,3,0,0,7
1948625,1491334,2025-02-17,Senate,"Senate Rules Committee Action (PFC)",0,0,0,0,0
1948625,1501150,2025-02-27,Senate,"Senate - Committee of the Whole (DP)",0,0,0,0,0
1948625,1504956,2025-03-04,Senate,"Senate - Third Reading",16,11,3,0,30
1948625,1545554,2025-02-12,Senate,"Senate Education-Archived and Renamed Education and Transportation as of 04/01/2025 Committee Action (DP)",4,3,0,0,7
1948649,1487570,2025-02-12,Senate,"Senate Health and Human Services Committee Action (DP)",6,0,1,0,7
1948649,1490880,2025-02-17,Senate,"Senate Rules Committee Action (PFC)",0,0,0,0,0
1948649,1501627,2025-02-27,Senate,"Senate - Third Reading",29,0,1,0,30
1948649,1514313,2025-03-11,House,"House Education Committee Action (DPA)",12,0,0,0,12
1948649,1518873,2025-03-17,House,"House Rules Committee Action (C&P)",8,0,0,0,8
1948649,1521340,2025-03-19,House,"House - Committee of the Whole (DPA)",0,0,0,0,0
1948649,1535677,2025-04-03,House,"Motion Motion by Representative Carbone that pursuant to House Rule 12(P), SB1440 be calendared for an Additional Committee of the Whole for purposes of further amending. Motion passed v/v.",0,0,0,0,0
1948649,1535678,2025-04-03,House,"House - Committee of the Whole (DPA)",0,0,0,0,0
1948649,1547624,2025-04-14,House,"House - Third Reading",55,0,5,0,60
1948649,1559969,2025-04-29,Senate,"Senate - Concurrence",0,0,0,0,0
1948649,1559970,2025-04-29,Senate,"Senate - Third Reading",29,0,1,0,30
1948751,1487469,2025-02-12,House,"House Judiciary Committee Action (DP)",9,0,0,0,9
1948751,1490893,2025-02-17,House,"House Rules Committee Action (C&P)",7,0,0,1,8
1948751,1495223,2025-02-20,House,"House - Third Reading",59,0,1,0,60
1948751,1507123,2025-03-05,Senate,"Senate Judiciary and Elections Committee Action (DP)",7,0,0,0,7
1948751,1518889,2025-03-17,Senate,"Senate Rules Committee Action (PFC)",0,0,0,0,0
1948751,1527504,2025-03-26,Senate,"Senate - Third Reading",27,0,2,0,29
1948825,1488023,2025-02-12,Senate,"Senate Judiciary and Elections Committee Action (DP)",4,2,1,0,7
1948825,1490945,2025-02-17,Senate,"Senate Rules Committee Action (PFC)",0,0,0,0,0
1948825,1499157,2025-02-25,Senate,"Senate - Committee of the Whole (DP)",0,0,0,0,0
1948825,1500294,2025-02-26,Senate,"Senate - Third Reading",17,11,2,0,30
1948825,1514498,2025-03-11,House,"House Education Committee Action (DP)",7,4,1,0,12
1948825,1518744,2025-03-17,House,"House Rules Committee Action (C&P)",8,0,0,0,8
1948825,1522858,2025-03-20,House,"House - Committee of the Whole (DP)",0,0,0,0,0
1948825,1522859,2025-03-20,House,"House - Representative Sandoval  to show the bill failed to pass",23,31,6,0,60
1948825,1548700,2025-04-15,House,"House - Third Reading",32,20,8,0,60
1948853,1491689,2025-02-17,Senate,"Senate Federalism Committee Action (DPA)",4,2,1,0,7
1948853,1497598,2025-02-24,Senate,"Senate Rules Committee Action (PFC)",0,0,0,0,0
1948853,1504036,2025-03-03,Senate,"Senate - Committee of the Whole (DPA)",0,0,0,0,0
1948853,1508023,2025-03-06,Senate,"Senate - Third Reading",17,9,4,0,30
1948853,1525295,2025-03-24,House,"House Land, Agriculture & Rural Affairs Committee Action (DP)",6,3,0,0,9
1948876,1482328,2025-02-05,Senate,"Senate Education Committee Action (DPA)",7,0,0,0,7
1948876,1484964,2025-02-10,Senate,"Senate Rules Committee Action (PFC)",0,0,0,0,0
1948876,1495056,2025-02-20,Senate,"Senate - Committee of the Whole (DPA)",0,0,0,0,0
1948876,1495057,2025-02-20,Senate,"Senate - Third Reading",17,12,1,0,30
1948876,1503197,2025-03-03,House,"House Public Safety & Law Enforcement Committee Action (W/D)",0,0,0,0,0
1948876,1506323,2025-03-04,House,"House Education Committee Action (DPA)",11,0,0,1,12
1948876,1509294,2025-03-10,House,"House Rules Committee Action (C&P)",6,0,0,2,8
1948876,1517109,2025-03-13,House,"House - Committee of the Whole (DPA)",0,0,0,0,0
1948876,1517110,2025-03-13,House,"House - Representative Gutierrez to include the Gutierrez floor amendment",24,32,4,0,60
1948876,1520278,2025-03-18,House,"House - Third Reading",38,20,2,0,60
1948876,1534506,2025-04-02,Senate,"Senate - Concurrence",0,0,0,0,0
1948876,1534507,2025-04-02,Senate,"Senate - Third Reading",22,8,0,0,30
1948876,1545838,2025-02-05,Senate,"Senate Education-Archived and Renamed Education and Transportation as of 04/01/2025 Committee Action (DPA)",7,0,0,0,7
1948951,1494587,2025-02-19,Senate,"Senate Judiciary and Elections Committee Action (HELD)",0,0,0,0,0
1949025,1487484,2025-02-12,Senate,"Senate Government Committee Action (DPA)",4,3,0,0,7
1949025,1490950,2025-02-17,Senate,"Senate Rules Committee Action (PFC)",0,0,0,0,0
1949025,1501204,2025-02-27,Senate,"Senate - Committee of the Whole (DPA)",0,0,0,0,0
1949025,1504997,2025-03-04,Senate,"Senate - Third Reading",16,11,3,0,30
1949051,1489610,2025-02-13,Senate,"Senate Regulatory Affairs and Government Efficiency Committee Action (DP)",7,0,0,0,7
1949051,1498409,2025-02-24,Senate,"Senate Rules Committee Action (PFC)",0,0,0,0,0
1949051,1501421,2025-02-27,Senate,"Senate - Third Reading",23,6,1,0,30
1949098,1487598,2025-02-12,Senate,"Senate Health and Human Services Committee Action (DP)",7,0,0,0,7
1949098,1490924,2025-02-17,Senate,"Senate Rules Committee Action (PFC)",0,0,0,0,0
1949098,1501630,2025-02-27,Senate,"Senate - Third Reading",26,3,1,0,30
1949098,1509769,2025-03-10,House,"House Health & Human Services Committee Action (DP)",10,1,0,1,12
1949098,1518830,2025-03-17,House,"House Rules Committee Action (C&P)",8,0,0,0,8
1949098,1565148,2025-05-05,House,"House - Third Reading",57,0,3,0,60
1949121,1492964,2025-02-18,Senate,"Senate Natural Resources Committee Action (DPA)",4,3,1,0,8
1949121,1497846,2025-02-24,Senate,"Senate Rules Committee Action (PFC)",0,0,0,0,0
1949121,1501548,2025-02-27,Senate,"Senate - Committee of the Whole (DPA)",0,0,0,0,0
1949121,1504908,2025-03-04,Senate,"Senate - Third Reading",16,11,3,0,30
1949121,1519981,2025-03-18,House,"House Regulatory Oversight Committee Action (DP)",3,2,0,0,5
1949141,1487602,2025-02-12,Senate,"Senate Health and Human Services Committee Action (DP)",5,1,1,0,7
1949141,1490984,2025-02-17,Senate,"Senate Rules Committee Action (PFC)",0,0,0,0,0
1949141,1499182,2025-02-25,Senate,"Senate - Committee of the Whole (DP)",0,0,0,0,0
1949141,1500346,2025-02-26,Senate,"Senate - Third Reading",17,11,2,0,30
1949141,1515764,2025-03-12,House,"House Judiciary Committee Action (DP)",6,2,0,1,9
1949141,1518921,2025-03-17,House,"House Rules Committee Action (C&P)",8,0,0,0,8
1949141,1526623,2025-03-25,House,"House - Committee of the Whole (DP)",0,0,0,0,0
1949141,1559090,2025-04-28,House,"House - Third Reading",33,23,4,0,60
1949161,1488266,2025-02-12,Senate,"Senate Judiciary and Elections Committee Action (DPA)",4,2,1,0,7
1949161,1491184,2025-02-17,Senate,"Senate Rules Committee Action (PFC)",4,2,1,0,7
1949161,1498767,2025-02-25,Senate,"Senate - Committee of the Whole (RETAINED)",0,0,0,0,0
1949161,1507881,2025-03-06,Senate,"Senate - Committee of the Whole (DPA)",0,0,0,0,0
1949161,1517163,2025-03-13,Senate,"Senate - Third Reading",28,0,2,0,30
1949161,1527585,2025-03-26,House,"House Judiciary Committee Action (DP)",8,1,0,0,9
1949161,1531403,2025-03-31,House,"House Rules Committee Action (C&P)",7,0,0,1,8
1949161,1538327,2025-04-07,House,"House - Committee of the Whole (RET ON CAL)",0,0,0,0,0
1949161,1549003,2025-04-15,House,"House - Committee of the Whole (DPA)",0,0,0,0,0
1949161,1551093,2025-04-17,House,"House - Third Reading",33,24,3,0,60
1949161,1559997,2025-04-29,Senate,"Senate - Concurrence",0,0,0,0,0
1949161,1559998,2025-04-29,Senate,"Senate - Third Reading",29,0,1,0,30
1949179,1491719,2025-02-17,Senate,"Senate Finance Committee Action (DPA)",6,1,0,0,7
1949179,1497536,2025-02-24,Senate,"Senate Rules Committee Action (PFC)",0,0,0,0,0
1949179,1500366,2025-02-26,Senate,"Senate - Committee of the Whole (DPA)",0,0,0,0,0
1949179,1504543,2025-03-04,Senate,"Senate - Third Reading",16,11,3,0,30
1949207,1493342,2025-02-19,Senate,"Senate Health and Human Services Committee Action (DP)",7,0,0,0,7
1949207,1499358,2025-02-25,Senate,"Senate Appropriations Committee Action (DP)",10,0,0,0,10
1949207,1503518,2025-03-03,Senate,"Senate Rules Committee Action (PFC)",0,0,0,0,0
1949256,1491133,2025-02-12,Senate,"Senate Education Committee Action (DISC/HELD)",0,0,0,0,0
1949256,1545567,2025-02-12,Senate,"Senate Education-Archived and Renamed Education and Transportation as of 04/01/2025 Committee Action (DISC/HELD)",0,0,0,0,0
1949286,1489832,2025-02-13,Senate,"Senate Regulatory Affairs and Government Efficiency Committee Action (DP)",6,1,0,0,7
1949286,1498400,2025-02-24,Senate,"Senate Rules Committee Action (PFC)",0,0,0,0,0
1949286,1501554,2025-02-27,Senate,"Senate - Third Reading",20,9,1,0,30
1949286,1520016,2025-03-18,House,"House Commerce Committee Action (DP)",10,0,0,0,10
1949286,1525606,2025-03-24,House,"House Rules Committee Action (C&P)",8,0,0,0,8
1949286,1529449,2025-03-27,House,"House - Committee of the Whole (DP)",0,0,0,0,0
1949286,1550071,2025-04-16,House,"House - Third Reading",48,10,2,0,60
1949299,1485220,2025-02-10,Senate,"Senate Finance Committee Action (DP)",6,1,0,0,7
1949299,1490939,2025-02-17,Senate,"Senate Rules Committee Action (PFC)",0,0,0,0,0
1949299,1499151,2025-02-25,Senate,"Senate - Committee of the Whole (DPA)",0,0,0,0,0
1949299,1500286,2025-02-26,Senate,"Senate - Third Reading",17,11,2,0,30
1949299,1515850,2025-03-12,House,"House Ways & Means Committee Action (DP)",5,4,0,0,9
1949299,1518733,2025-03-17,House,"House Rules Committee Action (C&P)",8,0,0,0,8
1949299,1526466,2025-03-25,House,"House - Committee of the Whole (DP)",0,0,0,0,0
1949299,1549901,2025-04-16,House,"House - Third Reading",33,25,2,0,60
1949316,1488076,2025-02-12,Senate,"Senate Education Committee Action (HELD)",0,0,0,0,0
1949316,1490593,2025-02-12,Senate,"Senate Education Committee Action (DISC/HELD)",0,0,0,0,0
1949316,1494608,2025-02-19,Senate,"Senate Education Committee Action (DP)",4,3,0,0,7
1949316,1497561,2025-02-24,Senate,"Senate Rules Committee Action (PFC)",0,0,0,0,0
1949316,1501340,2025-02-27,Senate,"Senate - Committee of the Whole (RETAINED)",0,0,0,0,0
1949316,1507832,2025-03-06,Senate,"Senate - Committee of the Whole (DPA)",0,0,0,0,0
1949316,1517089,2025-03-13,Senate,"Senate - Third Reading",17,11,2,0,30
1949316,1526684,2025-03-25,House,"House Education Committee Action (DP)",7,5,0,0,12
1949316,1532443,2025-04-01,House,"House Rules Committee Action (C&P)",7,0,0,1,8
1949316,1545526,2025-02-19,Senate,"Senate Education-Archived and Renamed Education and Transportation as of 04/01/2025 Committee Action (DP)",4,3,0,0,7
1949316,1547511,2025-04-14,House,"House - Committee of the Whole (DP)",0,0,0,0,0
1949316,1559138,2025-04-28,House,"House - Third Reading",32,24,4,0,60
1949379,1503798,2025-03-03,Senate,"Senate Finance Committee Action (HELD)",0,0,0,0,0
1949379,1519442,2025-03-17,Senate,"Senate Finance Committee Action (DISC/ONLY)",0,0,0,0,0
1949387,1494561,2025-02-19,Senate,"Senate Education Committee Action (DPA/SE)",4,3,0,0,7
1949387,1497504,2025-02-24,Senate,"Senate Rules Committee Action (PFC)",0,0,0,0,0
1949387,1500315,2025-02-26,Senate,"Senate - Committee of the Whole (DPA)",0,0,0,0,0
1949387,1504569,2025-03-04,Senate,"Senate - Third Reading",16,11,3,0,30
1949387,1545865,2025-02-19,Senate,"Senate Education-Archived and Renamed Education and Transportation as of 04/01/2025 Committee Action (DPA/SE)",4,3,0,0,7
1949458,1487949,2025-02-12,Senate,"Senate Education Committee Action (DPA)",7,0,0,0,7
1949458,1490953,2025-02-17,Senate,"Senate Rules Committee Action (PFC)",0,0,0,0,0
1949458,1507751,2025-03-06,Senate,"Senate - Committee of the Whole (DPA)",0,0,0,0,0
1949458,1517066,2025-03-13,Senate,"Senate - Third Reading",27,1,2,0,30
1949458,1526694,2025-03-25,House,"House Education Committee Action (DP)",12,0,0,0,12
1949458,1545678,2025-02-12,Senate,"Senate Education-Archived and Renamed Education and Transportation as of 04/01/2025 Committee Action (DPA)",7,0,0,0,7
1949474,1493241,2025-02-19,Senate,"Senate Health and Human Services Committee Action (DP)",6,0,1,0,7
1949474,1499338,2025-02-25,Senate,"Senate Appropriations Committee Action (DP)",8,2,0,0,10
1949474,1503820,2025-03-03,Senate,"Senate Rules Committee Action (PFC)",0,0,0,0,0
1949474,1508126,2025-03-06,Senate,"Senate - Committee of the Whole (DP)",0,0,0,0,0
1949474,1517567,2025-03-13,Senate,"Senate - Third Reading",18,9,3,0,30
1949508,1494591,2025-02-19,Senate,"Senate Judiciary and Elections Committee Action (DP)",4,3,0,0,7
1949508,1497547,2025-02-24,Senate,"Senate Rules Committee Action (PFC)",0,0,0,0,0
1949508,1503211,2025-03-03,Senate,"Senate - Committee of the Whole (DP)",0,0,0,0,0
1949508,1506300,2025-03-05,Senate,"Senate - Third Reading",17,12,1,0,30
1949508,1528120,2025-03-26,House,"House Federalism, Military Affairs & Elections Committee Action (FAILED)",0,7,0,0,7
1949517,1505721,2025-03-05,Senate,"Senate Health and Human Services Committee Action (DISC/ONLY)",0,0,0,0,0
1949527,1491706,2025-02-17,Senate,"Senate Finance Committee Action (DPA)",6,1,0,0,7
1949527,1498401,2025-02-24,Senate,"Senate Rules Committee Action (PFC)",0,0,0,0,0
1949527,1500779,2025-02-26,Senate,"Senate - Committee of the Whole (DPA)",0,0,0,0,0
1949527,1504609,2025-03-04,Senate,"Senate - Third Reading",24,3,3,0,30
1949536,1488050,2025-02-12,Senate,"Senate Judiciary and Elections Committee Action (DP)",4,2,1,0,7
1949536,1490897,2025-02-17,Senate,"Senate Rules Committee Action (PFC)",0,0,0,0,0
1949536,1499107,2025-02-25,Senate,"Senate - Committee of the Whole (DP)",0,0,0,0,0
1949536,1500241,2025-02-26,Senate,"Senate - Third Reading",17,11,2,0,30
1949536,1518836,2025-03-17,House,"House Federalism, Military Affairs & Elections Committee Action (W/D)",0,0,0,0,0
1949536,1521998,2025-03-18,House,"House Education Committee Action (W/D)",0,0,0,0,0
1949536,1528110,2025-03-26,House,"House Federalism, Military Affairs & Elections Committee Action (DP)",4,3,0,0,7
1949536,1532464,2025-04-01,House,"House Rules Committee Action (C&P)",7,0,0,1,8
1949536,1541405,2025-04-09,House,"House - Committee of the Whole (DP)",0,0,0,0,0
1949536,1563885,2025-05-01,House,"House - Third Reading",31,27,2,0,60
1949573,1484730,2025-02-10,Senate,"Senate Health and Human Services Committee Action (W/D)",0,0,0,0,0
1949573,1488035,2025-02-12,Senate,"Senate Education Committee Action (HELD)",0,0,0,0,0
1949573,1494554,2025-02-12,Senate,"Senate Education Committee Action (DP)",4,3,0,0,7
1949573,1497523,2025-02-24,Senate,"Senate Rules Committee Action (PFC)",0,0,0,0,0
1949573,1501324,2025-02-27,Senate,"Senate - Committee of the Whole (RETAINED)",0,0,0,0,0
1949573,1507778,2025-03-06,Senate,"Senate - Committee of the Whole (DPA)",0,0,0,0,0
1949573,1517122,2025-03-13,Senate,"Senate - Third Reading",17,11,2,0,30
1949573,1526739,2025-03-25,House,"House Education Committee Action (DP)",12,0,0,0,12
1949573,1531339,2025-03-31,House,"House Rules Committee Action (C&P)",7,0,0,1,8
1949573,1535751,2025-04-03,House,"House - Committee of the Whole (RET ON CAL)",0,0,0,0,0
1949573,1545662,2025-02-19,Senate,"Senate Education-Archived and Renamed Education and Transportation as of 04/01/2025 Committee Action (DP)",4,3,0,0,7
1949573,1549011,2025-04-15,House,"House - Committee of the Whole (DPA)",0,0,0,0,0
1949573,1561926,2025-04-30,House,"House - Third Reading",54,0,6,0,60
1949573,1566217,2025-05-06,Senate,"Senate - Concurrence",0,0,0,0,0
1949573,1566218,2025-05-06,Senate,"Senate - Third Reading",17,11,2,0,30
1949581,1488788,2025-02-12,Senate,"Senate Public Safety Committee Action (DP)",5,1,1,0,7
1949581,1491511,2025-02-17,Senate,"Senate Rules Committee Action (PFC)",0,0,0,0,0
1949581,1501710,2025-02-27,Senate,"Senate - Third Reading",17,12,1,0,30
1949581,1512178,2025-03-10,House,"House Public Safety & Law Enforcement Committee Action (HELD)",0,0,0,0,0
1949581,1519396,2025-03-17,House,"House Public Safety & Law Enforcement Committee Action (DPA)",9,5,0,1,15
1949581,1525528,2025-03-24,House,"House Rules Committee Action (C&P)",8,0,0,0,8
1949581,1531012,2025-03-31,House,"House - Committee of the Whole (DPA)",0,0,0,0,0
1949581,1538377,2025-04-07,House,"Motion Motion by Representative Carbone that pursuant to House Rule 12(P), SB1461 be calendared for an Additional Committee of the Whole for purposes of further amending. Motion passed v/v.",0,0,0,0,0
1949581,1538378,2025-04-07,House,"House - Committee of the Whole (DPA)",0,0,0,0,0
1949581,1545093,2025-04-10,House,"House - Third Reading",42,17,1,0,60
1949581,1548412,2025-04-15,Senate,"Senate - Concurrence",0,0,0,0,0
1949581,1549192,2025-04-15,Senate,"Senate - Third Reading",18,12,0,0,30
1950062,1493704,2025-02-19,Senate,"Senate Government Committee Action (DPA)",5,2,0,0,7
1950062,1497563,2025-02-24,Senate,"Senate Rules Committee Action (PFC)",0,0,0,0,0
1950062,1503416,2025-03-03,Senate,"Senate - Committee of the Whole (DPA)",0,0,0,0,0
1950062,1506498,2025-03-05,Senate,"Senate - Third Reading",24,5,1,0,30
1950062,1526712,2025-03-25,House,"House Commerce Committee Action (DPA)",8,2,0,0,10
1950062,1531056,2025-03-31,House,"House Rules Committee Action (C&P)",7,0,0,1,8
1950062,1534638,2025-04-02,House,"House - Committee of the Whole (DPA)",0,0,0,0,0
1950062,1543789,2025-04-10,House,"House - Third Reading",57,2,1,0,60
1950062,1548520,2025-04-15,Senate,"Senate - Concurrence",0,0,0,0,0
1950062,1548521,2025-04-15,Senate,"Senate - Third Reading",27,3,0,0,30
1950233,1487085,2025-02-11,House,"House Commerce Committee Action (HELD)",0,0,0,0,0
1950236,1493926,2025-02-19,Senate,"Senate Public Safety Committee Action (DP)",5,2,0,0,7
1950236,1499644,2025-02-25,Senate,"Senate Appropriations Committee Action (DPA)",6,4,0,0,10
1950236,1503850,2025-03-03,Senate,"Senate Rules Committee Action (PFC)",0,0,0,0,0
1950236,1507812,2025-03-06,Senate,"Senate - Committee of the Whole (DPA)",0,0,0,0,0
1950236,1517578,2025-03-13,Senate,"Senate - Third Reading",16,11,3,0,30
1950236,1525360,2025-03-24,House,"House Public Safety & Law Enforcement Committee Action (DP)",7,6,0,2,15
1950380,1495703,2025-02-20,House,"House Government Committee Action (DP)",5,2,0,0,7
1950380,1498089,2025-02-24,House,"House Rules Committee Action (C&P)",7,0,0,1,8
1950380,1498653,2025-02-25,House,"House - Committee of the Whole (DPA)",0,0,0,0,0
1950380,1501729,2025-02-27,House,"Motion Motion by Representative Carbone that pursuant to House Rule 12(P), HB2723 be calendared for an Additional Committee of the Whole for purposes of further amending. Motion passed v/v.",0,0,0,0,0
1950380,1501730,2025-02-27,House,"House - Committee of the Whole (DPA)",0,0,0,0,0
1950380,1503278,2025-03-03,House,"House - Third Reading",36,22,2,0,60
1950458,1487140,2025-02-11,House,"House Education Committee Action (DP)",8,4,0,0,12
1950458,1491486,2025-02-17,House,"House Rules Committee Action (C&P)",7,0,0,1,8
1950458,1495360,2025-02-20,House,"House - Committee of the Whole (DPA)",0,0,0,0,0
1950458,1499576,2025-02-25,House,"House - Third Reading",60,0,0,0,60
1950458,1528185,2025-03-26,Senate,"Senate Education Committee Action (DPA)",6,0,1,0,7
1950458,1531085,2025-03-31,Senate,"Senate Rules Committee Action (PFC)",0,0,0,0,0
1950458,1546325,2025-03-26,Senate,"Senate Education-Archived and Renamed Education and Transportation as of 04/01/2025 Committee Action (DPA)",6,0,1,0,7
1950458,1556682,2025-04-24,Senate,"Senate - Committee of the Whole (DPA)",0,0,0,0,0
1950458,1563628,2025-05-01,Senate,"Senate - Third Reading",9,13,8,0,30
1950458,1565534,2025-05-06,Senate,"Senate - Reconsider Third Reading",0,0,0,0,0
1950530,1491323,2025-02-17,Senate,"Senate Federalism Committee Action (DP)",4,2,1,0,7
1950530,1503516,2025-03-03,Senate,"Senate Rules Committee Action (PFC)",5,4,0,0,9
1950530,1507469,2025-03-06,Senate,"Senate - Committee of the Whole (DPA)",0,0,0,0,0
1950530,1517305,2025-03-13,Senate,"Senate - Third Reading",17,11,2,0,30
1950605,1485626,2025-02-10,Senate,"Senate Finance Committee Action (DP)",4,3,0,0,7
1950605,1491153,2025-02-17,Senate,"Senate Rules Committee Action (PFC)",0,0,0,0,0
1950605,1499452,2025-02-25,Senate,"Senate - Committee of the Whole (DPA)",0,0,0,0,0
1950605,1500939,2025-02-26,Senate,"Senate - Third Reading",18,10,2,0,30
1950605,1527489,2025-03-26,House,"House Ways & Means Committee Action (DP)",5,2,0,2,9
1950605,1532482,2025-04-01,House,"House Rules Committee Action (C&P)",7,0,0,1,8
1950605,1541989,2025-04-09,House,"House - Committee of the Whole (RET ON CAL)",0,0,0,0,0
1950685,1487594,2025-02-12,House,"House Ways & Means Committee Action (DP)",5,4,0,0,9
1950685,1490889,2025-02-17,House,"House Rules Committee Action (C&P)",7,0,0,1,8
1950685,1494707,2025-02-20,House,"House - Committee of the Whole (RET ON CAL)",0,0,0,0,0
1950685,1499111,2025-02-25,House,"House - Committee of the Whole (DPA)",0,0,0,0,0
1950685,1500236,2025-02-26,House,"House - Third Reading",32,28,0,0,60
1950685,1521049,2025-03-19,Senate,"Senate Government Committee Action (DP)",4,3,0,0,7
1950685,1524742,2025-03-24,Senate,"Senate Rules Committee Action (PFC)",0,0,0,0,0
1950763,1491708,2025-02-17,Senate,"Senate Military Affairs and Border Security Committee Action (DP)",4,3,0,0,7
1950763,1497710,2025-02-24,Senate,"Senate Rules Committee Action (PFC)",4,3,0,0,7
1950763,1500917,2025-02-26,Senate,"Senate - Committee of the Whole (DP)",0,0,0,0,0
1950763,1506496,2025-03-05,Senate,"Senate - Third Reading",16,13,1,0,30
1950763,1528416,2025-03-26,House,"House Federalism, Military Affairs & Elections Committee Action (DP)",4,2,0,1,7
1950763,1538269,2025-04-07,House,"House Rules Committee Action (C&P)",4,3,0,1,8
1950933,1492632,2025-02-18,House,"House Education Committee Action (DPA/SE)",7,5,0,0,12
1950933,1497275,2025-02-24,House,"House Rules Committee Action (C&P)",7,0,0,1,8
1950933,1498753,2025-02-25,House,"House - Committee of the Whole (DPA)",0,0,0,0,0
1950933,1500465,2025-02-26,House,"House - Third Reading",23,36,1,0,60
1950933,1500831,2025-02-26,House,"House - Reconsider Third Reading",0,0,0,0,0
1950933,1520068,2025-03-18,House,"Motion Motion by Representative Carbone that pursuant to House Rule 12(P), HB2725 be calendared for an Additional Committee of the Whole for purposes of further amending. Motion passed RCV 32-26-2.",0,0,0,0,0
1950933,1520069,2025-03-18,House,"House - Committee of the Whole (DPA)",0,0,0,0,0
1950933,1521473,2025-03-19,House,"House - Third Reading",26,31,3,0,60
1950933,1521474,2025-03-19,House,"House - Reconsider Third Reading",0,0,0,0,0
1950977,1486902,2025-02-11,Senate,"Senate Natural Resources Committee Action (DPA)",5,2,1,0,8
1950977,1490969,2025-02-17,Senate,"Senate Rules Committee Action (PFC)",0,0,0,0,0
1950977,1499198,2025-02-25,Senate,"Senate - Committee of the Whole (DPA)",0,0,0,0,0
1950977,1500306,2025-02-26,Senate,"Senate - Third Reading",17,11,2,0,30
1950977,1514571,2025-03-11,House,"House Natural Resources, Energy & Water Committee Action (DP)",5,4,0,1,10
1950977,1518779,2025-03-17,House,"House Rules Committee Action (C&P)",8,0,0,0,8
1950977,1521398,2025-03-19,House,"House - Committee of the Whole (DPA)",0,0,0,0,0
1950977,1531379,2025-03-31,House,"House - Third Reading",31,25,4,0,60
1950977,1548401,2025-04-15,Senate,"Senate - Concurrence",0,0,0,0,0
1950977,1548995,2025-04-15,Senate,"Senate - Third Reading",18,12,0,0,30
1951020,1488313,2025-02-12,Senate,"Senate Education Committee Action (HELD)",0,0,0,0,0
1951020,1494611,2025-02-19,Senate,"Senate Education Committee Action (DP)",6,1,0,0,7
1951020,1497576,2025-02-24,Senate,"Senate Rules Committee Action (PFC)",0,0,0,0,0
1951020,1509213,2025-03-10,Senate,"Senate - Committee of the Whole (DPA)",0,0,0,0,0
1951020,1517067,2025-03-13,Senate,"Senate - Third Reading",27,1,2,0,30
1951020,1527015,2025-03-25,House,"House Education Committee Action (DPA)",10,2,0,0,12
1951020,1545636,2025-02-19,Senate,"Senate Education-Archived and Renamed Education and Transportation as of 04/01/2025 Committee Action (DP)",6,1,0,0,7
1951062,1495377,2025-02-19,Senate,"Senate Education Committee Action (DP)",7,0,0,0,7
1951062,1497807,2025-02-24,Senate,"Senate Rules Committee Action (PFC)",0,0,0,0,0
1951062,1503538,2025-03-03,Senate,"Senate - Committee of the Whole (DP)",0,0,0,0,0
1951062,1506121,2025-03-05,Senate,"Senate - Third Reading",29,0,1,0,30
1951062,1520360,2025-03-18,House,"House Education Committee Action (DP)",12,0,0,0,12
1951062,1524891,2025-03-24,House,"House Rules Committee Action (C&P)",8,0,0,0,8
1951062,1545903,2025-02-19,Senate,"Senate Education-Archived and Renamed Education and Transportation as of 04/01/2025 Committee Action (DP)",7,0,0,0,7
1951062,1558918,2025-04-28,House,"House - Third Reading",55,0,5,0,60
1951105,1493455,2025-02-19,Senate,"Senate Health and Human Services Committee Action (DP)",6,1,0,0,7
1951105,1497574,2025-02-24,Senate,"Senate Rules Committee Action (PFC)",0,0,0,0,0
1951105,1501346,2025-02-27,Senate,"Senate - Third Reading",17,12,1,0,30
1951105,1527749,2025-03-26,House,"House Judiciary Committee Action (W/D)",0,0,0,0,0
1951105,1531234,2025-03-31,House,"House Appropriations Committee Action (DPA/SE)",18,0,0,0,18
1951149,1488250,2025-02-12,Senate,"Senate Education Committee Action (HELD)",0,0,0,0,0
1951149,1495330,2025-02-19,Senate,"Senate Education Committee Action (DP)",7,0,0,0,7
1951149,1498339,2025-02-24,Senate,"Senate Rules Committee Action (PFC)",0,0,0,0,0
1951149,1505030,2025-03-04,Senate,"Senate - Committee of the Whole (DP)",0,0,0,0,0
1951149,1507991,2025-03-06,Senate,"Senate - Third Reading",27,0,3,0,30
1951149,1520363,2025-03-18,House,"House Education Committee Action (DP)",12,0,0,0,12
1951149,1524916,2025-03-24,House,"House Rules Committee Action (C&P)",8,0,0,0,8
1951149,1545496,2025-02-19,Senate,"Senate Education-Archived and Renamed Education and Transportation as of 04/01/2025 Committee Action (DP)",7,0,0,0,7
1951149,1551067,2025-04-16,House,"House - Third Reading",58,0,2,0,60
1951232,1487881,2025-02-12,Senate,"Senate Education Committee Action (HELD)",0,0,0,0,0
1951232,1490483,2025-02-12,Senate,"Senate Education Committee Action (DISC/HELD)",0,0,0,0,0
1951232,1495106,2025-02-19,Senate,"Senate Education Committee Action (DPA)",7,0,0,0,7
1951232,1497797,2025-02-24,Senate,"Senate Rules Committee Action (PFC)",0,0,0,0,0
1951232,1503640,2025-03-03,Senate,"Senate - Committee of the Whole (DPA)",0,0,0,0,0
1951232,1506288,2025-03-05,Senate,"Senate - Third Reading",29,0,1,0,30
1951232,1520011,2025-03-18,House,"House Education Committee Action (DP)",12,0,0,0,12
1951232,1538497,2025-04-07,House,"House Rules Committee Action (C&P)",7,0,0,1,8
1951232,1545866,2025-02-19,Senate,"Senate Education-Archived and Renamed Education and Transportation as of 04/01/2025 Committee Action (DPA)",7,0,0,0,7
1951232,1547423,2025-04-14,House,"House - Committee of the Whole (DP)",0,0,0,0,0
1951232,1562196,2025-04-30,House,"House - Third Reading",55,0,5,0,60
1951406,1494429,2025-02-19,Senate,"Senate Public Safety Committee Action (DP)",6,0,1,0,7
1951406,1498398,2025-02-24,Senate,"Senate Rules Committee Action (PFC)",0,0,0,0,0
1951406,1501728,2025-02-27,Senate,"Senate - Third Reading",29,0,1,0,30
1951406,1512152,2025-03-10,House,"House Public Safety & Law Enforcement Committee Action (DP)",14,0,0,1,15
1951406,1519276,2025-03-17,House,"House Rules Committee Action (C&P)",8,0,0,0,8
1951406,1522198,2025-03-19,House,"House - Third Reading",57,0,3,0,60
1951439,1494605,2025-02-19,Senate,"Senate Education Committee Action (DISC/HELD)",0,0,0,0,0
1951439,1499783,2025-02-19,Senate,"Senate Education Committee Action (HELD)",0,0,0,0,0
1951439,1545523,2025-02-19,Senate,"Senate Education-Archived and Renamed Education and Transportation as of 04/01/2025 Committee Action (HELD)",0,0,0,0,0
1951475,1492869,2025-02-18,Senate,"Senate Appropriations Committee Action (DP)",7,2,1,0,10
1951475,1498246,2025-02-24,Senate,"Senate Rules Committee Action (PFC)",0,0,0,0,0
1951475,1501762,2025-02-27,Senate,"Senate - Third Reading",17,12,1,0,30
1951475,1530291,2025-03-27,House,"House Government Committee Action (W/D)",0,0,0,0,0
1951475,1531440,2025-03-31,House,"House Appropriations Committee Action (DPA/SE)",11,7,0,0,18
1951475,1547903,2025-04-14,House,"House Rules Committee Action (C&P)",5,3,0,0,8
1951475,1549982,2025-04-16,House,"House - Committee of the Whole (DPA)",0,0,0,0,0
1951475,1556231,2025-04-23,House,"House - Third Reading",33,27,0,0,60
1951514,1488208,2025-02-12,Senate,"Senate Judiciary and Elections Committee Action (HELD)",0,0,0,0,0
1951514,1495634,2025-02-19,Senate,"Senate Judiciary and Elections Committee Action (DP)",4,3,0,0,7
1951514,1498397,2025-02-24,Senate,"Senate Rules Committee Action (PFC)",0,0,0,0,0
1951514,1504082,2025-03-03,Senate,"Senate - Committee of the Whole (DPA)",0,0,0,0,0
1951514,1507335,2025-03-06,Senate,"Senate - Third Reading",17,9,4,0,30
1951514,1528004,2025-03-26,House,"House Federalism, Military Affairs & Elections Committee Action (DPA)",4,2,0,1,7
1951586,1495431,2025-02-19,Senate,"Senate Education Committee Action (DPA/SE)",7,0,0,0,7
1951586,1498367,2025-02-24,Senate,"Senate Rules Committee Action (PFC)",0,0,0,0,0
1951586,1503846,2025-03-03,Senate,"Senate - Committee of the Whole (DPA)",0,0,0,0,0
1951586,1506839,2025-03-05,Senate,"Senate - Third Reading",17,12,1,0,30
1951586,1520116,2025-03-18,House,"House Education Committee Action (DP)",8,4,0,0,12
1951586,1524974,2025-03-24,House,"House Rules Committee Action (C&P)",8,0,0,0,8
1951586,1532723,2025-04-01,House,"House - Committee of the Whole (DPA)",0,0,0,0,0
1951586,1545683,2025-02-19,Senate,"Senate Education-Archived and Renamed Education and Transportation as of 04/01/2025 Committee Action (DPA/SE)",7,0,0,0,7
1951586,1563864,2025-05-01,House,"House - Third Reading",21,37,2,0,60
1951586,1563865,2025-05-01,House,"House - Reconsider Third Reading",0,0,0,0,0
1951704,1491561,2025-02-17,Senate,"Senate Regulatory Affairs and Government Efficiency Committee Action (W/D)",0,0,0,0,0
1951704,1499363,2025-02-25,Senate,"Senate Appropriations Committee Action (DPA)",7,3,0,0,10
1951704,1503591,2025-03-03,Senate,"Senate Rules Committee Action (PFC)",0,0,0,0,0
1951704,1508260,2025-03-06,Senate,"Senate - Committee of the Whole (DPA)",0,0,0,0,0
1951704,1517579,2025-03-13,Senate,"Senate - Third Reading",18,9,3,0,30
1951704,1526579,2025-03-25,House,"House Regulatory Oversight Committee Action (DP)",3,2,0,0,5
1951704,1530962,2025-03-31,House,"House Rules Committee Action (C&P)",7,0,0,1,8
1951704,1534442,2025-04-02,House,"House - Committee of the Whole (DP)",0,0,0,0,0
1951704,1558905,2025-04-28,House,"House - Third Reading",32,24,4,0,60
1951740,1495471,2025-02-20,Senate,"Senate Regulatory Affairs and Government Efficiency Committee Action (DPA)",7,0,0,0,7
1951740,1499376,2025-02-25,Senate,"Senate Appropriations Committee Action (DP)",9,1,0,0,10
1951740,1503464,2025-03-03,Senate,"Senate Rules Committee Action (PFC)",0,0,0,0,0
1951740,1507852,2025-03-06,Senate,"Senate - Committee of the Whole (DPA)",0,0,0,0,0
1951740,1517078,2025-03-13,Senate,"Senate - Third Reading",23,5,2,0,30
1951740,1527295,2025-03-26,House,"House Government Committee Action (DPA)",7,0,0,0,7
1951792,1488504,2025-02-12,Senate,"Senate Judiciary and Elections Committee Action (DP)",6,0,1,0,7
1951792,1491543,2025-02-17,Senate,"Senate Rules Committee Action (PFC)",0,0,0,0,0
1951792,1501487,2025-02-27,Senate,"Senate - Third Reading",29,0,1,0,30
1951792,1521017,2025-03-19,House,"House Judiciary Committee Action (DP)",5,3,1,0,9
1951792,1524928,2025-03-24,House,"House Rules Committee Action (C&P)",8,0,0,0,8
1951795,1495470,2025-02-20,Senate,"Senate Regulatory Affairs and Government Efficiency Committee Action (DP)",4,2,1,0,7
1951795,1497592,2025-02-24,Senate,"Senate Rules Committee Action (PFC)",0,0,0,0,0
1951795,1501656,2025-02-27,Senate,"Senate - Third Reading",18,11,1,0,30
1951795,1521363,2025-03-19,House,"House Transportation & Infrastructure Committee Action (DPA)",4,1,1,1,7
1951795,1538463,2025-04-07,House,"House Rules Committee Action (C&P)",7,0,0,1,8
1951795,1543853,2025-04-10,House,"House - Committee of the Whole (RET ON CAL)",0,0,0,0,0
1951801,1485803,2025-02-10,Senate,"Senate Finance Committee Action (DP)",7,0,0,0,7
1951801,1491082,2025-02-17,Senate,"Senate Rules Committee Action (PFC)",0,0,0,0,0
1951801,1501437,2025-02-27,Senate,"Senate - Third Reading",29,0,1,0,30
1951801,1520043,2025-03-18,House,"House Commerce Committee Action (DPA/SE)",10,0,0,0,10
1951801,1524849,2025-03-24,House,"House Rules Committee Action (C&P)",8,0,0,0,8
1951801,1528753,2025-03-27,House,"House - Committee of the Whole (DPA)",0,0,0,0,0
1951801,1547535,2025-04-14,House,"House - Third Reading",55,0,5,0,60
1951801,1559869,2025-04-29,Senate,"Senate - Concurrence",0,0,0,0,0
1951801,1559870,2025-04-29,Senate,"Senate - Third Reading",26,3,1,0,30
1951808,1487938,2025-02-12,Senate,"Senate Education Committee Action (DP)",4,3,0,0,7
1951808,1490941,2025-02-17,Senate,"Senate Rules Committee Action (PFC)",0,0,0,0,0
1951808,1498800,2025-02-25,Senate,"Senate - Committee of the Whole (RETAINED)",0,0,0,0,0
1951808,1509221,2025-03-10,Senate,"Senate - Committee of the Whole (DPA)",0,0,0,0,0
1951808,1517058,2025-03-13,Senate,"Senate - Third Reading",26,1,3,0,30
1951808,1526742,2025-03-25,House,"House Education Committee Action (DP)",12,0,0,0,12
1951808,1538447,2025-04-07,House,"House Rules Committee Action (C&P)",7,0,0,1,8
1951808,1541606,2025-04-09,House,"House - Committee of the Whole (DP)",0,0,0,0,0
1951808,1545856,2025-02-12,Senate,"Senate Education-Archived and Renamed Education and Transportation as of 04/01/2025 Committee Action (DP)",4,3,0,0,7
1951808,1549149,2025-04-15,House,"House - Third Reading",52,0,8,0,60
1951817,1493578,2025-02-18,Senate,"Senate Natural Resources Committee Action (DP)",7,0,1,0,8
1951817,1498244,2025-02-24,Senate,"Senate Rules Committee Action (PFC)",0,0,0,0,0
1951817,1509185,2025-03-10,Senate,"Senate - Third Reading",24,3,3,0,30
1951817,1520465,2025-03-18,House,"House Natural Resources, Energy & Water Committee Action (DP)",6,3,0,1,10
1951817,1547866,2025-04-14,House,"House Rules Committee Action (C&P)",8,0,0,0,8
1951817,1564120,2025-05-01,House,"House - Third Reading",16,42,2,0,60
1951823,1494579,2025-02-19,Senate,"Senate Judiciary and Elections Committee Action (DP)",4,3,0,0,7
1951823,1497557,2025-02-24,Senate,"Senate Rules Committee Action (PFC)",0,0,0,0,0
1951823,1503364,2025-03-03,Senate,"Senate - Committee of the Whole (DP)",0,0,0,0,0
1951823,1506505,2025-03-05,Senate,"Senate - Third Reading",17,12,1,0,30
1951838,1493945,2025-02-19,Senate,"Senate Health and Human Services Committee Action (DP)",5,0,2,0,7
1951838,1497826,2025-02-24,Senate,"Senate Rules Committee Action (PFC)",0,0,0,0,0
1951838,1501716,2025-02-27,Senate,"Senate - Committee of the Whole (RETAINED)",0,0,0,0,0
1951838,1508037,2025-03-06,Senate,"Senate - Committee of the Whole (DPA)",0,0,0,0,0
1951838,1517588,2025-03-13,Senate,"Senate - Third Reading",22,5,3,0,30
1951838,1525685,2025-03-24,House,"House Health & Human Services Committee Action (DP)",8,2,1,1,12
1951849,1492313,2025-02-17,Senate,"Senate Finance Committee Action (DPA/SE)",5,2,0,0,7
1951849,1495967,2025-02-20,Senate,"Senate Appropriations Committee Action (W/D)",0,0,0,0,0
1951849,1498188,2025-02-24,Senate,"Senate Rules Committee Action (PFC)",0,0,0,0,0
1951884,1494258,2025-02-19,Senate,"Senate Public Safety Committee Action (DP)",5,1,1,0,7
1951884,1498134,2025-02-24,Senate,"Senate Rules Committee Action (PFC)",0,0,0,0,0
1951884,1508066,2025-03-06,Senate,"Senate - Committee of the Whole (DPA)",0,0,0,0,0
1951884,1517575,2025-03-13,Senate,"Senate - Third Reading",17,11,2,0,30
1951884,1527988,2025-03-26,House,"House Transportation & Infrastructure Committee Action (DP)",5,1,0,1,7
1951884,1532459,2025-04-01,House,"House Rules Committee Action (C&P)",7,0,0,1,8
1951884,1550234,2025-04-16,House,"House - Committee of the Whole (DP)",0,0,0,0,0
1951884,1567041,2025-05-07,House,"House - Third Reading",27,31,2,0,60
1951884,1567464,2025-05-07,House,"House - Reconsider Third Reading",0,0,0,0,0
1951894,1486945,2025-02-11,Senate,"Senate Natural Resources Committee Action (DP)",5,2,1,0,8
1951894,1490874,2025-02-17,Senate,"Senate Rules Committee Action (PFC)",0,0,0,0,0
1951894,1503252,2025-03-03,Senate,"Senate - Committee of the Whole (DPA)",0,0,0,0,0
1951894,1506362,2025-03-05,Senate,"Senate - Third Reading",17,12,1,0,30
1951894,1526778,2025-03-25,House,"House Natural Resources, Energy & Water Committee Action (DPA)",10,0,0,0,10
1951894,1538496,2025-04-07,House,"House Rules Committee Action (C&P)",7,0,0,1,8
1951894,1559186,2025-04-28,House,"House - Committee of the Whole (DPA)",0,0,0,0,0
1951894,1563983,2025-05-01,House,"House - Third Reading",54,0,6,0,60
1951904,1495983,2025-02-20,House,"House Natural Resources, Energy & Water Committee Action (DPA/SE)",8,0,0,2,10
1951904,1497425,2025-02-24,House,"House Rules Committee Action (C&P)",7,0,0,1,8
1951904,1501538,2025-02-27,House,"House - Committee of the Whole (DPA)",0,0,0,0,0
1951904,1505388,2025-03-04,House,"House - Third Reading",44,14,2,0,60
1951904,1527442,2025-03-25,Senate,"Senate Natural Resources Committee Action (DP)",6,0,2,0,8
1951904,1531639,2025-03-31,Senate,"Senate Rules Committee Action (PFC)",0,0,0,0,0
1951904,1556830,2025-04-24,Senate,"Senate - Committee of the Whole (DP)",0,0,0,0,0
1951904,1562650,2025-04-30,Senate,"Senate - Third Reading",27,0,3,0,30
1951911,1494034,2025-02-19,Senate,"Senate Health and Human Services Committee Action (DPA)",5,0,2,0,7
1951911,1498393,2025-02-24,Senate,"Senate Rules Committee Action (PFC)",0,0,0,0,0
1951911,1501722,2025-02-27,Senate,"Senate - Committee of the Whole (DPA)",0,0,0,0,0
1951911,1505431,2025-03-04,Senate,"Senate - Third Reading",23,4,3,0,30
1951911,1525456,2025-03-24,House,"House Health & Human Services Committee Action (DPA/SE)",9,2,0,1,12
1951911,1547271,2025-04-14,House,"House Rules Committee Action (C&P)",8,0,0,0,8
1951911,1553311,2025-04-22,House,"House - Committee of the Whole (DPA)",0,0,0,0,0
1951922,1491704,2025-02-17,Senate,"Senate Finance Committee Action (DP)",7,0,0,0,7
1951922,1497519,2025-02-24,Senate,"Senate Rules Committee Action (PFC)",0,0,0,0,0
1951922,1501645,2025-02-27,Senate,"Senate - Third Reading",29,0,1,0,30
1951922,1515867,2025-03-12,House,"House Ways & Means Committee Action (DP)",7,0,0,2,9
1951922,1518813,2025-03-17,House,"House Rules Committee Action (C&P)",8,0,0,0,8
1951922,1521446,2025-03-19,House,"House - Third Reading",55,2,3,0,60
1951930,1492954,2025-02-18,Senate,"Senate Natural Resources Committee Action (DP)",4,3,1,0,8
1951930,1497878,2025-02-24,Senate,"Senate Rules Committee Action (PFC)",0,0,0,0,0
1951930,1501310,2025-02-27,Senate,"Senate - Committee of the Whole (DP)",0,0,0,0,0
1951930,1505134,2025-03-04,Senate,"Senate - Third Reading",16,11,3,0,30
1951930,1527143,2025-03-25,House,"House Natural Resources, Energy & Water Committee Action (DP)",6,3,0,1,10
1951930,1530961,2025-03-31,House,"House Rules Committee Action (C&P)",7,0,0,1,8
1951930,1535413,2025-04-02,House,"House - Committee of the Whole (DPA)",0,0,0,0,0
1951930,1551641,2025-04-17,House,"House - Third Reading",33,24,3,0,60
1951947,1495939,2025-02-20,Senate,"Senate Regulatory Affairs and Government Efficiency Committee Action (DP)",7,0,0,0,7
1951947,1497596,2025-02-24,Senate,"Senate Rules Committee Action (PFC)",0,0,0,0,0
1951947,1505969,2025-03-05,Senate,"Senate - Committee of the Whole (RETAINED)",0,0,0,0,0
1951947,1507308,2025-03-06,Senate,"Senate - Committee of the Whole (DPA)",0,0,0,0,0
1951947,1517385,2025-03-13,Senate,"Senate - Third Reading",27,0,3,0,30
1951947,1527718,2025-03-26,House,"House Government Committee Action (DP)",5,1,1,0,7
1951947,1531326,2025-03-31,House,"House Rules Committee Action (C&P)",7,0,0,1,8
1951953,1493812,2025-02-18,Senate,"Senate Natural Resources Committee Action (DP)",4,3,1,0,8
1951953,1498105,2025-02-24,Senate,"Senate Rules Committee Action (PFC)",0,0,0,0,0
1951953,1501869,2025-02-27,Senate,"Senate - Committee of the Whole (DP)",0,0,0,0,0
1951953,1504506,2025-03-04,Senate,"Senate - Third Reading",16,11,3,0,30
1951953,1520050,2025-03-18,House,"House Natural Resources, Energy & Water Committee Action (DP)",5,4,0,1,10
1951953,1524879,2025-03-24,House,"House Rules Committee Action (C&P)",8,0,0,0,8
1951953,1531530,2025-03-31,House,"House - Committee of the Whole (DP)",0,0,0,0,0
1951953,1565513,2025-05-05,House,"House - Third Reading",32,25,3,0,60
1951960,1496116,2025-02-20,House,"House Natural Resources, Energy & Water Committee Action (DP)",8,0,1,1,10
1951960,1497404,2025-02-24,House,"House Rules Committee Action (C&P)",7,0,0,1,8
1951960,1501583,2025-02-27,House,"House - Committee of the Whole (DP)",0,0,0,0,0
1951960,1503511,2025-03-03,House,"House - Third Reading",58,0,2,0,60
1951960,1520317,2025-03-18,Senate,"Senate Natural Resources Committee Action (DP)",8,0,0,0,8
1951960,1525198,2025-03-24,Senate,"Senate Rules Committee Action (PFC)",0,0,0,0,0
1951960,1529109,2025-03-27,Senate,"Senate - Third Reading",26,0,3,0,29
1951976,1485813,2025-02-10,Senate,"Senate Finance Committee Action (DP)",7,0,0,0,7
1951976,1491020,2025-02-17,Senate,"Senate Rules Committee Action (PFC)",0,0,0,0,0
1951976,1501488,2025-02-27,Senate,"Senate - Third Reading",29,0,1,0,30
1951976,1522258,2025-03-19,House,"House Commerce Committee Action (W/D)",0,0,0,0,0
1951976,1527686,2025-03-26,House,"House Judiciary Committee Action (DPA/SE)",7,2,0,0,9
1951976,1538424,2025-04-07,House,"House Rules Committee Action (C&P)",7,0,0,1,8
1952000,1495355,2025-02-20,Senate,"Senate Regulatory Affairs and Government Efficiency Committee Action (DP)",6,0,1,0,7
1952000,1498231,2025-02-24,Senate,"Senate Rules Committee Action (PFC)",0,0,0,0,0
1952000,1501572,2025-02-27,Senate,"Senate - Third Reading",29,0,1,0,30
1952000,1512366,2025-03-10,House,"House Health & Human Services Committee Action (DP)",7,4,0,1,12
1952000,1519211,2025-03-17,House,"House Rules Committee Action (C&P)",8,0,0,0,8
1952000,1526498,2025-03-25,House,"House - Committee of the Whole (DP)",0,0,0,0,0
1952000,1559093,2025-04-28,House,"House - Third Reading",37,18,5,0,60
1952006,1494640,2025-02-19,Senate,"Senate Education Committee Action (DP)",7,0,0,0,7
1952006,1498379,2025-02-24,Senate,"Senate Rules Committee Action (PFC)",0,0,0,0,0
1952006,1511665,2025-03-10,Senate,"Senate - Third Reading",24,3,3,0,30
1952006,1545827,2025-02-19,Senate,"Senate Education-Archived and Renamed Education and Transportation as of 04/01/2025 Committee Action (DP)",7,0,0,0,7
1952027,1493209,2025-02-19,Senate,"Senate Health and Human Services Committee Action (DP)",5,0,2,0,7
1952027,1499466,2025-02-25,Senate,"Senate Appropriations Committee Action (DP)",9,1,0,0,10
1952027,1503220,2025-03-03,Senate,"Senate Rules Committee Action (PFC)",0,0,0,0,0
1952027,1507749,2025-03-06,Senate,"Senate - Committee of the Whole (DP)",0,0,0,0,0
1952027,1517152,2025-03-13,Senate,"Senate - Third Reading",25,2,3,0,30
1952034,1495649,2025-02-19,Senate,"Senate Judiciary and Elections Committee Action (DP)",4,3,0,0,7
1952034,1498040,2025-02-24,Senate,"Senate Rules Committee Action (PFC)",0,0,0,0,0
1952034,1509281,2025-03-10,Senate,"Senate - Third Reading",17,10,3,0,30
1952034,1528456,2025-03-26,House,"House Federalism, Military Affairs & Elections Committee Action (DP)",4,3,0,0,7
1952034,1547871,2025-04-14,House,"House Rules Committee Action (C&P)",8,0,0,0,8
1952034,1564119,2025-05-01,House,"House - Third Reading",31,27,2,0,60
1952072,1493539,2025-02-19,Senate,"Senate Government Committee Action (DPA)",6,1,0,0,7
1952072,1498388,2025-02-24,Senate,"Senate Rules Committee Action (PFC)",0,0,0,0,0
1952072,1504011,2025-03-03,Senate,"Senate - Committee of the Whole (DPA)",0,0,0,0,0
1952072,1506856,2025-03-05,Senate,"Senate - Third Reading",24,5,1,0,30
1952072,1527154,2025-03-25,House,"House Commerce Committee Action (DPA)",6,3,0,1,10
1952072,1547895,2025-04-14,House,"House Rules Committee Action (C&P)",8,0,0,0,8
1952072,1550243,2025-04-16,House,"House - Committee of the Whole (RET ON CAL)",0,0,0,0,0
1952072,1560792,2025-04-29,House,"House - Committee of the Whole (DPA)",0,0,0,0,0
1952072,1564116,2025-05-01,House,"House - Third Reading",25,33,2,0,60
1952092,1492960,2025-02-18,Senate,"Senate Natural Resources Committee Action (DPA/SE)",4,3,1,0,8
1952092,1497549,2025-02-24,Senate,"Senate Rules Committee Action (PFC)",0,0,0,0,0
1952092,1509568,2025-03-10,Senate,"Senate - Committee of the Whole (DPA)",0,0,0,0,0
1952092,1517257,2025-03-13,Senate,"Senate - Third Reading",18,10,2,0,30
1952092,1526719,2025-03-25,House,"House Natural Resources, Energy & Water Committee Action (DPA)",6,4,0,0,10
1952092,1531084,2025-03-31,House,"House Rules Committee Action (C&P)",7,0,0,1,8
1952107,1488106,2025-02-12,House,"House Transportation & Infrastructure Committee Action (DP)",6,1,0,0,7
1952107,1490894,2025-02-17,House,"House Rules Committee Action (C&P)",5,2,0,1,8
1952107,1494655,2025-02-20,House,"House - Committee of the Whole (DPA)",0,0,0,0,0
1952107,1499052,2025-02-25,House,"House - Third Reading",50,10,0,0,60
1952107,1516273,2025-03-12,Senate,"Senate Judiciary and Elections Committee Action (DPA)",4,3,0,0,7
1952107,1518784,2025-03-17,Senate,"Senate Rules Committee Action (PFC)",0,0,0,0,0
1952107,1565725,2025-05-06,Senate,"Senate - Committee of the Whole (DPA)",0,0,0,0,0
1952107,1565726,2025-05-06,Senate,"Senate - Third Reading",18,10,2,0,30
1952107,1567443,2025-05-07,House,"House - Concurrence",0,0,0,0,0
1952107,1567444,2025-05-07,House,"House - Third Reading",46,12,2,0,60
1952121,1491736,2025-02-17,Senate,"Senate Military Affairs and Border Security Committee Action (DP)",6,1,0,0,7
1952121,1499366,2025-02-25,Senate,"Senate Appropriations Committee Action (DP)",7,3,0,0,10
1952121,1503975,2025-03-03,Senate,"Senate Rules Committee Action (PFC)",0,0,0,0,0
1952121,1507386,2025-03-06,Senate,"Senate - Committee of the Whole (DP)",0,0,0,0,0
1952121,1517587,2025-03-13,Senate,"Senate - Third Reading",18,9,3,0,30
1952121,1525686,2025-03-24,House,"House Public Safety & Law Enforcement Committee Action (DPA)",9,5,0,1,15
1952127,1489528,2025-02-13,Senate,"Senate Regulatory Affairs and Government Efficiency Committee Action (DP)",6,1,0,0,7
1952127,1497585,2025-02-24,Senate,"Senate Rules Committee Action (PFC)",0,0,0,0,0
1952127,1504643,2025-03-04,Senate,"Senate - Committee of the Whole (DPA)",0,0,0,0,0
1952127,1506510,2025-03-05,Senate,"Senate - Third Reading",23,6,1,0,30
1952127,1529834,2025-03-27,House,"House Commerce Committee Action (W/D)",0,0,0,0,0
1952144,1494596,2025-02-19,Senate,"Senate Judiciary and Elections Committee Action (DP)",4,3,0,0,7
1952144,1497600,2025-02-24,Senate,"Senate Rules Committee Action (PFC)",0,0,0,0,0
1952144,1503432,2025-03-03,Senate,"Senate - Committee of the Whole (DPA)",0,0,0,0,0
1952144,1506060,2025-03-05,Senate,"Senate - Third Reading",17,12,1,0,30
1952144,1521662,2025-03-19,House,"House Federalism, Military Affairs & Elections Committee Action (DP)",4,1,0,2,7
1952144,1524821,2025-03-24,House,"House Rules Committee Action (C&P)",8,0,0,0,8
1952144,1550184,2025-04-16,House,"House - Third Reading",33,25,2,0,60
1952182,1487047,2025-02-11,Senate,"Senate Natural Resources Committee Action (DP)",5,2,1,0,8
1952182,1490849,2025-02-17,Senate,"Senate Rules Committee Action (PFC)",0,0,0,0,0
1952182,1512500,2025-03-10,Senate,"Senate - Committee of the Whole (DP)",0,0,0,0,0
1952182,1517593,2025-03-13,Senate,"Senate - Third Reading",17,11,2,0,30
1952182,1527146,2025-03-25,House,"House Natural Resources, Energy & Water Committee Action (DPA/SE)",9,0,0,1,10
1952182,1547901,2025-04-14,House,"House Rules Committee Action (C&P)",8,0,0,0,8
1952182,1550989,2025-04-17,House,"House - Committee of the Whole (DPA)",0,0,0,0,0
1952182,1558896,2025-04-28,House,"House - Third Reading",51,5,4,0,60
1952182,1565825,2025-05-06,Senate,"Senate - Concurrence",0,0,0,0,0
1952182,1565826,2025-05-06,Senate,"Senate - Third Reading",25,3,2,0,30
1952188,1493631,2025-02-19,Senate,"Senate Government Committee Action (DP)",4,3,0,0,7
1952188,1497591,2025-02-24,Senate,"Senate Rules Committee Action (PFC)",0,0,0,0,0
1952188,1504378,2025-03-04,Senate,"Senate - Committee of the Whole (DPA)",0,0,0,0,0
1952188,1507210,2025-03-06,Senate,"Senate - Third Reading",16,11,3,0,30
1952188,1526670,2025-03-25,House,"House Natural Resources, Energy & Water Committee Action (DP)",6,4,0,0,10
1952188,1538479,2025-04-07,House,"House Rules Committee Action (C&P)",7,0,0,1,8
1952188,1543915,2025-04-10,House,"House - Committee of the Whole (DP)",0,0,0,0,0
1952188,1550089,2025-04-16,House,"House - Third Reading",33,25,2,0,60
1952207,1492109,2025-02-17,Senate,"Senate Finance Committee Action (DP)",6,1,0,0,7
1952207,1498050,2025-02-24,Senate,"Senate Rules Committee Action (PFC)",0,0,0,0,0
1952207,1501566,2025-02-27,Senate,"Senate - Committee of the Whole (DPA)",0,0,0,0,0
1952207,1504982,2025-03-04,Senate,"Senate - Third Reading",24,3,3,0,30
1952207,1519995,2025-03-18,House,"House Commerce Committee Action (DPA)",9,1,0,0,10
1952207,1532504,2025-04-01,House,"House Rules Committee Action (C&P)",7,0,0,1,8
1952207,1542152,2025-04-09,House,"House - Committee of the Whole (DPA)",0,0,0,0,0
1952207,1543628,2025-04-10,House,"House - Third Reading",40,19,1,0,60
1952207,1548440,2025-04-15,Senate,"Senate - Concurrence",0,0,0,0,0
1952207,1549031,2025-04-15,Senate,"Senate - Third Reading",29,1,0,0,30
1952214,1485812,2025-02-10,Senate,"Senate Finance Committee Action (DP)",7,0,0,0,7
1952214,1491501,2025-02-17,Senate,"Senate Rules Committee Action (PFC)",0,0,0,0,0
1952214,1498878,2025-02-25,Senate,"Senate - Committee of the Whole (DPA)",0,0,0,0,0
1952214,1500548,2025-02-26,Senate,"Senate - Third Reading",28,0,2,0,30
1952214,1521965,2025-03-19,House,"House Commerce Committee Action (W/D)",0,0,0,0,0
1952214,1527596,2025-03-26,House,"House International Trade Committee Action (DPA/SE)",8,0,0,2,10
1952214,1532446,2025-04-01,House,"House Rules Committee Action (C&P)",7,0,0,1,8
1952214,1538574,2025-04-07,House,"House - Committee of the Whole (RET ON CAL)",0,0,0,0,0
1952214,1541728,2025-04-09,House,"House - Committee of the Whole (DPA)",0,0,0,0,0
1952214,1541729,2025-04-09,House,"House - Representative Chaplik to show the bill failed to pass",16,39,5,0,60
1952214,1543980,2025-04-10,House,"House - Third Reading",40,19,1,0,60
1952214,1548860,2025-04-15,Senate,"Senate - Concurrence",0,0,0,0,0
1952214,1548861,2025-04-15,Senate,"Senate - Third Reading",17,13,0,0,30
1952220,1495016,2025-02-19,Senate,"Senate Judiciary and Elections Committee Action (DP)",4,3,0,0,7
1952220,1498210,2025-02-24,Senate,"Senate Rules Committee Action (PFC)",0,0,0,0,0
1952220,1501379,2025-02-27,Senate,"Senate - Committee of the Whole (DPA)",0,0,0,0,0
1952220,1505109,2025-03-04,Senate,"Senate - Third Reading",17,10,3,0,30
1952236,1488569,2025-02-12,Senate,"Senate Education Committee Action (HELD)",0,0,0,0,0
1952236,1490721,2025-02-12,Senate,"Senate Education Committee Action (DISC/HELD)",0,0,0,0,0
1952236,1545646,2025-02-19,Senate,"Senate Education-Archived and Renamed Education and Transportation as of 04/01/2025 Committee Action (DISC/HELD)",0,0,0,0,0
1952239,1493104,2025-02-18,Senate,"Senate Natural Resources Committee Action (DPA)",4,3,1,0,8
1952239,1498318,2025-02-24,Senate,"Senate Rules Committee Action (PFC)",0,0,0,0,0
1952239,1503602,2025-03-03,Senate,"Senate - Committee of the Whole (DPA)",0,0,0,0,0
1952268,1492963,2025-02-18,Senate,"Senate Natural Resources Committee Action (DP)",7,0,1,0,8
1952268,1498180,2025-02-24,Senate,"Senate Rules Committee Action (PFC)",0,0,0,0,0
1952268,1509159,2025-03-10,Senate,"Senate - Third Reading",24,3,3,0,30
1952268,1518670,2025-03-17,House,"House Land, Agriculture & Rural Affairs Committee Action (DP)",8,0,0,1,9
1952270,1488124,2025-02-12,Senate,"Senate Education Committee Action (HELD)",0,0,0,0,0
1952270,1494555,2025-02-19,Senate,"Senate Education Committee Action (DP)",4,3,0,0,7
1952270,1497546,2025-02-24,Senate,"Senate Rules Committee Action (PFC)",4,3,0,0,7
1952270,1501255,2025-02-27,Senate,"Senate - Committee of the Whole (DP)",0,0,0,0,0
1952270,1504889,2025-03-04,Senate,"Senate - Third Reading",16,11,3,0,30
1952270,1520511,2025-03-18,House,"House Education Committee Action (DP)",7,5,0,0,12
1952270,1524787,2025-03-24,House,"House Rules Committee Action (C&P)",8,0,0,0,8
1952270,1533274,2025-04-01,House,"House - Committee of the Whole (DP)",0,0,0,0,0
1952270,1545601,2025-02-19,Senate,"Senate Education-Archived and Renamed Education and Transportation as of 04/01/2025 Committee Action (DP)",4,3,0,0,7
1952270,1559077,2025-04-28,House,"House - Third Reading",32,23,5,0,60
1952271,1493822,2025-02-19,Senate,"Senate Health and Human Services Committee Action (DP)",6,0,1,0,7
1952271,1499534,2025-02-25,Senate,"Senate Appropriations Committee Action (DP)",10,0,0,0,10
1952271,1503630,2025-03-03,Senate,"Senate Rules Committee Action (PFC)",0,0,0,0,0
1952271,1507752,2025-03-06,Senate,"Senate - Committee of the Whole (DP)",0,0,0,0,0
1952271,1517442,2025-03-13,Senate,"Senate - Third Reading",21,6,3,0,30
1952278,1487958,2025-02-12,Senate,"Senate Judiciary and Elections Committee Action (DP)",4,2,1,0,7
1952278,1491564,2025-02-17,Senate,"Senate Rules Committee Action (PFC)",0,0,0,0,0
1952278,1499418,2025-02-25,Senate,"Senate - Committee of the Whole (DP)",0,0,0,0,0
1952278,1500950,2025-02-26,Senate,"Senate - Third Reading",17,11,2,0,30
1952278,1520851,2025-03-19,House,"House Judiciary Committee Action (DP)",5,2,2,0,9
1952278,1524909,2025-03-24,House,"House Rules Committee Action (C&P)",8,0,0,0,8
1952278,1533820,2025-04-01,House,"House - Committee of the Whole (DP)",0,0,0,0,0
1952278,1564071,2025-05-01,House,"House - Third Reading",25,33,2,0,60
1952278,1564072,2025-05-01,House,"House - Reconsider Third Reading",0,0,0,0,0
1952281,1488371,2025-02-12,Senate,"Senate Education Committee Action (DP)",5,0,2,0,7
1952281,1491626,2025-02-17,Senate,"Senate Rules Committee Action (PFC)",0,0,0,0,0
1952281,1508209,2025-03-06,Senate,"Senate - Committee of the Whole (DPA)",0,0,0,0,0
1952281,1517566,2025-03-13,Senate,"Senate - Third Reading",26,1,3,0,30
1952281,1526675,2025-03-25,House,"House Education Committee Action (DPA)",11,1,0,0,12
1952281,1538546,2025-04-07,House,"House Rules Committee Action (C&P)",7,0,0,1,8
1952281,1541765,2025-04-09,House,"House - Committee of the Whole (DPA)",0,0,0,0,0
1952281,1545521,2025-02-12,Senate,"Senate Education-Archived and Renamed Education and Transportation as of 04/01/2025 Committee Action (DP)",5,0,2,0,7
1952281,1547533,2025-04-14,House,"House - Third Reading",51,4,5,0,60
1952281,1563797,2025-05-01,Senate,"Senate - Concurrence",0,0,0,0,0
1952281,1563798,2025-05-01,Senate,"Senate - Third Reading",22,0,8,0,30
1952291,1491402,2025-02-17,House,"House Public Safety & Law Enforcement Committee Action (HELD)",0,0,0,0,0
1952291,1495265,2025-02-20,House,"House Public Safety & Law Enforcement Committee Action (DPA)",10,0,3,2,15
1952291,1497305,2025-02-24,House,"House Rules Committee Action (C&P)",7,0,0,1,8
1952291,1499960,2025-02-26,House,"House - Committee of the Whole (DPA)",0,0,0,0,0
1952291,1503304,2025-03-03,House,"House - Third Reading",44,13,3,0,60
1952291,1519095,2025-03-17,Senate,"Senate Military Affairs and Border Security Committee Action (DP)",5,1,1,0,7
1952291,1524802,2025-03-24,Senate,"Senate Rules Committee Action (PFC)",0,0,0,0,0
1952291,1550001,2025-04-16,Senate,"Senate - Third Reading",25,4,1,0,30
1952292,1488354,2025-02-12,Senate,"Senate Judiciary and Elections Committee Action (DP)",4,2,1,0,7
1952292,1491540,2025-02-17,Senate,"Senate Rules Committee Action (PFC)",0,0,0,0,0
1952292,1499593,2025-02-25,Senate,"Senate - Committee of the Whole (RETAINED)",0,0,0,0,0
1952292,1501132,2025-02-27,Senate,"Senate - Committee of the Whole (DPA)",0,0,0,0,0
1952292,1507884,2025-03-06,Senate,"Senate - Third Reading",17,9,4,0,30
1952292,1527638,2025-03-26,House,"House Judiciary Committee Action (DP)",4,2,2,1,9
1952292,1538317,2025-04-07,House,"House Rules Committee Action (C&P)",7,0,0,1,8
1952292,1544255,2025-04-10,House,"House - Committee of the Whole (DP)",0,0,0,0,0
1952296,1495369,2025-02-19,Senate,"Senate Judiciary and Elections Committee Action (DP)",4,3,0,0,7
1952296,1498039,2025-02-24,Senate,"Senate Rules Committee Action (PFC)",0,0,0,0,0
1952296,1503778,2025-03-03,Senate,"Senate - Committee of the Whole (DP)",0,0,0,0,0
1952296,1506840,2025-03-05,Senate,"Senate - Third Reading",17,12,1,0,30
1952296,1527746,2025-03-26,House,"House Judiciary Committee Action (DPA)",6,3,0,0,9
1952296,1539013,2025-04-07,House,"House Rules Committee Action (C&P)",7,0,0,1,8
1952296,1549279,2025-04-15,House,"House - Committee of the Whole (DPA)",0,0,0,0,0
1952296,1555052,2025-04-23,House,"House - Third Reading",33,27,0,0,60
1952296,1566373,2025-05-06,Senate,"Senate - Concurrence",0,0,0,0,0
1952296,1566374,2025-05-06,Senate,"Senate - Third Reading",17,11,2,0,30
1952301,1493366,2025-02-18,Senate,"Senate Natural Resources Committee Action (DP)",6,1,1,0,8
1952301,1498387,2025-02-24,Senate,"Senate Rules Committee Action (PFC)",0,0,0,0,0
1952301,1503730,2025-03-03,Senate,"Senate - Committee of the Whole (RETAINED)",0,0,0,0,0
1952301,1507992,2025-03-06,Senate,"Senate - Committee of the Whole (RETAINED)",0,0,0,0,0
1952301,1509170,2025-03-10,Senate,"Senate - Committee of the Whole (DPA)",0,0,0,0,0
1952301,1517413,2025-03-13,Senate,"Senate - Third Reading",18,9,3,0,30
1952301,1517414,2025-03-13,Senate,"Senate - Reconsider Third Reading",26,0,4,0,30
1952308,1492917,2025-02-18,Senate,"Senate Appropriations Committee Action (DP)",8,1,1,0,10
1952308,1498069,2025-02-24,Senate,"Senate Rules Committee Action (PFC)",0,0,0,0,0
1952308,1502110,2025-02-27,Senate,"Senate - Third Reading",28,1,1,0,30
1952308,1522029,2025-03-19,House,"House Appropriations Committee Action (HELD)",0,0,0,0,0
1952308,1531343,2025-03-31,House,"House Appropriations Committee Action (DPA)",18,0,0,0,18
1952310,1492900,2025-02-18,Senate,"Senate Appropriations Committee Action (DP)",9,0,1,0,10
1952310,1498386,2025-02-24,Senate,"Senate Rules Committee Action (PFC)",0,0,0,0,0
1952310,1501744,2025-02-27,Senate,"Senate - Third Reading",24,5,1,0,30
1952310,1525354,2025-03-24,House,"House Public Safety & Law Enforcement Committee Action (FAILED)",7,7,0,1,15
1952310,1528533,2025-03-26,House,"House Public Safety & Law Enforcement Committee Action (W/D)",0,0,0,0,0
1952310,1531359,2025-03-31,House,"House Appropriations Committee Action (DP)",11,6,0,1,18
1952312,1494565,2025-02-19,Senate,"Senate Judiciary and Elections Committee Action (DP)",4,3,0,0,7
1952312,1497587,2025-02-24,Senate,"Senate Rules Committee Action (PFC)",0,0,0,0,0
1952312,1503394,2025-03-03,Senate,"Senate - Committee of the Whole (DP)",0,0,0,0,0
1952312,1507354,2025-03-06,Senate,"Senate - Third Reading",16,9,5,0,30
1952312,1527599,2025-03-26,House,"House Judiciary Committee Action (DP)",6,3,0,0,9
1952312,1538512,2025-04-07,House,"House Rules Committee Action (C&P)",7,0,0,1,8
1952312,1543992,2025-04-10,House,"House - Committee of the Whole (DP)",0,0,0,0,0
1952312,1543993,2025-04-10,House,"House - Representative Marquez to include the Marquez floor amendment",26,31,3,0,60
1952312,1550082,2025-04-16,House,"House - Third Reading",31,24,5,0,60
1952325,1488151,2025-02-12,Senate,"Senate Judiciary and Elections Committee Action (DP)",5,1,1,0,7
1952325,1490926,2025-02-17,Senate,"Senate Rules Committee Action (PFC)",0,0,0,0,0
1952325,1501689,2025-02-27,Senate,"Senate - Third Reading",27,2,1,0,30
1952325,1527255,2025-03-26,House,"House Judiciary Committee Action (DP)",6,0,1,2,9
1952325,1547331,2025-04-14,House,"House Rules Committee Action (C&P)",8,0,0,0,8
1952325,1564101,2025-05-01,House,"House - Third Reading",54,0,6,0,60
1952341,1488385,2025-02-12,Senate,"Senate Education Committee Action (DPA)",4,3,0,0,7
1952341,1491554,2025-02-17,Senate,"Senate Rules Committee Action (PFC)",0,0,0,0,0
1952341,1499134,2025-02-25,Senate,"Senate - Committee of the Whole (DPA)",0,0,0,0,0
1952341,1500114,2025-02-26,Senate,"Senate - Third Reading",17,11,2,0,30
1952341,1514556,2025-03-11,House,"House Education Committee Action (HELD)",0,0,0,0,0
1952341,1545799,2025-02-12,Senate,"Senate Education-Archived and Renamed Education and Transportation as of 04/01/2025 Committee Action (DPA)",4,3,0,0,7
1952358,1494029,2025-02-19,Senate,"Senate Public Safety Committee Action (DP)",6,0,1,0,7
1952358,1498167,2025-02-24,Senate,"Senate Rules Committee Action (PFC)",0,0,0,0,0
1952358,1501424,2025-02-27,Senate,"Senate - Third Reading",23,6,1,0,30
1952358,1528172,2025-03-26,House,"House Transportation & Infrastructure Committee Action (DP)",5,0,0,2,7
1952358,1547879,2025-04-14,House,"House Rules Committee Action (C&P)",8,0,0,0,8
1952358,1566994,2025-05-06,House,"House - Third Reading",33,21,6,0,60
1952359,1487870,2025-02-12,Senate,"Senate Judiciary and Elections Committee Action (DP)",4,2,1,0,7
1952359,1509276,2025-03-10,Senate,"Senate Rules Committee Action (PFC)",5,3,1,0,9
1952365,1506134,2025-03-05,Senate,"Senate Health and Human Services Committee Action (DISC/ONLY)",0,0,0,0,0
1952366,1494558,2025-02-19,Senate,"Senate Judiciary and Elections Committee Action (DPA)",6,0,1,0,7
1952366,1497520,2025-02-24,Senate,"Senate Rules Committee Action (PFC)",0,0,0,0,0
1952366,1509163,2025-03-10,Senate,"Senate - Committee of the Whole (DPA)",0,0,0,0,0
1952366,1517047,2025-03-13,Senate,"Senate - Third Reading",27,0,3,0,30
1952366,1527738,2025-03-26,House,"House Government Committee Action (HELD)",0,0,0,0,0
1952366,1530329,2025-03-27,House,"House Government Committee Action (DP)",7,0,0,0,7
1952370,1491692,2025-02-17,House,"House Public Safety & Law Enforcement Committee Action (DPA)",13,0,0,2,15
1952370,1497264,2025-02-24,House,"House Rules Committee Action (C&P)",7,0,0,1,8
1952370,1501422,2025-02-27,House,"House - Committee of the Whole (DPA)",0,0,0,0,0
1952370,1504606,2025-03-04,House,"House - Third Reading",58,0,2,0,60
1952370,1521657,2025-03-19,Senate,"Senate Public Safety Committee Action (DP)",5,0,2,0,7
1952370,1524767,2025-03-24,Senate,"Senate Rules Committee Action (PFC)",0,0,0,0,0
1952370,1566355,2025-05-06,Senate,"Senate - Third Reading",28,0,2,0,30
1952383,1494570,2025-02-19,Senate,"Senate Education Committee Action (DP)",6,0,1,0,7
1952383,1499373,2025-02-25,Senate,"Senate Appropriations Committee Action (DP)",9,0,1,0,10
1952383,1503531,2025-03-03,Senate,"Senate Rules Committee Action (PFC)",0,0,0,0,0
1952383,1507485,2025-03-06,Senate,"Senate - Committee of the Whole (DPA)",0,0,0,0,0
1952383,1517286,2025-03-13,Senate,"Senate - Committee of the Whole (DPA)",0,0,0,0,0
1952383,1517287,2025-03-13,Senate,"Senate - Third Reading",26,1,3,0,30
1952383,1531292,2025-03-31,House,"House Appropriations Committee Action (DPA)",17,1,0,0,18
1952383,1545596,2025-02-19,Senate,"Senate Education-Archived and Renamed Education and Transportation as of 04/01/2025 Committee Action (DP)",6,0,1,0,7
1952394,1487490,2025-02-12,Senate,"Senate Health and Human Services Committee Action (DP)",7,0,0,0,7
1952394,1490875,2025-02-17,Senate,"Senate Rules Committee Action (PFC)",0,0,0,0,0
1952394,1501642,2025-02-27,Senate,"Senate - Third Reading",29,0,1,0,30
1952394,1511203,2025-03-10,House,"House Health & Human Services Committee Action (DP)",11,0,0,1,12
1952394,1518778,2025-03-17,House,"House Rules Committee Action (C&P)",8,0,0,0,8
1952394,1550249,2025-04-16,House,"House - Third Reading",50,5,5,0,60
1952396,1495282,2025-02-20,House,"House Natural Resources, Energy & Water Committee Action (DISC/HELD)",0,0,0,0,0
1952411,1495489,2025-02-20,Senate,"Senate Regulatory Affairs and Government Efficiency Committee Action (DPA)",4,2,1,0,7
1952411,1497575,2025-02-24,Senate,"Senate Rules Committee Action (PFC)",0,0,0,0,0
1952411,1507368,2025-03-06,Senate,"Senate - Committee of the Whole (DPA)",0,0,0,0,0
1952411,1517193,2025-03-13,Senate,"Senate - Third Reading",17,10,3,0,30
1952411,1527290,2025-03-26,House,"House Government Committee Action (DPA/SE)",6,1,0,0,7
1952411,1547275,2025-04-14,House,"House Rules Committee Action (HELD)",0,0,0,0,0
1952411,1550323,2025-04-16,House,"House Rules Committee Action (C&P)",8,0,0,0,8
1952413,1492081,2025-02-17,Senate,"Senate Finance Committee Action (DPA)",4,3,0,0,7
1952413,1497943,2025-02-24,Senate,"Senate Rules Committee Action (PFC)",0,0,0,0,0
1952430,1493392,2025-02-19,Senate,"Senate Health and Human Services Committee Action (DISC/ONLY)",0,0,0,0,0
1952435,1494635,2025-02-19,Senate,"Senate Judiciary and Elections Committee Action (DP)",4,3,0,0,7
1952435,1498060,2025-02-24,Senate,"Senate Rules Committee Action (PFC)",0,0,0,0,0
1952435,1504080,2025-03-03,Senate,"Senate - Committee of the Whole (DP)",0,0,0,0,0
1952435,1507309,2025-03-06,Senate,"Senate - Third Reading",17,9,4,0,30
1952445,1496113,2025-02-20,Senate,"Senate Regulatory Affairs and Government Efficiency Committee Action (DPA/SE)",5,2,0,0,7
1952445,1497921,2025-02-24,Senate,"Senate Rules Committee Action (PFC)",0,0,0,0,0
1952445,1500962,2025-02-26,Senate,"Senate - Committee of the Whole (DPA)",0,0,0,0,0
1952445,1505396,2025-03-04,Senate,"Senate - Third Reading",16,11,3,0,30
1952445,1525439,2025-03-24,House,"House Land, Agriculture & Rural Affairs Committee Action (DP)",5,3,0,1,9
1952445,1538517,2025-04-07,House,"House Rules Committee Action (C&P)",7,0,0,1,8
1952445,1541639,2025-04-09,House,"House - Committee of the Whole (DP)",0,0,0,0,0
1952445,1548688,2025-04-15,House,"House - Third Reading",31,21,8,0,60
1952449,1491720,2025-02-17,Senate,"Senate Military Affairs and Border Security Committee Action (DP)",4,2,1,0,7
1952449,1498383,2025-02-24,Senate,"Senate Rules Committee Action (PFC)",0,0,0,0,0
1952449,1500884,2025-02-26,Senate,"Senate - Committee of the Whole (DP)",0,0,0,0,0
1952449,1512282,2025-03-10,Senate,"Senate - Third Reading",17,10,3,0,30
1952449,1519378,2025-03-17,House,"House Public Safety & Law Enforcement Committee Action (DP)",8,6,0,1,15
1952449,1524871,2025-03-24,House,"House Rules Committee Action (C&P)",8,0,0,0,8
1952449,1533741,2025-04-01,House,"House - Committee of the Whole (DP)",0,0,0,0,0
1952449,1550685,2025-04-16,House,"House - Third Reading",33,25,2,0,60
1952457,1493668,2025-02-19,Senate,"Senate Government Committee Action (DPA)",4,3,0,0,7
1952457,1497570,2025-02-24,Senate,"Senate Rules Committee Action (PFC)",0,0,0,0,0
1952457,1504388,2025-03-04,Senate,"Senate - Committee of the Whole (DPA)",0,0,0,0,0
1952457,1507631,2025-03-06,Senate,"Senate - Third Reading",25,0,5,0,30
1952457,1527739,2025-03-26,House,"House Government Committee Action (DP)",7,0,0,0,7
1952457,1538548,2025-04-07,House,"House Rules Committee Action (C&P)",7,0,0,1,8
1952457,1547308,2025-04-14,House,"House - Committee of the Whole (RET ON CAL)",0,0,0,0,0
1952457,1548605,2025-04-15,House,"House - Committee of the Whole (DPA)",0,0,0,0,0
1952457,1551254,2025-04-17,House,"House - Third Reading",19,39,2,0,60
1952457,1551255,2025-04-17,House,"House - Reconsider Third Reading",0,0,0,0,0
1952457,1565017,2025-05-05,House,"House - Third Reading",57,0,3,0,60
1952457,1567256,2025-05-07,Senate,"Senate - Concurrence",0,0,0,0,0
1952457,1567257,2025-05-07,Senate,"Senate - Third Reading",26,0,4,0,30
1952468,1487953,2025-02-12,Senate,"Senate Judiciary and Elections Committee Action (DP)",4,2,1,0,7
1952468,1490962,2025-02-17,Senate,"Senate Rules Committee Action (PFC)",0,0,0,0,0
1952468,1499203,2025-02-25,Senate,"Senate - Committee of the Whole (DP)",0,0,0,0,0
1952468,1500378,2025-02-26,Senate,"Senate - Third Reading",18,10,2,0,30
1952468,1515753,2025-03-12,House,"House Judiciary Committee Action (DP)",6,3,0,0,9
1952468,1547269,2025-04-14,House,"House Rules Committee Action (C&P)",8,0,0,0,8
1952469,1494069,2025-02-19,Senate,"Senate Government Committee Action (DP)",4,3,0,0,7
1952469,1498047,2025-02-24,Senate,"Senate Rules Committee Action (PFC)",0,0,0,0,0
1952469,1503873,2025-03-03,Senate,"Senate - Committee of the Whole (DP)",0,0,0,0,0
1952469,1506509,2025-03-05,Senate,"Senate - Third Reading",17,12,1,0,30
1952471,1488579,2025-02-12,Senate,"Senate Education Committee Action (DP)",6,0,1,0,7
1952471,1491492,2025-02-17,Senate,"Senate Rules Committee Action (PFC)",0,0,0,0,0
1952471,1499481,2025-02-25,Senate,"Senate - Committee of the Whole (RETAINED)",0,0,0,0,0
1952471,1507956,2025-03-06,Senate,"Senate - Committee of the Whole (DPA)",0,0,0,0,0
1952471,1517594,2025-03-13,Senate,"Senate - Third Reading",26,1,3,0,30
1952471,1526850,2025-03-25,House,"House Education Committee Action (DP)",11,0,0,1,12
1952471,1530966,2025-03-31,House,"House Rules Committee Action (C&P)",7,0,0,1,8
1952471,1535835,2025-04-03,House,"House - Committee of the Whole (DP)",0,0,0,0,0
1952471,1546045,2025-02-12,Senate,"Senate Education-Archived and Renamed Education and Transportation as of 04/01/2025 Committee Action (DP)",6,0,1,0,7
1952471,1550819,2025-04-16,House,"House - Third Reading",55,0,5,0,60
1952473,1493434,2025-02-19,Senate,"Senate Health and Human Services Committee Action (DPA)",7,0,0,0,7
1952473,1497627,2025-02-24,Senate,"Senate Rules Committee Action (PFC)",0,0,0,0,0
1952473,1503421,2025-03-03,Senate,"Senate - Committee of the Whole (DPA)",0,0,0,0,0
1952473,1507379,2025-03-06,Senate,"Senate - Third Reading",22,4,4,0,30
1952473,1525094,2025-03-24,House,"House Health & Human Services Committee Action (DP)",10,1,0,1,12
1952481,1487694,2025-02-12,Senate,"Senate Health and Human Services Committee Action (DP)",7,0,0,0,7
1952481,1492492,2025-02-18,Senate,"Senate Appropriations Committee Action (DP)",9,0,1,0,10
1952481,1497894,2025-02-24,Senate,"Senate Rules Committee Action (PFC)",0,0,0,0,0
1952481,1509154,2025-03-10,Senate,"Senate - Third Reading",26,1,3,0,30
1952481,1525052,2025-03-24,House,"House Health & Human Services Committee Action (DP)",10,1,0,1,12
1952487,1495585,2025-02-20,Senate,"Senate Regulatory Affairs and Government Efficiency Committee Action (DP)",4,3,0,0,7
1952487,1497544,2025-02-24,Senate,"Senate Rules Committee Action (PFC)",0,0,0,0,0
1952487,1503268,2025-03-03,Senate,"Senate - Committee of the Whole (DP)",0,0,0,0,0
1952487,1506355,2025-03-05,Senate,"Senate - Third Reading",17,12,1,0,30
1952487,1527305,2025-03-26,House,"House Government Committee Action (DP)",4,3,0,0,7
1952487,1538449,2025-04-07,House,"House Rules Committee Action (C&P)",7,0,0,1,8
1952487,1548652,2025-04-15,House,"House - Committee of the Whole (DP)",0,0,0,0,0
1952487,1563694,2025-05-01,House,"House - Third Reading",31,27,2,0,60
1952496,1493701,2025-02-19,Senate,"Senate Health and Human Services Committee Action (DPA)",7,0,0,0,7
1952496,1498141,2025-02-24,Senate,"Senate Rules Committee Action (PFC)",0,0,0,0,0
1952496,1501615,2025-02-27,Senate,"Senate - Committee of the Whole (RETAINED)",0,0,0,0,0
1952496,1505355,2025-03-04,Senate,"Senate - Committee of the Whole (DPA)",0,0,0,0,0
1952496,1507149,2025-03-06,Senate,"Senate - Third Reading",24,3,3,0,30
1952496,1518937,2025-03-17,House,"House Health & Human Services Committee Action (DISC/HELD)",0,0,0,0,0
1952496,1525412,2025-03-24,House,"House Health & Human Services Committee Action (DPA)",10,1,0,1,12
1952496,1538362,2025-04-07,House,"House Rules Committee Action (C&P)",7,0,0,1,8
1952496,1541592,2025-04-09,House,"House - Committee of the Whole (DPA)",0,0,0,0,0
1952496,1547247,2025-04-14,House,"House - Third Reading",47,8,5,0,60
1952496,1560873,2025-04-29,Senate,"Senate - Concurrence",0,0,0,0,0
1952496,1560874,2025-04-29,Senate,"Senate - Third Reading",26,3,1,0,30
1952500,1494566,2025-02-19,Senate,"Senate Judiciary and Elections Committee Action (DPA)",6,0,1,0,7
1952500,1497625,2025-02-24,Senate,"Senate Rules Committee Action (PFC)",0,0,0,0,0
1952500,1501420,2025-02-27,Senate,"Senate - Committee of the Whole (DPA)",0,0,0,0,0
1952500,1504667,2025-03-04,Senate,"Senate - Third Reading",27,0,3,0,30
1952500,1520932,2025-03-19,House,"House Judiciary Committee Action (DP)",9,0,0,0,9
1952500,1524867,2025-03-24,House,"House Rules Committee Action (C&P)",8,0,0,0,8
1952500,1547620,2025-04-14,House,"House - Third Reading",55,0,5,0,60
1952503,1488099,2025-02-12,Senate,"Senate Judiciary and Elections Committee Action (DPA)",4,2,1,0,7
1952503,1490888,2025-02-17,Senate,"Senate Rules Committee Action (PFC)",0,0,0,0,0
1952503,1499128,2025-02-25,Senate,"Senate - Committee of the Whole (DPA)",0,0,0,0,0
1952503,1500244,2025-02-26,Senate,"Senate - Third Reading",17,11,2,0,30
1952503,1515742,2025-03-12,House,"House Judiciary Committee Action (DP)",6,2,0,1,9
1952503,1518964,2025-03-17,House,"House Rules Committee Action (C&P)",8,0,0,0,8
1952503,1527984,2025-03-26,House,"House - Committee of the Whole (DP)",0,0,0,0,0
1952503,1563788,2025-05-01,House,"House - Third Reading",31,26,3,0,60
1952510,1495651,2025-02-19,Senate,"Senate Judiciary and Elections Committee Action (DP)",7,0,0,0,7
1952510,1498057,2025-02-24,Senate,"Senate Rules Committee Action (PFC)",0,0,0,0,0
1952510,1501703,2025-02-27,Senate,"Senate - Third Reading",29,0,1,0,30
1952510,1516691,2025-03-12,House,"House Federalism, Military Affairs & Elections Committee Action (DP)",7,0,0,0,7
1952510,1518933,2025-03-17,House,"House Rules Committee Action (C&P)",8,0,0,0,8
1952510,1559191,2025-04-28,House,"House - Third Reading",55,0,5,0,60
1952518,1485800,2025-02-10,Senate,"Senate Military Affairs and Border Security Committee Action (DP)",7,0,0,0,7
1952518,1492511,2025-02-18,Senate,"Senate Appropriations Committee Action (DP)",8,0,2,0,10
1952518,1498384,2025-02-24,Senate,"Senate Rules Committee Action (PFC)",0,0,0,0,0
1952518,1509523,2025-03-10,Senate,"Senate - Third Reading",25,2,3,0,30
1952518,1525407,2025-03-24,House,"House Public Safety & Law Enforcement Committee Action (DISC/HELD)",0,0,0,0,0
1952518,1528371,2025-03-25,House,"House Public Safety & Law Enforcement Committee Action (W/D)",0,0,0,0,0
1952518,1530995,2025-03-31,House,"House Appropriations Committee Action (DP)",15,2,0,1,18
1952532,1493582,2025-02-18,Senate,"Senate Natural Resources Committee Action (DP)",4,3,1,0,8
1952532,1498329,2025-02-24,Senate,"Senate Rules Committee Action (PFC)",0,0,0,0,0
1952533,1494379,2025-02-19,Senate,"Senate Public Safety Committee Action (DP)",7,0,0,0,7
1952533,1498098,2025-02-24,Senate,"Senate Rules Committee Action (PFC)",0,0,0,0,0
1952533,1501707,2025-02-27,Senate,"Senate - Third Reading",26,3,1,0,30
1952533,1527905,2025-03-26,House,"House Transportation & Infrastructure Committee Action (DPA/SE)",5,1,0,1,7
1952543,1493529,2025-02-19,Senate,"Senate Health and Human Services Committee Action (DP)",7,0,0,0,7
1952543,1498478,2025-02-24,Senate,"Senate Rules Committee Action (PFC)",0,0,0,0,0
1952543,1501717,2025-02-27,Senate,"Senate - Third Reading",26,3,1,0,30
1952543,1525331,2025-03-24,House,"House Health & Human Services Committee Action (DPA)",8,3,0,1,12
1952543,1547329,2025-04-14,House,"House Rules Committee Action (C&P)",8,0,0,0,8
1952543,1559137,2025-04-28,House,"House - Committee of the Whole (DPA)",0,0,0,0,0
1952543,1567098,2025-05-07,House,"House - Third Reading",39,19,2,0,60
1952566,1493058,2025-02-18,Senate,"Senate Natural Resources Committee Action (DP)",7,0,1,0,8
1952566,1498347,2025-02-24,Senate,"Senate Rules Committee Action (PFC)",0,0,0,0,0
1952566,1509279,2025-03-10,Senate,"Senate - Third Reading",26,1,3,0,30
1952566,1525342,2025-03-24,House,"House Land, Agriculture & Rural Affairs Committee Action (DPA/SE)",4,3,2,0,9
1952566,1547880,2025-04-14,House,"House Rules Committee Action (C&P)",8,0,0,0,8
1952566,1554267,2025-04-22,House,"House - Committee of the Whole (DPA)",0,0,0,0,0
1952568,1494478,2025-02-19,Senate,"Senate Public Safety Committee Action (DP)",7,0,0,0,7
1952568,1498392,2025-02-24,Senate,"Senate Rules Committee Action (PFC)",0,0,0,0,0
1952568,1501706,2025-02-27,Senate,"Senate - Third Reading",29,0,1,0,30
1952568,1512413,2025-03-10,House,"House Public Safety & Law Enforcement Committee Action (DP)",14,0,0,1,15
1952568,1519238,2025-03-17,House,"House Rules Committee Action (C&P)",8,0,0,0,8
1952568,1521780,2025-03-19,House,"House - Third Reading",57,0,3,0,60
1952572,1491866,2025-02-17,Senate,"Senate Finance Committee Action (DP)",4,3,0,0,7
1952572,1497562,2025-02-24,Senate,"Senate Rules Committee Action (PFC)",0,0,0,0,0
1952572,1501708,2025-02-27,Senate,"Senate - Third Reading",17,12,1,0,30
1952572,1515757,2025-03-12,House,"House Ways & Means Committee Action (DP)",5,2,0,2,9
1952572,1518627,2025-03-17,House,"House Rules Committee Action (C&P)",8,0,0,0,8
1952572,1549512,2025-04-15,House,"House - Third Reading",49,3,8,0,60
1952574,1495161,2025-02-19,Senate,"Senate Education Committee Action (DPA)",4,3,0,0,7
1952574,1498374,2025-02-24,Senate,"Senate Rules Committee Action (PFC)",0,0,0,0,0
1952574,1501152,2025-02-27,Senate,"Senate - Committee of the Whole (DPA)",0,0,0,0,0
1952574,1507261,2025-03-06,Senate,"Senate - Third Reading",17,9,4,0,30
1952574,1526757,2025-03-25,House,"House Education Committee Action (DP)",7,5,0,0,12
1952574,1545818,2025-02-19,Senate,"Senate Education-Archived and Renamed Education and Transportation as of 04/01/2025 Committee Action (DPA)",4,3,0,0,7
1952574,1547251,2025-04-14,House,"House Rules Committee Action (C&P)",8,0,0,0,8
1952574,1552666,2025-04-21,House,"House - Committee of the Whole (DP)",0,0,0,0,0
1952574,1564005,2025-05-01,House,"House - Third Reading",29,28,3,0,60
1952574,1564006,2025-05-01,House,"House - Reconsider Third Reading",0,0,0,0,0
1952576,1491842,2025-02-17,Senate,"Senate Military Affairs and Border Security Committee Action (DP)",4,2,1,0,7
1952576,1498399,2025-02-24,Senate,"Senate Rules Committee Action (PFC)",4,3,0,0,7
1952576,1507453,2025-03-06,Senate,"Senate - Committee of the Whole (DP)",0,0,0,0,0
1952576,1517105,2025-03-13,Senate,"Senate - Third Reading",17,9,4,0,30
1952576,1528100,2025-03-26,House,"House Federalism, Military Affairs & Elections Committee Action (FAILED)",3,4,0,0,7
1952587,1493727,2025-02-18,Senate,"Senate Natural Resources Committee Action (DP)",7,0,1,0,8
1952587,1508288,2025-03-06,Senate,"Senate Appropriations Committee Action (W/D)",0,0,0,0,0
1952587,1509100,2025-03-10,Senate,"Senate Rules Committee Action (PFC)",0,0,0,0,0
1952587,1527016,2025-03-25,Senate,"Senate - Committee of the Whole (DP)",0,0,0,0,0
1952587,1527017,2025-03-25,Senate,"Senate - Third Reading",25,0,4,0,29
1952595,1548396,2025-04-15,Senate,"Senate Appropriations Committee Action (DPA)",6,4,0,0,10
1952595,1548397,2025-04-15,Senate,"Senate Rules Committee Action (PFC)",5,4,0,0,9
1952595,1555335,2025-04-23,Senate,"Senate - Committee of the Whole (DPA)",0,0,0,0,0
1952595,1555336,2025-04-23,Senate,"Senate - Third Reading",16,13,1,0,30
1952595,1556583,2025-04-24,Senate,"Senate - Reconsider Third Reading",0,0,0,0,0
1952595,1556584,2025-04-24,Senate,"Senate - Committee of the Whole (DPA)",0,0,0,0,0
1952595,1557089,2025-04-23,House,"Motion If the Senate requests the House return SB1734 for the purpose of reconsideration, that the House accede to the Senate request to return SB1734 for the purpose of reconsideration.",0,0,0,0,0
1952595,1557090,2025-04-24,Senate,"Motion Senator Shamp moved that the Senate request the House return SB 1734, which was passed by the Senate and transmitted to the House on April 23, 2025 for the purpose of reconsideration. Motion carried.",0,0,0,0,0
1952595,1566069,2025-04-23,House,"Motion If the Senate requests the House return SB1734 for the purpose of reconsideration, that the House accede to the Senate request to return SB1734 for the purpose of reconsideration.",0,0,0,0,0
1952603,1492958,2025-02-19,House,"House Government Committee Action (DP)",5,1,0,1,7
1952603,1497249,2025-02-24,House,"House Rules Committee Action (C&P)",7,0,0,1,8
1952603,1499912,2025-02-26,House,"House - Committee of the Whole (DP)",0,0,0,0,0
1952603,1503770,2025-03-03,House,"House - Third Reading",32,26,2,0,60
1952603,1518665,2025-03-17,Senate,"Senate Federalism Committee Action (DP)",4,3,0,0,7
1952603,1524799,2025-03-24,Senate,"Senate Rules Committee Action (PFC)",0,0,0,0,0
1952603,1566471,2025-05-06,Senate,"Senate - Third Reading",17,11,2,0,30
1952608,1494560,2025-02-19,Senate,"Senate Education Committee Action (DP)",4,3,0,0,7
1952608,1497896,2025-02-24,Senate,"Senate Rules Committee Action (PFC)",0,0,0,0,0
1952608,1501220,2025-02-27,Senate,"Senate - Committee of the Whole (DP)",0,0,0,0,0
1952608,1505063,2025-03-04,Senate,"Senate - Third Reading",15,12,3,0,30
1952608,1505064,2025-03-04,Senate,"Senate - Reconsider Third Reading",0,0,0,0,0
1952608,1518877,2025-03-17,Senate,"Senate - Third Reading",16,11,2,0,29
1952608,1545475,2025-02-19,Senate,"Senate Education-Archived as of 04/01/2025 Committee Action (DP)",4,3,0,0,7
1952608,1546770,2025-02-19,Senate,"Senate Education-Archived and Renamed Education and Transportation as of 04/01/2025 Committee Action (DP)",4,3,0,0,7
1952624,1492233,2025-02-17,Senate,"Senate Military Affairs and Border Security Committee Action (DP)",5,0,2,0,7
1952624,1499430,2025-02-25,Senate,"Senate Appropriations Committee Action (DP)",9,1,0,0,10
1952624,1503226,2025-03-03,Senate,"Senate Rules Committee Action (PFC)",0,0,0,0,0
1952624,1508125,2025-03-06,Senate,"Senate - Committee of the Whole (DPA)",0,0,0,0,0
1952624,1517573,2025-03-13,Senate,"Senate - Third Reading",25,2,3,0,30
1952624,1525567,2025-03-24,House,"House Federalism, Military Affairs & Elections Committee Action (W/D)",0,0,0,0,0
1952631,1493115,2025-02-19,Senate,"Senate Health and Human Services Committee Action (DPA)",4,1,2,0,7
1952631,1498120,2025-02-24,Senate,"Senate Rules Committee Action (PFC)",0,0,0,0,0
1952631,1508000,2025-03-06,Senate,"Senate - Committee of the Whole (DPA)",0,0,0,0,0
1952631,1517585,2025-03-13,Senate,"Senate - Third Reading",17,10,3,0,30
1952631,1531373,2025-03-31,House,"House Appropriations Committee Action (DP)",11,7,0,0,18
1952631,1547332,2025-04-14,House,"House Rules Committee Action (C&P)",8,0,0,0,8
1952631,1564947,2025-05-05,House,"Motion Motion by Representative Way that pursuant to House Rule 12(P), SB1600 be calendared for an Additional Committee of the Whole for purposes of further amending. Motion passed v/v.",0,0,0,0,0
1952631,1564948,2025-05-05,House,"House - Committee of the Whole (DPA)",0,0,0,0,0
1952631,1566018,2025-05-06,House,"House - Third Reading",31,23,6,0,60
1952631,1567592,2025-05-07,Senate,"Senate - Concurrence",0,0,0,0,0
1952631,1567593,2025-05-07,Senate,"Senate - Third Reading",17,9,4,0,30
1952633,1492895,2025-02-18,Senate,"Senate Appropriations Committee Action (DP)",7,2,1,0,10
1952633,1498382,2025-02-24,Senate,"Senate Rules Committee Action (PFC)",0,0,0,0,0
1952633,1501400,2025-02-27,Senate,"Senate - Third Reading",15,14,1,0,30
1952633,1501969,2025-02-27,Senate,"Senate - Reconsider Third Reading",0,0,0,0,0
1952633,1506935,2025-03-05,Senate,"Senate - Third Reading",17,12,1,0,30
1952633,1526826,2025-03-25,House,"House Government Committee Action (W/D)",0,0,0,0,0
1952633,1531027,2025-03-31,House,"House Appropriations Committee Action (DPA/SE)",10,8,0,0,18
1952654,1494185,2025-02-19,Senate,"Senate Health and Human Services Committee Action (HELD)",0,0,0,0,0
1952655,1493093,2025-02-18,Senate,"Senate Natural Resources Committee Action (DP)",6,1,1,0,8
1952655,1498071,2025-02-24,Senate,"Senate Rules Committee Action (PFC)",0,0,0,0,0
1952655,1501725,2025-02-27,Senate,"Senate - Committee of the Whole (DP)",0,0,0,0,0
1952655,1504972,2025-03-04,Senate,"Senate - Third Reading",18,9,3,0,30
1952655,1525372,2025-03-24,House,"House Land, Agriculture & Rural Affairs Committee Action (DPA/SE)",7,2,0,0,9
1952655,1547893,2025-04-14,House,"House Rules Committee Action (C&P)",8,0,0,0,8
1952655,1553332,2025-04-22,House,"House - Committee of the Whole (RET ON CAL)",0,0,0,0,0
1952659,1493612,2025-02-18,Senate,"Senate Natural Resources Committee Action (DPA)",7,0,1,0,8
1952659,1498381,2025-02-24,Senate,"Senate Rules Committee Action (PFC)",0,0,0,0,0
1952659,1501257,2025-02-27,Senate,"Senate - Committee of the Whole (DPA)",0,0,0,0,0
1952659,1505050,2025-03-04,Senate,"Senate - Third Reading",23,4,3,0,30
1952660,1493808,2025-02-19,Senate,"Senate Government Committee Action (HELD)",0,0,0,0,0
1952666,1494257,2025-02-19,Senate,"Senate Government Committee Action (HELD)",0,0,0,0,0
1952666,1496999,2025-02-20,Senate,"Senate Government Committee Action (DPA)",4,3,0,0,7
1952666,1497629,2025-02-24,Senate,"Senate Rules Committee Action (PFC)",0,0,0,0,0
1952666,1503343,2025-03-03,Senate,"Senate - Committee of the Whole (DPA)",0,0,0,0,0
1952666,1508170,2025-03-06,Senate,"Senate - Third Reading",17,10,3,0,30
1952666,1528021,2025-03-26,House,"House Government Committee Action (FAILED)",2,4,0,1,7
1952666,1528022,2025-03-26,House,"House Government Committee Action (DP ON RECON)",4,3,0,0,7
1952666,1530939,2025-03-31,House,"House Rules Committee Action (C&P)",7,0,0,1,8
1952666,1543031,2025-04-09,House,"House - Committee of the Whole (RET ON CAL)",0,0,0,0,0
1952666,1550363,2025-04-16,House,"House - Committee of the Whole (DPA)",0,0,0,0,0
1952666,1565072,2025-05-05,House,"House - Third Reading",32,25,3,0,60
1952666,1567975,2025-05-07,Senate,"Senate - Concurrence",0,0,0,0,0
1952666,1567976,2025-05-07,Senate,"Senate - Third Reading",16,10,4,0,30
1952675,1492999,2025-02-18,Senate,"Senate Natural Resources Committee Action (DP)",4,2,2,0,8
1952675,1498407,2025-02-24,Senate,"Senate Rules Committee Action (PFC)",0,0,0,0,0
1952675,1506565,2025-03-05,Senate,"Senate - Committee of the Whole (DPA)",0,0,0,0,0
1952675,1507955,2025-03-06,Senate,"Senate - Third Reading",24,1,5,0,30
1952675,1526848,2025-03-25,House,"House Natural Resources, Energy & Water Committee Action (DP)",9,0,0,1,10
1952675,1538180,2025-04-07,House,"House Rules Committee Action (C&P)",7,0,0,1,8
1952675,1545056,2025-04-10,House,"House - Committee of the Whole (DP)",0,0,0,0,0
1952675,1549194,2025-04-15,House,"House - Third Reading",46,7,7,0,60
1952682,1495655,2025-02-19,Senate,"Senate Judiciary and Elections Committee Action (DP)",4,3,0,0,7
1952682,1498319,2025-02-24,Senate,"Senate Rules Committee Action (HELD)",0,0,0,0,0
1952685,1499216,2025-02-25,Senate,"Senate Appropriations Committee Action (DPA)",9,1,0,0,10
1952685,1503944,2025-03-03,Senate,"Senate Rules Committee Action (PFC)",0,0,0,0,0
1952685,1508092,2025-03-06,Senate,"Senate - Committee of the Whole (DPA)",0,0,0,0,0
1952685,1517572,2025-03-13,Senate,"Senate - Third Reading",25,2,3,0,30
1952685,1529869,2025-03-27,House,"House Natural Resources, Energy & Water Committee Action (W/D)",0,0,0,0,0
1952691,1491705,2025-02-17,Senate,"Senate Finance Committee Action (DP)",6,1,0,0,7
1952691,1497550,2025-02-24,Senate,"Senate Rules Committee Action (PFC)",0,0,0,0,0
1952691,1509261,2025-03-10,Senate,"Senate - Third Reading",24,3,3,0,30
1952691,1525089,2025-03-24,House,"House Health & Human Services Committee Action (DP)",12,0,0,0,12
1952691,1547256,2025-04-14,House,"House Rules Committee Action (C&P)",8,0,0,0,8
1952691,1562137,2025-04-30,House,"House - Third Reading",43,12,5,0,60
1952693,1487925,2025-02-12,Senate,"Senate Education Committee Action (DP)",6,0,1,0,7
1952693,1490980,2025-02-17,Senate,"Senate Rules Committee Action (PFC)",0,0,0,0,0
1952693,1499152,2025-02-25,Senate,"Senate - Committee of the Whole (DP)",0,0,0,0,0
1952693,1500342,2025-02-26,Senate,"Senate - Third Reading",25,3,2,0,30
1952693,1514336,2025-03-11,House,"House Education Committee Action (DPA)",12,0,0,0,12
1952693,1518908,2025-03-17,House,"House Rules Committee Action (C&P)",8,0,0,0,8
1952693,1523100,2025-03-20,House,"House - Committee of the Whole (DPA)",0,0,0,0,0
1952693,1545564,2025-02-12,Senate,"Senate Education-Archived and Renamed Education and Transportation as of 04/01/2025 Committee Action (DP)",6,0,1,0,7
1952693,1547586,2025-04-14,House,"House - Third Reading",54,0,6,0,60
1952693,1559837,2025-04-29,Senate,"Senate - Concurrence",0,0,0,0,0
1952693,1560376,2025-04-29,Senate,"Senate - Third Reading",29,0,1,0,30
1952709,1492956,2025-02-18,Senate,"Senate Natural Resources Committee Action (DPA/SE)",4,3,1,0,8
1952709,1498113,2025-02-24,Senate,"Senate Rules Committee Action (PFC)",0,0,0,0,0
1952709,1501715,2025-02-27,Senate,"Senate - Committee of the Whole (DPA)",0,0,0,0,0
1952709,1505546,2025-03-04,Senate,"Senate - Third Reading",15,12,3,0,30
1952709,1505547,2025-03-04,Senate,"Senate - Reconsider Third Reading",0,0,0,0,0
1952715,1493283,2025-02-19,Senate,"Senate Health and Human Services Committee Action (DP)",7,0,0,0,7
1952715,1499406,2025-02-25,Senate,"Senate Appropriations Committee Action (DP)",10,0,0,0,10
1952715,1503560,2025-03-03,Senate,"Senate Rules Committee Action (PFC)",0,0,0,0,0
1952715,1517200,2025-03-13,Senate,"Senate - Committee of the Whole (DP)",0,0,0,0,0
1952715,1517201,2025-03-13,Senate,"Senate - Third Reading",22,5,3,0,30
1952728,1495341,2025-02-20,Senate,"Senate Regulatory Affairs and Government Efficiency Committee Action (DPA)",7,0,0,0,7
1952728,1498182,2025-02-24,Senate,"Senate Rules Committee Action (PFC)",0,0,0,0,0
1952728,1500194,2025-02-26,Senate,"Senate - Committee of the Whole (DPA)",0,0,0,0,0
1952728,1504727,2025-03-04,Senate,"Senate - Third Reading",16,11,3,0,30
1952733,1495427,2025-02-20,Senate,"Senate Regulatory Affairs and Government Efficiency Committee Action (DPA)",5,2,0,0,7
1952733,1497601,2025-02-24,Senate,"Senate Rules Committee Action (PFC)",0,0,0,0,0
1952733,1500421,2025-02-26,Senate,"Senate - Committee of the Whole (DPA)",0,0,0,0,0
1952733,1504671,2025-03-04,Senate,"Senate - Third Reading",16,11,3,0,30
1952733,1527285,2025-03-26,House,"House Government Committee Action (DP)",4,3,0,0,7
1952733,1538440,2025-04-07,House,"House Rules Committee Action (C&P)",7,0,0,1,8
1952733,1541544,2025-04-09,House,"House - Committee of the Whole (DP)",0,0,0,0,0
1952733,1548760,2025-04-15,House,"House - Third Reading",31,21,8,0,60
1952740,1494569,2025-02-19,Senate,"Senate Judiciary and Elections Committee Action (DP)",4,2,1,0,7
1952740,1497533,2025-02-24,Senate,"Senate Rules Committee Action (PFC)",4,3,0,0,7
1952740,1503367,2025-03-03,Senate,"Senate - Committee of the Whole (DP)",0,0,0,0,0
1952740,1507284,2025-03-06,Senate,"Senate - Third Reading",17,10,3,0,30
1952753,1492957,2025-02-18,Senate,"Senate Natural Resources Committee Action (DP)",4,3,1,0,8
1952753,1499371,2025-02-25,Senate,"Senate Appropriations Committee Action (DP)",6,4,0,0,10
1952753,1503565,2025-03-03,Senate,"Senate Rules Committee Action (PFC)",0,0,0,0,0
1952753,1507524,2025-03-06,Senate,"Senate - Committee of the Whole (DPA)",0,0,0,0,0
1952753,1517283,2025-03-13,Senate,"Senate - Third Reading",16,11,3,0,30
1952764,1487876,2025-02-12,Senate,"Senate Education Committee Action (DP)",5,2,0,0,7
1952764,1491007,2025-02-17,Senate,"Senate Rules Committee Action (PFC)",0,0,0,0,0
1952764,1499536,2025-02-25,Senate,"Senate - Committee of the Whole (DPA)",0,0,0,0,0
1952764,1500839,2025-02-26,Senate,"Senate - Third Reading",28,0,2,0,30
1952764,1515390,2025-03-11,House,"House Education Committee Action (DP)",7,3,2,0,12
1952764,1519251,2025-03-17,House,"House Rules Committee Action (C&P)",8,0,0,0,8
1952764,1523191,2025-03-20,House,"House - Committee of the Whole (DP)",0,0,0,0,0
1952764,1545744,2025-02-12,Senate,"Senate Education-Archived and Renamed Education and Transportation as of 04/01/2025 Committee Action (DP)",5,2,0,0,7
1952764,1550805,2025-04-16,House,"House - Third Reading",50,5,5,0,60
1952765,1494136,2025-02-19,Senate,"Senate Public Safety Committee Action (DP)",4,3,0,0,7
1952765,1498088,2025-02-24,Senate,"Senate Rules Committee Action (PFC)",0,0,0,0,0
1952765,1501752,2025-02-27,Senate,"Senate - Third Reading",17,12,1,0,30
1952765,1521352,2025-03-19,House,"House Transportation & Infrastructure Committee Action (DP)",4,2,0,1,7
1952765,1524913,2025-03-24,House,"House Rules Committee Action (C&P)",8,0,0,0,8
1952765,1533230,2025-04-01,House,"House - Committee of the Whole (DP)",0,0,0,0,0
1952765,1559859,2025-04-28,House,"House - Third Reading",32,23,5,0,60
1952794,1495307,2025-02-20,Senate,"Senate Regulatory Affairs and Government Efficiency Committee Action (DP)",7,0,0,0,7
1952794,1498003,2025-02-24,Senate,"Senate Rules Committee Action (PFC)",0,0,0,0,0
1952794,1501740,2025-02-27,Senate,"Senate - Third Reading",18,11,1,0,30
1952794,1527131,2025-03-25,House,"House Regulatory Oversight Committee Action (DP)",3,2,0,0,5
1952794,1538290,2025-04-07,House,"House Rules Committee Action (C&P)",7,0,0,1,8
1952794,1544925,2025-04-10,House,"House - Committee of the Whole (DP)",0,0,0,0,0
1952794,1549877,2025-04-16,House,"House - Third Reading",31,25,4,0,60
1952806,1495514,2025-02-20,Senate,"Senate Regulatory Affairs and Government Efficiency Committee Action (DP)",4,1,2,0,7
1952806,1497518,2025-02-24,Senate,"Senate Rules Committee Action (PFC)",0,0,0,0,0
1952806,1500475,2025-02-26,Senate,"Senate - Committee of the Whole (RETAINED)",0,0,0,0,0
1952806,1504717,2025-03-04,Senate,"Senate - Committee of the Whole (DPA)",0,0,0,0,0
1952806,1507387,2025-03-06,Senate,"Senate - Third Reading",16,11,3,0,30
1952806,1530947,2025-03-31,House,"House Appropriations Committee Action (DP)",11,7,0,0,18
1952806,1547296,2025-04-14,House,"House Rules Committee Action (C&P)",8,0,0,0,8
1952806,1552669,2025-04-21,House,"House - Committee of the Whole (DP)",0,0,0,0,0
1952814,1491727,2025-02-17,Senate,"Senate Finance Committee Action (HELD)",0,0,0,0,0
1952815,1494409,2025-02-19,Senate,"Senate Public Safety Committee Action (DP)",6,0,1,0,7
1952815,1497930,2025-02-24,Senate,"Senate Rules Committee Action (PFC)",0,0,0,0,0
1952815,1501396,2025-02-27,Senate,"Senate - Third Reading",27,2,1,0,30
1952829,1485385,2025-02-10,Senate,"Senate Military Affairs and Border Security Committee Action (DP)",7,0,0,0,7
1952829,1492388,2025-02-18,Senate,"Senate Appropriations Committee Action (DP)",9,0,1,0,10
1952829,1498093,2025-02-24,Senate,"Senate Rules Committee Action (PFC)",0,0,0,0,0
1952829,1501714,2025-02-27,Senate,"Senate - Third Reading",29,0,1,0,30
1952829,1516715,2025-03-12,House,"House Federalism, Military Affairs & Elections Committee Action (DP)",7,0,0,0,7
1952829,1521915,2025-03-19,House,"House Appropriations Committee Action (DP)",18,0,0,0,18
1952830,1495483,2025-02-20,Senate,"Senate Regulatory Affairs and Government Efficiency Committee Action (DPA)",4,3,0,0,7
1952830,1497571,2025-02-24,Senate,"Senate Rules Committee Action (PFC)",4,3,0,0,7
1952830,1501294,2025-02-27,Senate,"Senate - Committee of the Whole (RETAINED)",0,0,0,0,0
1952830,1507799,2025-03-06,Senate,"Senate - Committee of the Whole (DPA)",0,0,0,0,0
1952834,1492925,2025-02-18,Senate,"Senate Appropriations Committee Action (DP)",9,0,1,0,10
1952834,1498067,2025-02-24,Senate,"Senate Rules Committee Action (PFC)",0,0,0,0,0
1952834,1501757,2025-02-27,Senate,"Senate - Third Reading",24,5,1,0,30
1952834,1531232,2025-03-31,House,"House Appropriations Committee Action (DP)",11,7,0,0,18
1952849,1493736,2025-02-19,Senate,"Senate Health and Human Services Committee Action (DP)",7,0,0,0,7
1952849,1499315,2025-02-25,Senate,"Senate Appropriations Committee Action (DP)",10,0,0,0,10
1952849,1503535,2025-03-03,Senate,"Senate Rules Committee Action (PFC)",0,0,0,0,0
1952849,1507493,2025-03-06,Senate,"Senate - Committee of the Whole (DP)",0,0,0,0,0
1952849,1517582,2025-03-13,Senate,"Senate - Third Reading",18,9,3,0,30
1953978,1494057,2025-02-19,House,"House Science & Technology Committee Action (DP)",9,0,0,0,9
1953978,1501585,2025-02-27,House,"House Appropriations Committee Action (W/D)",0,0,0,0,0
1953978,1503262,2025-03-03,House,"House Rules Committee Action (C&P)",8,0,0,0,8
1953978,1504447,2025-03-04,House,"House - Committee of the Whole (DPA)",0,0,0,0,0
1953978,1509156,2025-03-10,House,"Motion Motion by Representative Carbone that pursuant to House Rule 12(P), HB2736 be calendared for an Additional Committee of the Whole for purposes of further amending. Motion passed v/v.",0,0,0,0,0
1953978,1509157,2025-03-10,House,"House - Committee of the Whole (DPA)",0,0,0,0,0
1953978,1514113,2025-03-11,House,"House - Third Reading",35,22,3,0,60
1953978,1525112,2025-03-24,Senate,"Senate Federalism Committee Action (DPA)",7,0,0,0,7
1953978,1531262,2025-03-31,Senate,"Senate Rules Committee Action (PFC)",0,0,0,0,0
1954323,1492911,2025-02-18,House,"House Natural Resources, Energy & Water Committee Action (DPA)",6,4,0,0,10
1954323,1497405,2025-02-24,House,"House Rules Committee Action (C&P)",7,0,0,1,8
1954323,1499109,2025-02-25,House,"House - Committee of the Whole (RET ON CAL)",0,0,0,0,0
1954323,1503595,2025-03-03,House,"House - Committee of the Whole (DPA)",0,0,0,0,0
1954323,1506184,2025-03-05,House,"House - Third Reading",26,32,2,0,60
1954323,1506185,2025-03-05,House,"House - Reconsider Third Reading",0,0,0,0,0
1954680,1495717,2025-02-20,House,"House Natural Resources, Energy & Water Committee Action (DPA/SE)",5,3,0,2,10
1954680,1497417,2025-02-24,House,"House Rules Committee Action (C&P)",7,0,0,1,8
1954680,1499252,2025-02-25,House,"House - Committee of the Whole (DPA)",0,0,0,0,0
1954680,1500541,2025-02-26,House,"House - Third Reading",53,6,1,0,60
1954680,1514836,2025-03-11,Senate,"Senate Natural Resources Committee Action (DP)",6,1,1,0,8
1954680,1518854,2025-03-17,Senate,"Senate Rules Committee Action (PFC)",0,0,0,0,0
1954680,1549876,2025-04-16,Senate,"Senate - Third Reading",28,1,1,0,30
1955124,1494440,2025-02-19,House,"House Transportation & Infrastructure Committee Action (DP)",7,0,0,0,7
1955124,1498125,2025-02-24,House,"House Rules Committee Action (C&P)",7,0,0,1,8
1955124,1500670,2025-02-26,House,"House - Third Reading",57,0,3,0,60
1955124,1526357,2025-03-24,Senate,"Senate Finance Committee Action (DP)",7,0,0,0,7
1955124,1530984,2025-03-31,Senate,"Senate Rules Committee Action (PFC)",0,0,0,0,0
1955124,1557068,2025-04-24,Senate,"Senate - Committee of the Whole (DP)",0,0,0,0,0
1955124,1562656,2025-04-30,Senate,"Senate - Third Reading",25,3,2,0,30
1955171,1491634,2025-02-17,House,"House Health & Human Services Committee Action (DP)",10,1,1,0,12
1955171,1498029,2025-02-24,House,"House Rules Committee Action (C&P)",7,0,0,1,8
1955171,1500913,2025-02-26,House,"House - Third Reading",57,0,3,0,60
1955171,1516232,2025-03-12,Senate,"Senate Health and Human Services Committee Action (HELD)",0,0,0,0,0
1955171,1521478,2025-03-19,Senate,"Senate Health and Human Services Committee Action (DPA)",5,2,0,0,7
1955171,1524991,2025-03-24,Senate,"Senate Rules Committee Action (PFC)",0,0,0,0,0
1955171,1565987,2025-05-06,Senate,"Senate - Committee of the Whole (DPA)",0,0,0,0,0
1955171,1565988,2025-05-06,Senate,"Senate - Third Reading",26,2,2,0,30
1955171,1567110,2025-05-07,House,"House - Concurrence",0,0,0,0,0
1955171,1567986,2025-05-07,House,"House - Third Reading",56,1,3,0,60
1955216,1486997,2025-02-11,House,"House Commerce Committee Action (DPA)",10,0,0,0,10
1955216,1491545,2025-02-17,House,"House Rules Committee Action (C&P)",7,0,0,1,8
1955216,1495088,2025-02-20,House,"House - Committee of the Whole (RET ON CAL)",0,0,0,0,0
1955216,1498671,2025-02-25,House,"House - Committee of the Whole (DPA)",0,0,0,0,0
1955216,1500637,2025-02-26,House,"House - Third Reading",57,0,3,0,60
1955216,1521072,2025-03-19,Senate,"Senate Government Committee Action (DP)",7,0,0,0,7
1955216,1539785,2025-04-08,Senate,"Senate Rules Committee Action (PFC)",0,0,0,0,0
1955216,1556978,2025-04-24,Senate,"Senate - Committee of the Whole (DP)",0,0,0,0,0
1955216,1562172,2025-04-30,Senate,"Senate - Third Reading",20,8,2,0,30
1955312,1487050,2025-02-11,House,"House Commerce Committee Action (DP)",7,3,0,0,10
1955312,1491167,2025-02-17,House,"House Rules Committee Action (C&P)",7,0,0,1,8
1955312,1504867,2025-03-04,House,"House - Committee of the Whole (RET ON CAL)",0,0,0,0,0
1955312,1505962,2025-03-05,House,"House - Committee of the Whole (DPA)",0,0,0,0,0
1955312,1507184,2025-03-06,House,"House - Third Reading",21,33,6,0,60
1955312,1507185,2025-03-06,House,"House - Reconsider Third Reading",0,0,0,0,0
1955491,1491558,2025-02-17,House,"House Land, Agriculture & Rural Affairs Committee Action (DP)",6,3,0,0,9
1955491,1497254,2025-02-24,House,"House Rules Committee Action (C&P)",7,0,0,1,8
1955491,1499752,2025-02-26,House,"House - Committee of the Whole (DP)",0,0,0,0,0
1955491,1504819,2025-03-04,House,"House - Third Reading",32,26,2,0,60
1955577,1492785,2025-02-18,House,"House Commerce Committee Action (DP)",8,0,0,2,10
1955577,1497219,2025-02-24,House,"House Rules Committee Action (C&P)",7,0,0,1,8
1955577,1500989,2025-02-26,House,"House - Third Reading",56,1,3,0,60
1955577,1521031,2025-03-19,Senate,"Senate Regulatory Affairs and Government Efficiency Committee Action (DP)",5,1,1,0,7
1955577,1524745,2025-03-24,Senate,"Senate Rules Committee Action (PFC)",0,0,0,0,0
1955577,1543825,2025-04-10,Senate,"Senate - Third Reading",24,5,1,0,30
1956263,1495693,2025-02-20,House,"House Natural Resources, Energy & Water Committee Action (DP)",5,2,1,2,10
1956263,1497415,2025-02-24,House,"House Rules Committee Action (C&P)",7,0,0,1,8
1956263,1501185,2025-02-27,House,"House - Committee of the Whole (DPA)",0,0,0,0,0
1956263,1504848,2025-03-04,House,"House - Third Reading",31,26,3,0,60
1956263,1527949,2025-03-25,Senate,"Senate Natural Resources Committee Action (DP)",4,3,1,0,8
1956263,1530990,2025-03-31,Senate,"Senate Rules Committee Action (PFC)",0,0,0,0,0
1956263,1567944,2025-05-07,Senate,"Senate - Committee of the Whole (DPA)",0,0,0,0,0
1956263,1567945,2025-05-07,Senate,"Senate - Third Reading",25,1,4,0,30
1956585,1525509,2025-03-24,House,"House - Third Reading",0,0,0,0,0
1958832,1492845,2025-02-18,House,"House Education Committee Action (DP)",12,0,0,0,12
1958832,1497315,2025-02-24,House,"House Rules Committee Action (C&P)",7,0,0,1,8
1958832,1500468,2025-02-26,House,"House - Third Reading",57,0,3,0,60
1958832,1516256,2025-03-12,Senate,"Senate Education Committee Action (DP)",7,0,0,0,7
1958832,1518770,2025-03-17,Senate,"Senate Rules Committee Action (PFC)",0,0,0,0,0
1958832,1545577,2025-03-12,Senate,"Senate Education-Archived and Renamed Education and Transportation as of 04/01/2025 Committee Action (DP)",7,0,0,0,7
1958832,1550254,2025-04-16,Senate,"Senate - Third Reading",27,2,1,0,30
1959224,1495348,2025-02-20,House,"House Government Committee Action (DP)",5,2,0,0,7
1959224,1499294,2025-02-25,House,"House Rules Committee Action (C&P)",7,0,0,1,8
1959301,1491520,2025-02-17,House,"House Land, Agriculture & Rural Affairs Committee Action (DP)",9,0,0,0,9
1959301,1497373,2025-02-24,House,"House Rules Committee Action (C&P)",7,0,0,1,8
1959301,1501392,2025-02-27,House,"House - Committee of the Whole (DPA)",0,0,0,0,0
1959301,1505544,2025-03-04,House,"House - Third Reading",57,0,3,0,60
1959301,1520233,2025-03-18,Senate,"Senate Natural Resources Committee Action (DP)",7,0,1,0,8
1959301,1525283,2025-03-24,Senate,"Senate Rules Committee Action (PFC)",0,0,0,0,0
1959301,1529547,2025-03-27,Senate,"Senate - Third Reading",21,5,3,0,29
1959445,1488149,2025-02-12,House,"House Education Committee Action (W/D)",0,0,0,0,0
1959584,1493917,2025-02-19,House,"House Federalism, Military Affairs & Elections Committee Action (DP)",3,2,1,1,7
1959584,1497273,2025-02-24,House,"House Rules Committee Action (C&P)",7,0,0,1,8
1959584,1499951,2025-02-26,House,"House - Committee of the Whole (DP)",0,0,0,0,0
1959584,1504963,2025-03-04,House,"House - Third Reading",31,26,3,0,60
1959584,1528695,2025-03-26,Senate,"Senate Judiciary and Elections Committee Action (DP)",4,3,0,0,7
1959584,1531253,2025-03-31,Senate,"Senate Rules Committee Action (PFC)",0,0,0,0,0
1959584,1565664,2025-05-06,Senate,"Senate - Committee of the Whole (DP)",0,0,0,0,0
1959584,1565665,2025-05-06,Senate,"Senate - Third Reading",17,11,2,0,30
1959801,1495488,2025-02-20,House,"House Natural Resources, Energy & Water Committee Action (DPA)",5,3,0,2,10
1959801,1497967,2025-02-24,House,"House Rules Committee Action (C&P)",7,0,0,1,8
1959801,1499770,2025-02-26,House,"House - Committee of the Whole (DPA)",0,0,0,0,0
1959801,1506762,2025-03-05,House,"House - Third Reading",33,25,2,0,60
1959801,1520382,2025-03-18,Senate,"Senate Natural Resources Committee Action (DP)",5,3,0,0,8
1959801,1524740,2025-03-24,Senate,"Senate Rules Committee Action (PFC)",0,0,0,0,0
1959801,1566414,2025-05-06,Senate,"Senate - Third Reading",17,11,2,0,30
1959874,1492852,2025-02-18,House,"House Natural Resources, Energy & Water Committee Action (DP)",6,4,0,0,10
1959874,1497423,2025-02-24,House,"House Rules Committee Action (C&P)",7,0,0,1,8
1959874,1500961,2025-02-26,House,"House - Third Reading",32,27,1,0,60
1959874,1515117,2025-03-11,Senate,"Senate Natural Resources Committee Action (DP)",5,2,1,0,8
1959874,1518914,2025-03-17,Senate,"Senate Rules Committee Action (PFC)",0,0,0,0,0
1959874,1549949,2025-04-16,Senate,"Senate - Third Reading",17,12,1,0,30
1960229,1492700,2025-02-18,House,"House Natural Resources, Energy & Water Committee Action (DPA/SE)",6,4,0,0,10
1960229,1497298,2025-02-24,House,"House Rules Committee Action (C&P)",7,0,0,1,8
1960229,1498755,2025-02-25,House,"House - Committee of the Whole (DPA)",0,0,0,0,0
1960229,1500462,2025-02-26,House,"House - Third Reading",35,24,1,0,60
1960229,1514274,2025-03-11,Senate,"Senate Natural Resources Committee Action (DP)",5,3,0,0,8
1960229,1518772,2025-03-17,Senate,"Senate Rules Committee Action (PFC)",0,0,0,0,0
1960229,1550136,2025-04-16,Senate,"Senate - Third Reading",16,13,1,0,30
1960347,1492979,2025-02-19,House,"House Judiciary Committee Action (DP)",8,1,0,0,9
1960347,1497314,2025-02-24,House,"House Rules Committee Action (C&P)",7,0,0,1,8
1960347,1503218,2025-03-03,House,"Motion Motion by Representative Carbone that pursuant to House Rule 12(P), HB2786 be calendared for an Additional Committee of the Whole for purposes of further amending. Motion passed v/v.",0,0,0,0,0
1960347,1503219,2025-03-03,House,"House - Committee of the Whole (DPA)",0,0,0,0,0
1960347,1507219,2025-03-06,House,"House - Third Reading",24,30,6,0,60
1960347,1507220,2025-03-06,House,"House - Reconsider Third Reading",0,0,0,0,0
1960347,1513811,2025-03-11,House,"House - Third Reading",26,31,3,0,60
1960388,1492491,2025-02-18,House,"House Education Committee Action (DPA)",6,4,0,2,12
1960388,1497351,2025-02-24,House,"House Rules Committee Action (C&P)",7,0,0,1,8
1960388,1499316,2025-02-25,House,"House - Committee of the Whole (DPA)",0,0,0,0,0
1960388,1500603,2025-02-26,House,"House - Third Reading",43,16,1,0,60
1960514,1491696,2025-02-17,House,"House Health & Human Services Committee Action (DP)",11,1,0,0,12
1960514,1498158,2025-02-24,House,"House Rules Committee Action (C&P)",7,0,0,1,8
1960514,1500694,2025-02-26,House,"House - Committee of the Whole (DP)",0,0,0,0,0
1960514,1503286,2025-03-03,House,"House - Third Reading",56,2,2,0,60
1960514,1528142,2025-03-26,Senate,"Senate Health and Human Services Committee Action (FAILED)",1,5,1,0,7
1960765,1492905,2025-02-18,House,"House Commerce Committee Action (DP)",6,3,0,1,10
1960765,1497433,2025-02-24,House,"House Rules Committee Action (C&P)",7,0,0,1,8
1960765,1499903,2025-02-26,House,"House - Committee of the Whole (DP)",0,0,0,0,0
1960765,1503946,2025-03-03,House,"House - Third Reading",37,21,2,0,60
1960765,1527817,2025-03-26,Senate,"Senate Regulatory Affairs and Government Efficiency Committee Action (DPA)",7,0,0,0,7
1960765,1531315,2025-03-31,Senate,"Senate Rules Committee Action (PFC)",0,0,0,0,0
1960765,1565707,2025-05-06,Senate,"Senate - Committee of the Whole (DPA)",0,0,0,0,0
1960765,1565708,2025-05-06,Senate,"Senate - Third Reading",28,0,2,0,30
1960765,1567438,2025-05-07,House,"House - Concurrence",0,0,0,0,0
1960765,1567439,2025-05-07,House,"House - Third Reading",52,5,3,0,60
1960806,1492508,2025-02-18,House,"House Natural Resources, Energy & Water Committee Action (DP)",6,4,0,0,10
1960806,1497299,2025-02-24,House,"House Rules Committee Action (C&P)",7,0,0,1,8
1960806,1500433,2025-02-26,House,"House - Third Reading",31,28,1,0,60
1960806,1520281,2025-03-18,Senate,"Senate Natural Resources Committee Action (DP)",5,3,0,0,8
1960806,1524826,2025-03-24,Senate,"Senate Rules Committee Action (PFC)",0,0,0,0,0
1960806,1550078,2025-04-16,Senate,"Senate - Third Reading",17,12,1,0,30
1960932,1492500,2025-02-18,House,"House Judiciary Committee Action (W/D)",0,0,0,0,0
1960932,1496104,2025-02-20,House,"House Government Committee Action (DPA)",7,0,0,0,7
1960932,1497225,2025-02-24,House,"House Rules Committee Action (C&P)",7,0,0,1,8
1960932,1501610,2025-02-27,House,"House - Committee of the Whole (DPA)",0,0,0,0,0
1960932,1503444,2025-03-03,House,"House - Third Reading",58,0,2,0,60
1960932,1528534,2025-03-26,Senate,"Senate Judiciary and Elections Committee Action (DPA)",5,0,2,0,7
1960932,1531563,2025-03-31,Senate,"Senate Rules Committee Action (PFC)",0,0,0,0,0
1960932,1565841,2025-05-06,Senate,"Senate - Committee of the Whole (RETAINED)",0,0,0,0,0
1960970,1490923,2025-02-17,House,"House Commerce Committee Action (W/D)",0,0,0,0,0
1960970,1495364,2025-02-20,House,"House Government Committee Action (DP)",4,3,0,0,7
1960970,1503848,2025-03-03,House,"House Rules Committee Action (C&P)",8,0,0,0,8
1962215,1491460,2025-02-17,House,"House Land, Agriculture & Rural Affairs Committee Action (DPA)",5,3,1,0,9
1962215,1497241,2025-02-24,House,"House Rules Committee Action (HELD)",0,0,0,0,0
1962215,1499924,2025-02-25,House,"House Rules Committee Action (C&P)",7,0,0,1,8
1962215,1501327,2025-02-27,House,"House - Committee of the Whole (DPA)",0,0,0,0,0
1962215,1506456,2025-03-05,House,"House - Third Reading",52,6,2,0,60
1962411,1493174,2025-02-19,House,"House Judiciary Committee Action (DP)",6,3,0,0,9
1962411,1503419,2025-03-03,House,"House Rules Committee Action (C&P)",8,0,0,0,8
1962411,1506000,2025-03-05,House,"House - Committee of the Whole (DP)",0,0,0,0,0
1962411,1514301,2025-03-11,House,"House - Third Reading",37,20,3,0,60
1962602,1494206,2025-02-19,House,"House Government Committee Action (DP)",4,3,0,0,7
1962602,1497474,2025-02-24,House,"House Rules Committee Action (C&P)",7,0,0,1,8
1962602,1499843,2025-02-26,House,"House - Committee of the Whole (DP)",0,0,0,0,0
1962602,1505075,2025-03-04,House,"House - Third Reading",31,26,3,0,60
1962602,1521413,2025-03-19,Senate,"Senate Government Committee Action (DP)",4,3,0,0,7
1962602,1524844,2025-03-24,Senate,"Senate Rules Committee Action (PFC)",0,0,0,0,0
1962602,1566408,2025-05-06,Senate,"Senate - Third Reading",17,11,2,0,30
1962799,1492439,2025-02-18,House,"House Education Committee Action (HELD)",0,0,0,0,0
1963317,1493664,2025-02-19,House,"House Science & Technology Committee Action (DPA)",7,1,0,1,9
1963317,1497231,2025-02-24,House,"House Rules Committee Action (C&P)",7,0,0,1,8
1963317,1499028,2025-02-25,House,"House - Committee of the Whole (DPA)",0,0,0,0,0
1963317,1500996,2025-02-26,House,"House - Third Reading",40,17,3,0,60
1963435,1493299,2025-02-19,House,"House Government Committee Action (DP)",4,3,0,0,7
1963435,1497308,2025-02-24,House,"House Rules Committee Action (C&P)",7,0,0,1,8
1963435,1501068,2025-02-27,House,"Motion Motion by Representative Carbone that pursuant to House Rule 12(P), HB2803 be calendared for an Additional Committee of the Whole for purposes of further amending. Motion passed v/v.",0,0,0,0,0
1963435,1501069,2025-02-27,House,"House - Committee of the Whole (DPA)",0,0,0,0,0
1963435,1504925,2025-03-04,House,"House - Third Reading",31,26,3,0,60
1963435,1520981,2025-03-19,Senate,"Senate Government Committee Action (DP)",4,3,0,0,7
1963435,1524823,2025-03-24,Senate,"Senate Rules Committee Action (PFC)",0,0,0,0,0
1963435,1565595,2025-05-06,Senate,"Senate - Third Reading",17,11,2,0,30
1963435,1566459,2025-05-06,Senate,"Senate - Committee of the Whole (DP)",0,0,0,0,0
1963604,1495766,2025-02-20,House,"House Public Safety & Law Enforcement Committee Action (DP)",13,0,0,2,15
1963604,1497409,2025-02-24,House,"House Rules Committee Action (C&P)",7,0,0,1,8
1963604,1500920,2025-02-26,House,"House - Third Reading",59,0,1,0,60
1963660,1494157,2025-02-19,House,"House Appropriations Committee Action (DP)",11,6,1,0,18
1963660,1497261,2025-02-24,House,"House Rules Committee Action (C&P)",7,0,0,1,8
1963660,1500454,2025-02-26,House,"House - Third Reading",32,27,1,0,60
1963660,1514209,2025-03-11,Senate,"Senate Appropriations Committee Action (FAILED)",5,5,0,0,10
1963660,1520342,2025-03-18,Senate,"Senate Appropriations Committee Action (DP)",6,4,0,0,10
1963660,1524770,2025-03-24,Senate,"Senate Rules Committee Action (PFC)",0,0,0,0,0
1963660,1549792,2025-04-16,Senate,"Senate - Third Reading",17,12,1,0,30
1963939,1491701,2025-02-17,House,"House Health & Human Services Committee Action (DP)",8,4,0,0,12
1963939,1497413,2025-02-24,House,"House Rules Committee Action (C&P)",7,0,0,1,8
1963939,1500756,2025-02-26,House,"House - Committee of the Whole (DP)",0,0,0,0,0
1963939,1503615,2025-03-03,House,"House - Third Reading",36,22,2,0,60
1963939,1520950,2025-03-19,Senate,"Senate Health and Human Services Committee Action (HELD)",0,0,0,0,0
1964119,1497607,2025-02-24,House,"House Judiciary Committee Action (W/D)",0,0,0,0,0
1964119,1500899,2025-02-24,House,"House Appropriations Committee Action (DP)",17,1,0,0,18
1964119,1500900,2025-02-25,House,"House Rules Committee Action (C&P)",7,0,0,1,8
1964124,1493214,2025-02-19,House,"House Judiciary Committee Action (HELD)",0,0,0,0,0
1964126,1496105,2025-02-20,House,"House Government Committee Action (DP)",4,3,0,0,7
1964126,1497430,2025-02-24,House,"House Rules Committee Action (C&P)",7,0,0,1,8
1964126,1500708,2025-02-26,House,"House - Third Reading",32,27,1,0,60
1964126,1521837,2025-03-19,Senate,"Senate Government Committee Action (DPA)",4,3,0,0,7
1964126,1525266,2025-03-24,Senate,"Senate Rules Committee Action (PFC)",0,0,0,0,0
1964126,1544608,2025-04-10,Senate,"Senate - Committee of the Whole (DPA)",0,0,0,0,0
1964126,1550371,2025-04-16,Senate,"Senate - Third Reading",17,13,0,0,30
1964126,1563718,2025-05-01,House,"House - Concurrence",0,0,0,0,0
1964126,1563719,2025-05-01,House,"House - Third Reading",31,26,3,0,60
1964132,1493229,2025-02-19,House,"House Ways & Means Committee Action (DPA)",5,4,0,0,9
1964132,1497240,2025-02-24,House,"House Rules Committee Action (C&P)",7,0,0,1,8
1964132,1498699,2025-02-25,House,"House - Committee of the Whole (DPA)",0,0,0,0,0
1964132,1500380,2025-02-26,House,"House - Third Reading",32,27,1,0,60
1964132,1509721,2025-03-10,Senate,"Senate Finance Committee Action (DP)",4,3,0,0,7
1964132,1518912,2025-03-17,Senate,"Senate Rules Committee Action (PFC)",0,0,0,0,0
1964132,1549976,2025-04-16,Senate,"Senate - Third Reading",17,12,1,0,30
1964144,1493985,2025-02-19,House,"House Federalism, Military Affairs & Elections Committee Action (FAILED)",0,5,2,0,7
1964165,1493977,2025-02-19,House,"House Transportation & Infrastructure Committee Action (DP)",7,0,0,0,7
1964165,1498555,2025-02-25,House,"House Rules Committee Action (C&P)",7,0,0,1,8
1964165,1503734,2025-03-03,House,"House - Third Reading",49,9,2,0,60
1964165,1521706,2025-03-19,Senate,"Senate Public Safety Committee Action (DP)",6,0,1,0,7
1964165,1524780,2025-03-24,Senate,"Senate Rules Committee Action (PFC)",0,0,0,0,0
1964165,1566207,2025-05-06,Senate,"Senate - Third Reading",24,4,2,0,30
1964168,1494901,2025-02-20,House,"House Ways & Means Committee Action (W/D)",0,0,0,0,0
1964168,1497539,2025-02-24,House,"House Appropriations Committee Action (DPA/SE)",10,8,0,0,18
1964168,1499935,2025-02-26,House,"House - Committee of the Whole (RET ON CAL)",0,0,0,0,0
1964168,1500436,2025-02-25,House,"House Rules Committee Action (C&P)",7,0,0,1,8
1964168,1506257,2025-03-05,House,"House - Committee of the Whole (DPA)",0,0,0,0,0
1964169,1488545,2025-02-12,House,"House Health & Human Services Committee Action (W/D)",0,0,0,0,0
1964169,1493906,2025-02-19,House,"House Science & Technology Committee Action (DP)",9,0,0,0,9
1964169,1497419,2025-02-24,House,"House Rules Committee Action (C&P)",7,0,0,1,8
1964179,1493309,2025-02-19,House,"House Judiciary Committee Action (DP)",9,0,0,0,9
1964179,1497229,2025-02-24,House,"House Rules Committee Action (C&P)",7,0,0,1,8
1964179,1499793,2025-02-26,House,"House - Committee of the Whole (DPA)",0,0,0,0,0
1964179,1503691,2025-03-03,House,"House - Third Reading",58,0,2,0,60
1964179,1521671,2025-03-19,Senate,"Senate Public Safety Committee Action (HELD)",0,0,0,0,0
1964179,1528119,2025-03-26,Senate,"Senate Public Safety Committee Action (DPA)",6,0,1,0,7
1964179,1531238,2025-03-31,Senate,"Senate Rules Committee Action (PFC)",0,0,0,0,0
1964179,1555639,2025-04-23,Senate,"Senate - Committee of the Whole (DPA)",0,0,0,0,0
1964179,1560321,2025-04-29,Senate,"Senate - Third Reading",29,0,1,0,30
1964179,1565709,2025-05-06,House,"House - Concurrence",0,0,0,0,0
1964179,1565710,2025-05-06,House,"House - Third Reading",55,0,5,0,60
1964188,1489389,2025-02-13,House,"House Federalism, Military Affairs & Elections Committee Action (W/D)",0,0,0,0,0
1964188,1495315,2025-02-20,House,"House Government Committee Action (DPA)",7,0,0,0,7
1964195,1491484,2025-02-17,House,"House Health & Human Services Committee Action (DP)",12,0,0,0,12
1964195,1497424,2025-02-24,House,"House Rules Committee Action (C&P)",7,0,0,1,8
1964209,1491421,2025-02-17,House,"House - Third Reading",0,0,0,0,0
1964209,1491422,2025-02-17,Senate,"Senate - Third Reading",0,0,0,0,0
1964216,1495786,2025-02-20,House,"House Public Safety & Law Enforcement Committee Action (DPA/SE)",9,1,3,2,15
1964216,1497439,2025-02-24,House,"House Rules Committee Action (C&P)",7,0,0,1,8
1964216,1498617,2025-02-25,House,"House - Committee of the Whole (DPA)",0,0,0,0,0
1964216,1500698,2025-02-26,House,"House - Third Reading",39,20,1,0,60
1964216,1509531,2025-03-10,Senate,"Senate Appropriations Committee Action (W/D)",0,0,0,0,0
1964216,1509532,2025-03-10,Senate,"Senate Public Safety Committee Action (W/D)",0,0,0,0,0
1964217,1494469,2025-02-19,House,"House Appropriations Committee Action (DP)",17,1,0,0,18
1964217,1497944,2025-02-24,House,"House Rules Committee Action (C&P)",7,0,0,1,8
1964217,1500574,2025-02-26,House,"House - Third Reading",50,9,1,0,60
1964217,1516318,2025-03-12,Senate,"Senate Public Safety Committee Action (DP)",7,0,0,0,7
1964217,1520212,2025-03-18,Senate,"Senate Appropriations Committee Action (DP)",9,0,1,0,10
1964222,1492254,2025-02-18,House,"House Commerce Committee Action (DPA)",7,3,0,0,10
1964222,1497392,2025-02-24,House,"House Rules Committee Action (C&P)",7,0,0,1,8
1964222,1499789,2025-02-26,House,"House - Committee of the Whole (DPA)",0,0,0,0,0
1964222,1501557,2025-02-27,House,"House - Third Reading",42,15,3,0,60
1964232,1493846,2025-02-19,House,"House Federalism, Military Affairs & Elections Committee Action (DP)",4,3,0,0,7
1964232,1497301,2025-02-24,House,"House Rules Committee Action (C&P)",7,0,0,1,8
1964232,1500470,2025-02-26,House,"House - Third Reading",25,34,1,0,60
1964237,1497765,2025-02-24,House,"House Appropriations Committee Action (DPA)",11,6,0,1,18
1964237,1499913,2025-02-26,House,"House - Committee of the Whole (DPA)",0,0,0,0,0
1964237,1500412,2025-02-25,House,"House Rules Committee Action (C&P)",7,0,0,1,8
1964237,1503688,2025-03-03,House,"House - Third Reading",32,26,2,0,60
1964237,1532675,2025-04-01,Senate,"Senate Appropriations Committee Action (DP)",6,4,0,0,10
1964243,1496054,2025-02-20,House,"House Government Committee Action (DP)",7,0,0,0,7
1964252,1497406,2025-02-24,House,"House Appropriations Committee Action (DPA)",13,1,4,0,18
1964252,1499970,2025-02-25,House,"House Rules Committee Action (C&P)",7,0,0,1,8
1964252,1499971,2025-02-26,House,"House - Committee of the Whole (DPA)",0,0,0,0,0
1964252,1503665,2025-03-03,House,"House - Third Reading",36,22,2,0,60
1964252,1514031,2025-03-11,Senate,"Senate Appropriations Committee Action (DP)",10,0,0,0,10
1964263,1494455,2025-02-19,House,"House Federalism, Military Affairs & Elections Committee Action (DP)",4,3,0,0,7
1964263,1497431,2025-02-24,House,"House Rules Committee Action (C&P)",7,0,0,1,8
1964263,1500045,2025-02-26,House,"House - Committee of the Whole (DP)",0,0,0,0,0
1964263,1509197,2025-03-10,House,"House - Third Reading",31,25,4,0,60
1964263,1527272,2025-03-25,Senate,"Senate Natural Resources Committee Action (DP)",4,3,1,0,8
1964263,1531289,2025-03-31,Senate,"Senate Rules Committee Action (PFC)",0,0,0,0,0
1964263,1544252,2025-04-10,Senate,"Senate - Committee of the Whole (DP)",0,0,0,0,0
1964263,1549811,2025-04-16,Senate,"Senate - Third Reading",17,12,1,0,30
1964269,1495952,2025-02-20,House,"House Government Committee Action (DP)",4,2,1,0,7
1964269,1497421,2025-02-24,House,"House Rules Committee Action (C&P)",7,0,0,1,8
1964269,1500818,2025-02-26,House,"House - Third Reading",37,22,1,0,60
1964269,1521258,2025-03-19,Senate,"Senate Government Committee Action (DPA)",4,3,0,0,7
1964269,1524696,2025-03-24,Senate,"Senate Rules Committee Action (PFC)",0,0,0,0,0
1964269,1556921,2025-04-24,Senate,"Senate - Committee of the Whole (RETAINED)",0,0,0,0,0
1964269,1562149,2025-04-30,Senate,"Senate - Committee of the Whole (DPA)",0,0,0,0,0
1964269,1566821,2025-05-06,Senate,"Senate - Third Reading",17,11,2,0,30
1964269,1567078,2025-05-07,House,"House - Concurrence",0,0,0,0,0
1964269,1567985,2025-05-07,House,"House - Third Reading",34,23,3,0,60
1964273,1528302,2025-03-26,Senate,"Senate - Third Reading",0,0,0,0,0
1964273,1528303,2025-03-26,House,"House - Third Reading",0,0,0,0,0
1964276,1493986,2025-02-19,House,"House Federalism, Military Affairs & Elections Committee Action (FAILED)",1,4,2,0,7
1964283,1494091,2025-02-19,House,"House Appropriations Committee Action (DPA)",10,8,0,0,18
1964283,1503497,2025-03-03,House,"House Rules Committee Action (C&P)",8,0,0,0,8
1964297,1492627,2025-02-18,House,"House Commerce Committee Action (DPA)",9,1,0,0,10
1964297,1497339,2025-02-24,House,"House Rules Committee Action (C&P)",7,0,0,1,8
1964297,1499986,2025-02-26,House,"House - Committee of the Whole (DPA)",0,0,0,0,0
1964297,1503483,2025-03-03,House,"House - Third Reading",33,25,2,0,60
1964303,1493563,2025-02-19,House,"House Federalism, Military Affairs & Elections Committee Action (DP)",3,0,4,0,7
1964303,1497407,2025-02-24,House,"House Rules Committee Action (C&P)",7,0,0,1,8
1964303,1500355,2025-02-26,House,"House - Third Reading",31,28,1,0,60
1964309,1492564,2025-02-18,House,"House Commerce Committee Action (DP)",8,0,0,2,10
1964309,1497970,2025-02-24,House,"House Rules Committee Action (C&P)",7,0,0,1,8
1964309,1500571,2025-02-26,House,"House - Third Reading",56,1,3,0,60
1964309,1516161,2025-03-12,Senate,"Senate Regulatory Affairs and Government Efficiency Committee Action (DP)",7,0,0,0,7
1964309,1519245,2025-03-17,Senate,"Senate Rules Committee Action (PFC)",0,0,0,0,0
1964309,1529563,2025-03-27,Senate,"Senate - Third Reading",26,0,3,0,29
1964327,1494427,2025-02-19,House,"House Appropriations Committee Action (DP)",11,7,0,0,18
1964327,1497296,2025-02-24,House,"House Rules Committee Action (C&P)",7,0,0,1,8
1964327,1499991,2025-02-26,House,"House - Committee of the Whole (DP)",0,0,0,0,0
1964327,1506549,2025-03-05,House,"House - Third Reading",32,26,2,0,60
1964327,1521092,2025-03-19,Senate,"Senate Regulatory Affairs and Government Efficiency Committee Action (DP)",4,3,0,0,7
1964327,1524706,2025-03-24,Senate,"Senate Rules Committee Action (PFC)",0,0,0,0,0
1964327,1549952,2025-04-16,Senate,"Senate - Third Reading",17,12,1,0,30
1964334,1488033,2025-02-12,House,"House Government Committee Action (W/D)",0,0,0,0,0
1964334,1492547,2025-02-18,House,"House Commerce Committee Action (DP)",6,3,1,0,10
1964334,1497279,2025-02-24,House,"House Rules Committee Action (HELD)",0,0,0,0,0
1964334,1499784,2025-02-25,House,"House Rules Committee Action (C&P)",7,0,0,1,8
1964334,1499785,2025-02-26,House,"House - Committee of the Whole (DP)",0,0,0,0,0
1964337,1491300,2025-02-17,House,"House Judiciary Committee Action (W/D)",0,0,0,0,0
1964337,1494038,2025-02-19,House,"House Ways & Means Committee Action (DP)",9,0,0,0,9
1964337,1503510,2025-03-03,House,"House Rules Committee Action (C&P)",8,0,0,0,8
1964341,1493893,2025-02-19,House,"House Science & Technology Committee Action (DPA)",7,2,0,0,9
1964341,1497234,2025-02-24,House,"House Rules Committee Action (C&P)",7,0,0,1,8
1964341,1498677,2025-02-25,House,"House - Committee of the Whole (DPA)",0,0,0,0,0
1964341,1503754,2025-03-03,House,"House - Third Reading",31,27,2,0,60
1964341,1527632,2025-03-26,Senate,"Senate Government Committee Action (DPA/SE)",4,3,0,0,7
1964354,1494052,2025-02-19,House,"House Appropriations Committee Action (DPA)",17,0,0,1,18
1964354,1497257,2025-02-24,House,"House Rules Committee Action (C&P)",7,0,0,1,8
1964354,1501371,2025-02-27,House,"House - Committee of the Whole (DPA)",0,0,0,0,0
1964361,1492403,2025-02-18,House,"House Commerce Committee Action (W/D)",0,0,0,0,0
1964361,1497978,2025-02-24,House,"House Appropriations Committee Action (DPA)",18,0,0,0,18
1964361,1499919,2025-02-26,House,"House - Committee of the Whole (DPA)",0,0,0,0,0
1964361,1500815,2025-02-25,House,"House Rules Committee Action (C&P)",7,0,0,1,8
1964361,1503683,2025-03-03,House,"House - Third Reading",47,11,2,0,60
1964370,1495788,2025-02-20,House,"House Government Committee Action (DP)",4,3,0,0,7
1964370,1497343,2025-02-24,House,"House Rules Committee Action (C&P)",7,0,0,1,8
1964370,1500036,2025-02-26,House,"House - Committee of the Whole (DP)",0,0,0,0,0
1964370,1506425,2025-03-05,House,"House - Third Reading",32,26,2,0,60
1964370,1521527,2025-03-19,Senate,"Senate Judiciary and Elections Committee Action (DP)",4,3,0,0,7
1964371,1493760,2025-02-19,House,"House Transportation & Infrastructure Committee Action (DP)",6,0,0,1,7
1964371,1503835,2025-03-03,House,"House Rules Committee Action (C&P)",8,0,0,0,8
1964371,1506234,2025-03-05,House,"House - Committee of the Whole (DPA)",0,0,0,0,0
1964371,1509300,2025-03-10,House,"House - Third Reading",38,18,4,0,60
1964371,1528079,2025-03-26,Senate,"Senate Public Safety Committee Action (DPA)",6,0,1,0,7
1964371,1531217,2025-03-31,Senate,"Senate Rules Committee Action (PFC)",0,0,0,0,0
1964371,1544080,2025-04-10,Senate,"Senate - Committee of the Whole (DPA)",0,0,0,0,0
1964371,1549739,2025-04-16,Senate,"Senate - Third Reading",29,1,0,0,30
1964371,1558943,2025-04-28,House,"House - Concurrence",0,0,0,0,0
1964371,1558944,2025-04-28,House,"House - Third Reading",33,22,5,0,60
1964374,1492750,2025-02-18,House,"House Education Committee Action (DPA/SE)",7,2,2,1,12
1964374,1497427,2025-02-24,House,"House Rules Committee Action (C&P)",7,0,0,1,8
1964374,1499493,2025-02-25,House,"House - Committee of the Whole (RET ON CAL)",0,0,0,0,0
1964374,1501760,2025-02-27,House,"House - Committee of the Whole (DPA)",0,0,0,0,0
1964374,1503902,2025-03-03,House,"Motion Motion by Representative Carbone that pursuant to House Rule 12(P), HB2883 be calendared for an Additional Committee of the Whole for purposes of further amending. Motion passed v/v.",0,0,0,0,0
1964374,1503903,2025-03-03,House,"House - Committee of the Whole (DPA)",0,0,0,0,0
1964374,1512410,2025-03-10,House,"House - Third Reading",21,35,4,0,60
1964374,1512411,2025-03-10,House,"House - Reconsider Third Reading",0,0,0,0,0
1964374,1517570,2025-03-13,House,"Motion Motion by Representative Carbone that pursuant to House Rule 12(P), HB2883 be calendared for an Additional Committee of the Whole for purposes of further amending. Motion passed v/v.",0,0,0,0,0
1964374,1517571,2025-03-13,House,"House - Committee of the Whole (DPA)",0,0,0,0,0
1964380,1492670,2025-02-18,House,"House Education Committee Action (DPA)",8,4,0,0,12
1964380,1497770,2025-02-24,House,"House Rules Committee Action (HELD)",0,0,0,0,0
1964380,1499870,2025-02-26,House,"House - Committee of the Whole (DPA)",0,0,0,0,0
1964380,1500607,2025-02-25,House,"House Rules Committee Action (C&P)",7,0,0,1,8
1964380,1503690,2025-03-03,House,"House - Third Reading",38,20,2,0,60
1964380,1522341,2025-03-19,Senate,"Senate Education Committee Action (DP)",4,3,0,0,7
1964380,1524982,2025-03-24,Senate,"Senate Rules Committee Action (PFC)",5,4,0,0,9
1964380,1545468,2025-03-19,Senate,"Senate Education-Archived as of 04/01/2025 Committee Action (DP)",4,3,0,0,7
1964380,1546769,2025-03-19,Senate,"Senate Education-Archived and Renamed Education and Transportation as of 04/01/2025 Committee Action (DP)",4,3,0,0,7
1964382,1489391,2025-02-13,House,"House Federalism, Military Affairs & Elections Committee Action (W/D)",0,0,0,0,0
1964382,1492990,2025-02-19,House,"House Government Committee Action (DP)",7,0,0,0,7
1964382,1498728,2025-02-25,House,"House Rules Committee Action (C&P)",7,0,0,1,8
1964395,1492620,2025-02-18,House,"House Education Committee Action (DP)",9,0,3,0,12
1964395,1497232,2025-02-24,House,"House Rules Committee Action (C&P)",7,0,0,1,8
1964395,1499914,2025-02-26,House,"House - Committee of the Whole (DPA)",0,0,0,0,0
1964395,1503753,2025-03-03,House,"House - Third Reading",41,17,2,0,60
1964395,1514276,2025-03-11,Senate,"Senate Education Committee Action (W/D)",0,0,0,0,0
1964395,1521418,2025-03-19,Senate,"Senate Public Safety Committee Action (DP)",4,3,0,0,7
1964395,1524741,2025-03-24,Senate,"Senate Rules Committee Action (PFC)",5,4,0,0,9
1964395,1545790,2025-03-11,Senate,"Senate Education-Archived and Renamed Education and Transportation as of 04/01/2025 Committee Action (W/D)",0,0,0,0,0
1964395,1556720,2025-04-24,Senate,"Senate - Committee of the Whole (DP)",0,0,0,0,0
1964395,1562091,2025-04-30,Senate,"Senate - Third Reading",18,10,2,0,30
1964401,1493933,2025-02-19,House,"House Judiciary Committee Action (DP)",6,2,0,1,9
1964401,1497412,2025-02-24,House,"House Rules Committee Action (C&P)",7,0,0,1,8
1964401,1500949,2025-02-26,House,"House - Third Reading",36,23,1,0,60
1964409,1492703,2025-02-18,House,"House Commerce Committee Action (DP)",9,0,0,1,10
1964409,1497418,2025-02-24,House,"House Rules Committee Action (C&P)",7,0,0,1,8
1964409,1499498,2025-02-25,House,"House - Committee of the Whole (DPA)",0,0,0,0,0
1964409,1500688,2025-02-26,House,"House - Third Reading",57,0,3,0,60
1964409,1519517,2025-03-17,Senate,"Senate Finance Committee Action (DP)",6,1,0,0,7
1964409,1524793,2025-03-24,Senate,"Senate Rules Committee Action (PFC)",0,0,0,0,0
1964409,1550101,2025-04-16,Senate,"Senate - Third Reading",17,12,1,0,30
1964429,1493737,2025-02-19,House,"House Transportation & Infrastructure Committee Action (DP)",7,0,0,0,7
1964429,1497426,2025-02-24,House,"House Rules Committee Action (C&P)",7,0,0,1,8
1964429,1500933,2025-02-26,House,"House - Third Reading",47,10,3,0,60
1964429,1521802,2025-03-19,Senate,"Senate Public Safety Committee Action (HELD)",0,0,0,0,0
1964431,1492427,2025-02-18,House,"House Commerce Committee Action (DPA)",8,0,0,2,10
1964431,1498566,2025-02-25,House,"House Rules Committee Action (C&P)",7,0,0,1,8
1964431,1501335,2025-02-27,House,"House - Committee of the Whole (DPA)",0,0,0,0,0
1964433,1493247,2025-02-19,House,"House Ways & Means Committee Action (DPA)",5,4,0,0,9
1964433,1497260,2025-02-24,House,"House Rules Committee Action (C&P)",7,0,0,1,8
1964433,1498718,2025-02-25,House,"House - Committee of the Whole (DPA)",0,0,0,0,0
1964433,1500438,2025-02-26,House,"House - Third Reading",31,28,1,0,60
1964433,1526014,2025-03-24,Senate,"Senate Finance Committee Action (DP)",4,3,0,0,7
1964433,1532819,2025-04-01,Senate,"Senate Appropriations Committee Action (DP)",6,4,0,0,10
1964447,1492996,2025-02-19,House,"House Judiciary Committee Action (DP)",6,2,0,1,9
1964447,1497262,2025-02-24,House,"House Rules Committee Action (C&P)",7,0,0,1,8
1964447,1500446,2025-02-26,House,"House - Third Reading",32,27,1,0,60
1964447,1528609,2025-03-26,Senate,"Senate Judiciary and Elections Committee Action (DP)",4,3,0,0,7
1964457,1493997,2025-02-19,House,"House Federalism, Military Affairs & Elections Committee Action (HELD)",0,0,0,0,0
1964458,1495249,2025-02-20,House,"House Government Committee Action (DP)",4,3,0,0,7
1964458,1497284,2025-02-24,House,"House Rules Committee Action (HELD)",0,0,0,0,0
1964458,1499890,2025-02-25,House,"House Rules Committee Action (C&P)",7,0,0,1,8
1964458,1499891,2025-02-26,House,"House - Committee of the Whole (DP)",0,0,0,0,0
1964458,1503600,2025-03-03,House,"House - Third Reading",32,26,2,0,60
1964458,1527594,2025-03-26,Senate,"Senate Government Committee Action (DPA/SE)",4,3,0,0,7
1964458,1531185,2025-03-31,Senate,"Senate Rules Committee Action (PFC)",5,4,0,0,9
1964458,1562128,2025-04-30,Senate,"Senate - Committee of the Whole (DPA)",0,0,0,0,0
1964458,1566377,2025-05-06,Senate,"Senate - Third Reading",17,11,2,0,30
1964458,1567285,2025-05-07,House,"House - Concurrence",0,0,0,0,0
1964458,1567286,2025-05-07,House,"House - Third Reading",33,25,2,0,60
1964481,1494305,2025-02-19,House,"House Federalism, Military Affairs & Elections Committee Action (DP)",4,3,0,0,7
1964481,1497420,2025-02-24,House,"House Rules Committee Action (C&P)",7,0,0,1,8
1964481,1499805,2025-02-26,House,"House - Committee of the Whole (DP)",0,0,0,0,0
1964481,1506638,2025-03-05,House,"House - Third Reading",32,26,2,0,60
1964481,1521462,2025-03-19,Senate,"Senate Judiciary and Elections Committee Action (DP)",4,3,0,0,7
1964481,1524733,2025-03-24,Senate,"Senate Rules Committee Action (PFC)",0,0,0,0,0
1964481,1566556,2025-05-06,Senate,"Senate - Third Reading",17,11,2,0,30
1964505,1489476,2025-02-13,House,"House Health & Human Services Committee Action (DP)",12,0,0,0,12
1964505,1498035,2025-02-24,House,"House Rules Committee Action (C&P)",7,0,0,1,8
1964505,1499341,2025-02-25,House,"House - Committee of the Whole (DP)",0,0,0,0,0
1964505,1500908,2025-02-26,House,"House - Third Reading",56,1,3,0,60
1964505,1516187,2025-03-12,Senate,"Senate Health and Human Services Committee Action (DP)",6,0,1,0,7
1964505,1518574,2025-03-17,Senate,"Senate Rules Committee Action (PFC)",0,0,0,0,0
1964505,1565961,2025-05-06,Senate,"Senate - Third Reading",24,4,2,0,30
1964522,1492516,2025-02-18,House,"House - Third Reading",0,0,0,0,0
1964538,1495750,2025-02-20,House,"House Government Committee Action (DP)",5,2,0,0,7
1964538,1497329,2025-02-24,House,"House Rules Committee Action (C&P)",7,0,0,1,8
1964538,1499989,2025-02-26,House,"House - Committee of the Whole (RET ON CAL)",0,0,0,0,0
1964538,1503481,2025-03-03,House,"House - Committee of the Whole (RET ON CAL)",0,0,0,0,0
1964538,1506153,2025-03-05,House,"House - Committee of the Whole (DPA)",0,0,0,0,0
1964538,1509508,2025-03-10,House,"House - Third Reading",50,6,4,0,60
1964538,1527633,2025-03-26,Senate,"Senate Regulatory Affairs and Government Efficiency Committee Action (DP)",7,0,0,0,7
1964538,1531149,2025-03-31,Senate,"Senate Rules Committee Action (PFC)",0,0,0,0,0
1964538,1567387,2025-05-07,Senate,"Senate - Committee of the Whole (DPA)",0,0,0,0,0
1964538,1567388,2025-05-07,Senate,"Senate - Third Reading",21,6,3,0,30
1964554,1495408,2025-02-20,House,"House Public Safety & Law Enforcement Committee Action (DP)",9,0,3,3,15
1964562,1492890,2025-02-18,House,"House Natural Resources, Energy & Water Committee Action (DPA)",6,4,0,0,10
1964562,1497422,2025-02-24,House,"House Rules Committee Action (C&P)",7,0,0,1,8
1964562,1499117,2025-02-25,House,"House - Committee of the Whole (DPA)",0,0,0,0,0
1964562,1500384,2025-02-26,House,"House - Third Reading",33,26,1,0,60
1964562,1520277,2025-03-18,Senate,"Senate Natural Resources Committee Action (DP)",5,3,0,0,8
1964562,1524735,2025-03-24,Senate,"Senate Rules Committee Action (PFC)",0,0,0,0,0
1964562,1551394,2025-04-17,Senate,"Senate - Committee of the Whole (DPA)",0,0,0,0,0
1964562,1562131,2025-04-30,Senate,"Senate - Third Reading",16,12,2,0,30
1964562,1565526,2025-05-06,House,"House - Concurrence",0,0,0,0,0
1964562,1566278,2025-05-06,House,"House - Third Reading",32,23,5,0,60
1964579,1497818,2025-02-24,House,"House Appropriations Committee Action (HELD)",0,0,0,0,0
1964587,1491238,2025-02-17,House,"House Public Safety & Law Enforcement Committee Action (W/D)",0,0,0,0,0
1964587,1493889,2025-02-19,House,"House Science & Technology Committee Action (DP)",5,4,0,0,9
1964587,1497265,2025-02-24,House,"House Rules Committee Action (C&P)",7,0,0,1,8
1964611,1495615,2025-02-20,House,"House Public Safety & Law Enforcement Committee Action (DPA/SE)",8,0,5,2,15
1964611,1497429,2025-02-24,House,"House Rules Committee Action (C&P)",7,0,0,1,8
1964611,1500922,2025-02-26,House,"House - Committee of the Whole (DPA)",0,0,0,0,0
1964611,1505451,2025-03-04,House,"House - Third Reading",48,9,3,0,60
1964611,1519158,2025-03-17,Senate,"Senate Military Affairs and Border Security Committee Action (DP)",6,0,1,0,7
1964611,1526843,2025-03-25,Senate,"Senate Appropriations Committee Action (DP)",8,0,2,0,10
1964620,1492174,2025-02-18,House,"House Public Safety & Law Enforcement Committee Action (W/D)",0,0,0,0,0
1964628,1495457,2025-02-20,House,"House Government Committee Action (DP)",4,1,2,0,7
1964628,1497267,2025-02-24,House,"House Rules Committee Action (C&P)",7,0,0,1,8
1964628,1499947,2025-02-26,House,"House - Committee of the Whole (RET ON CAL)",0,0,0,0,0
1964628,1509188,2025-03-10,House,"House - Committee of the Whole (RET ON CAL)",0,0,0,0,0
1964628,1514265,2025-03-11,House,"House - Committee of the Whole (DPA)",0,0,0,0,0
1964628,1516234,2025-03-12,House,"House - Third Reading",36,20,4,0,60
1964628,1527640,2025-03-26,Senate,"Senate Government Committee Action (DPA)",4,3,0,0,7
1964628,1531019,2025-03-31,Senate,"Senate Rules Committee Action (PFC)",0,0,0,0,0
1964628,1543860,2025-04-10,Senate,"Senate - Committee of the Whole (DPA)",0,0,0,0,0
1964628,1549706,2025-04-16,Senate,"Senate - Third Reading",17,13,0,0,30
1964628,1567402,2025-05-07,House,"House - Concurrence",0,0,0,0,0
1964628,1567403,2025-05-07,House,"House - Third Reading",39,18,3,0,60
1971849,1491260,2025-02-17,House,"Motion Without objection, notwithstanding House Rule 8(C) or any other House Rule, HR2006 has permission to be introduced, First and Second Readings of HR2006 will be waived and the measure will be placed on Third Reading of Bills today.",0,0,0,0,0
1971849,1491261,2025-02-17,House,"House - Third Reading",0,0,0,0,0
2009594,1566982,2025-05-06,Senate,"Senate - Third Reading",0,0,0,0,0
2021238,1548425,2025-04-15,House,"House Appropriations Committee Action (DPA)",11,10,0,0,21
2021238,1551494,2025-04-16,House,"House Rules Committee Action (C&P)",5,3,0,0,8
2021238,1555844,2025-04-23,House,"House - Committee of the Whole (DPA)",0,0,0,0,0
2021238,1555845,2025-04-23,House,"House - Third Reading",48,11,1,0,60
2021238,1556627,2025-04-24,Senate,"Motion HB 2945 substituted for SB 1734. Motion carried.",0,0,0,0,0
2021238,1556628,2025-04-24,Senate,"Senate - Third Reading",28,1,1,0,30
2025880,1556261,2025-04-23,House,"House - Third Reading",0,0,0,0,0
