bill_id,roll_call_id,date,chamber,description,yea,nay,nv,absent,total
1907252,1471201,2025-01-08,Senate,"Senate: Consideration of Resolutions Resolution",32,0,0,0,32
1907273,1492531,2025-02-18,Senate,"Senate State, Veterans, & Military Affairs: Adopt amendment L.005 (Attachment E).",5,0,0,0,5
1907273,1515951,2025-02-18,Senate,"Senate State, Veterans, & Military Affairs: Adopt amendment L.006 (Attachment F).",5,0,0,0,5
1907273,1515952,2025-02-18,Senate,"Senate State, Veterans, & Military Affairs: Adopt amendment L.007 (Attachment G).",5,0,0,0,5
1907273,1515953,2025-02-18,Senate,"Senate State, Veterans, & Military Affairs: Adopt amendment L.008 (Attachment H).",5,0,0,0,5
1907273,1515954,2025-02-18,Senate,"Senate State, Veterans, & Military Affairs: Adopt amendment L.009 (Attachment I).",5,0,0,0,5
1907273,1515955,2025-02-18,Senate,"Senate State, Veterans, & Military Affairs: Adopt amendment L.010 (Attachment J)",5,0,0,0,5
1907273,1515956,2025-02-18,Senate,"Senate State, Veterans, & Military Affairs: Adopt amendment L.011 (Attachment K).",5,0,0,0,5
1907273,1515957,2025-02-18,Senate,"Senate State, Veterans, & Military Affairs: Adopt amendment L.012 (Attachment L).",5,0,0,0,5
1907273,1515958,2025-02-18,Senate,"Senate State, Veterans, & Military Affairs: Adopt amendment L.013 (Attachment M).",5,0,0,0,5
1907273,1515959,2025-02-18,Senate,"Senate State, Veterans, & Military Affairs: Refer Senate Bill 25-001, as amended, to the Committee on Appropriations.",3,2,0,0,5
1907273,1527589,2025-03-26,Senate,"Senate Appropriations: Adopt amendment J.001",7,0,0,0,7
1907273,1530210,2025-03-28,Senate,"Senate: Committee of the Whole Cow * (s.001)",20,14,0,1,35
1907273,1531117,2025-03-31,Senate,"Senate: Third Reading Bill",22,12,0,1,35
1907273,1531118,2025-03-31,Senate,"Senate: Third Reading Bill",22,12,0,1,35
1907273,1532124,2025-03-26,Senate,"Senate Appropriations: Adopt amendment L.015",7,0,0,0,7
1907273,1532125,2025-03-26,Senate,"Senate Appropriations: Refer Senate Bill 25-001, as amended, to the Committee of the Whole.",4,3,0,0,7
1907273,1547548,2025-04-14,House,"House State, Civic, Military, & Veterans Affairs: Adopt amendment L.052 (Attachment G).",9,2,0,0,11
1907273,1551204,2025-04-14,House,"House State, Civic, Military, & Veterans Affairs: Adopt amendment L.046 (Attachment H).",8,3,0,0,11
1907273,1551205,2025-04-14,House,"House State, Civic, Military, & Veterans Affairs: Adopt amendment L.047 (Attachment I).",11,0,0,0,11
1907273,1551206,2025-04-14,House,"House State, Civic, Military, & Veterans Affairs: Adopt amendment L.048 (Attachment J).",11,0,0,0,11
1907273,1551207,2025-04-14,House,"House State, Civic, Military, & Veterans Affairs: Adopt amendment L.049 (Attachment K).",11,0,0,0,11
1907273,1551208,2025-04-14,House,"House State, Civic, Military, & Veterans Affairs: Refer Senate Bill 25-001, as amended, to the Committee on Appropriations.",8,3,0,0,11
1907273,1553448,2025-04-22,House,"House Appropriations: Refer Senate Bill 25-001 to the Committee of the Whole.",7,4,0,0,11
1907273,1558400,2025-04-25,House,"House: Committee of the Whole Amd (h.001)",21,39,0,5,65
1907273,1558401,2025-04-25,House,"House: Committee of the Whole Amd (h.002)",20,40,0,5,65
1907273,1558402,2025-04-25,House,"House: Committee of the Whole Amd (h.003)",21,39,0,5,65
1907273,1558403,2025-04-25,House,"House: Committee of the Whole Amd (h.004)",20,40,0,5,65
1907273,1558404,2025-04-25,House,"House: Committee of the Whole Amd (h.007)",21,39,0,5,65
1907273,1558405,2025-04-25,House,"House: Committee of the Whole Amd (h.008)",22,38,0,5,65
1907273,1558406,2025-04-25,House,"House: Committee of the Whole Amd (h.009)",22,38,0,5,65
1907273,1559064,2025-04-28,House,"House: Third Reading Amd (l.077)",23,39,0,3,65
1907273,1559065,2025-04-28,House,"House: Third Reading Bill",43,22,0,0,65
1907273,1559066,2025-04-28,House,"House: Third Reading Perm",59,3,0,3,65
1907273,1560521,2025-04-29,Senate,"Senate: House Amendments Concur",20,12,0,3,35
1907273,1560522,2025-04-29,Senate,"Senate: House Amendments Repass",20,12,0,3,35
1907293,1493302,2025-02-19,Senate,"Senate Agriculture & Natural Resources: Adopt amendment L.001 (Attachment A).",7,0,0,0,7
1907293,1504865,2025-02-19,Senate,"Senate Agriculture & Natural Resources: Adopt amendment L.004 (Attachment B).",7,0,0,0,7
1907293,1504866,2025-02-19,Senate,"Senate Agriculture & Natural Resources: Refer Senate Bill 25-007, as amended, to the Committee on Appropriations.",5,2,0,0,7
1907293,1559815,2025-04-29,Senate,"Senate Appropriations: Adopt amendment L.009",7,0,0,0,7
1907293,1559816,2025-04-29,Senate,"Senate Appropriations: Refer Senate Bill 25-007, as amended, to the Committee of the Whole.",4,3,0,0,7
1907293,1561768,2025-04-30,Senate,"Senate: Third Reading Bill",26,9,0,0,35
1907293,1563920,2025-05-01,House,"House Energy & Environment: Refer Senate Bill 25-007 to the Committee on Appropriations.",10,3,0,0,13
1907293,1564842,2025-05-05,House,"House Appropriations: Adopt amendment J.003",11,0,0,0,11
1907293,1564843,2025-05-05,House,"House Appropriations: Adopt amendment L.010",11,0,0,0,11
1907293,1564844,2025-05-05,House,"House Appropriations: Refer Senate Bill 25-007, as amended, to the Committee of the Whole.",6,4,0,1,11
1907293,1567628,2025-05-07,House,"House: Third Reading Bill",44,21,0,0,65
1907293,1567629,2025-05-07,Senate,"Senate: House Amendments Concur",35,0,0,0,35
1907293,1567630,2025-05-07,Senate,"Senate: House Amendments Repass",24,11,0,0,35
1907315,1487321,2025-02-12,Senate,"Senate Health & Human Services: Adopt amendment L.001 (Attachment B).",9,0,0,0,9
1907315,1502484,2025-02-12,Senate,"Senate Health & Human Services: Refer Senate Bill 25-008, as amended, to the Committee on Appropriations.",6,3,0,0,9
1907315,1548036,2025-04-15,Senate,"Senate Appropriations: Refer Senate Bill 25-008 to the Committee of the Whole.",4,3,0,0,7
1907315,1552493,2025-04-21,Senate,"Senate: Third Reading Bill",23,12,0,0,35
1907315,1553970,2025-04-22,House,"House Transportation, Housing & Local Government: Adopt amendment L.004 (Attachment G)",13,0,0,0,13
1907315,1555493,2025-04-22,House,"House Transportation, Housing & Local Government: Refer Senate Bill 25-008, as amended, to the Committee on Appropriations.",9,4,0,0,13
1907315,1560148,2025-04-29,House,"House Appropriations: Refer Senate Bill 25-008 to the Committee of the Whole.",8,3,0,0,11
1907315,1562305,2025-04-30,House,"House: Third Reading Bill",43,22,0,0,65
1907315,1564342,2025-05-01,Senate,"Senate: House Amendments Concur",32,0,0,3,35
1907315,1564343,2025-05-01,Senate,"Senate: House Amendments Repass",21,11,0,3,35
1907338,1477488,2025-01-30,Senate,"Senate Local Government & Housing: Adopt amendment L.002",4,1,0,2,7
1907338,1478085,2025-01-30,Senate,"Senate Local Government & Housing: Adopt amendment L.003",7,0,0,0,7
1907338,1478086,2025-01-30,Senate,"Senate Local Government & Housing: Refer Senate Bill 25-006, as amended, to the Committee of the Whole.",4,2,0,1,7
1907338,1480652,2025-02-05,Senate,"Senate: Third Reading Bill",25,10,0,0,35
1907338,1480653,2025-02-05,Senate,"Senate: Third Reading Reconsideration",24,11,0,0,35
1907338,1504687,2025-03-04,House,"House Transportation, Housing & Local Government: Refer Senate Bill 25-006 to the Committee on Finance.",9,3,0,1,13
1907338,1525267,2025-03-24,House,"House Finance: Adopt amendment L.005 (Attachment C).",13,0,0,0,13
1907338,1543937,2025-03-24,House,"House Finance: Refer Senate Bill 25-006, as amended, to the Committee of the Whole.",7,6,0,0,13
1907338,1545911,2025-04-11,House,"House: Third Reading Bill",42,20,0,3,65
1907338,1549764,2025-04-16,Senate,"Senate: House Amendments Concur",31,1,0,3,35
1907338,1549765,2025-04-16,Senate,"Senate: House Amendments Repass",21,11,0,3,35
1907362,1471199,2025-01-08,House,"House: RESOLUTIONS Res",63,0,0,1,64
1907362,1471200,2025-01-08,Senate,"Senate: Consideration of Resolutions Resolution",32,0,0,0,32
1907387,1476064,2025-01-28,Senate,"Senate State, Veterans, & Military Affairs: Adopt amendment L.001 (Attachment F).",3,2,0,0,5
1907387,1489914,2025-02-14,Senate,"Senate: Committee of the Whole Cow * (s.002)",11,22,0,2,35
1907387,1489915,2025-02-14,Senate,"Senate: Committee of the Whole Cow * (s.003)",12,21,0,2,35
1907387,1489916,2025-02-14,Senate,"Senate: Committee of the Whole Cow * (s.006)",18,15,0,2,35
1907387,1491893,2025-02-18,Senate,"Senate: Third Reading Amend (l.042)",32,2,0,0,34
1907387,1491894,2025-02-18,Senate,"Senate: Third Reading Bill",19,15,0,0,34
1907387,1515574,2025-03-11,House,"House Judiciary: Refer Senate Bill 25-003, as amended, to the Committee on Finance.",7,4,0,0,11
1907387,1515899,2025-01-28,Senate,"Senate State, Veterans, & Military Affairs: Adopt amendment L.002 (Attachment G).",3,2,0,0,5
1907387,1515900,2025-01-28,Senate,"Senate State, Veterans, & Military Affairs: Adopt amendment L.003 (Attachment H).",3,2,0,0,5
1907387,1515901,2025-01-28,Senate,"Senate State, Veterans, & Military Affairs: Adopt amendment L.004 (Attachment I).",3,2,0,0,5
1907387,1515902,2025-01-28,Senate,"Senate State, Veterans, & Military Affairs: Adopt amendment L.005 (Attachment J).",3,2,0,0,5
1907387,1515903,2025-01-28,Senate,"Senate State, Veterans, & Military Affairs: Refer Senate Bill 25-003, as amended, to the Committee of the Whole.",3,2,0,0,5
1907387,1515904,2025-01-28,Senate,"Senate State, Veterans, & Military Affairs: Refer Senate Bill 25-003, as amended, to the Committee on Appropriations.",2,3,0,0,5
1907387,1518083,2025-03-14,House,"House Finance: Adopt amendment L.055 (Attachment D).",8,5,0,0,13
1907387,1519527,2025-03-18,House,"House Appropriations: Adopt amendment J.002",7,4,0,0,11
1907387,1519528,2025-03-18,House,"House Appropriations: Adopt amendment L.056",7,4,0,0,11
1907387,1519529,2025-03-18,House,"House Appropriations: Adopt amendment L.058",4,7,0,0,11
1907387,1519530,2025-03-18,House,"House Appropriations: Adopt amendment L.059",4,7,0,0,11
1907387,1519531,2025-03-18,House,"House Appropriations: Adopt amendment L.060",4,7,0,0,11
1907387,1519532,2025-03-18,House,"House Appropriations: Refer Senate Bill 25-003, as amended, to the Committee of the Whole.",7,4,0,0,11
1907387,1521539,2025-03-14,House,"House Finance: Adopt amendment L.057 (Attachment H).",5,8,0,0,13
1907387,1521540,2025-03-14,House,"House Finance: Refer Senate Bill 25-003, as amended, to the Committee on Appropriations.",7,6,0,0,13
1907387,1524231,2025-03-21,House,"House: Committee of the Whole Amd (h.003)",22,42,0,1,65
1907387,1524232,2025-03-21,House,"House: Committee of the Whole Amd (h.006)",23,41,0,1,65
1907387,1524280,2025-03-21,House,"House: Committee of the Whole Amd (h.001)",24,41,0,0,65
1907387,1524281,2025-03-21,House,"House: Committee of the Whole Amd (h.002)",26,39,0,0,65
1907387,1524282,2025-03-21,House,"House: Committee of the Whole Amd (h.004)",22,43,0,0,65
1907387,1524283,2025-03-21,House,"House: Committee of the Whole Amd (h.005)",23,42,0,0,65
1907387,1524284,2025-03-21,House,"House: Committee of the Whole Amd (h.007)",25,40,0,0,65
1907387,1524285,2025-03-21,House,"House: Committee of the Whole Amd (h.008)",28,37,0,0,65
1907387,1524286,2025-03-21,House,"House: Committee of the Whole Amd (h.009)",24,41,0,0,65
1907387,1524287,2025-03-21,House,"House: Committee of the Whole Amd (h.010)",24,41,0,0,65
1907387,1524288,2025-03-21,House,"House: Committee of the Whole Amd (h.011)",23,41,0,1,65
1907387,1524289,2025-03-21,House,"House: Committee of the Whole Amd (h.012)",22,43,0,0,65
1907387,1524290,2025-03-21,House,"House: Committee of the Whole Amd (h.013)",26,39,0,0,65
1907387,1524291,2025-03-21,House,"House: Committee of the Whole Amd (h.014)",28,36,0,1,65
1907387,1525103,2025-03-24,House,"House: Third Reading Bill",36,28,0,1,65
1907387,1525104,2025-03-24,House,"House: Third Reading Refer (joint)",23,41,0,1,65
1907387,1525105,2025-03-24,House,"House: Third Reading Rerefer (2nd)",23,40,0,2,65
1907387,1525106,2025-03-24,House,"House: Third Reading Rerefer (app)",25,38,0,2,65
1907387,1530410,2025-03-28,Senate,"Senate: House Amendments Concur",20,14,0,1,35
1907387,1530411,2025-03-28,Senate,"Senate: House Amendments Repass",19,15,0,1,35
1907407,1472777,2025-01-21,Senate,"Senate Business, Labor, & Technology: Refer Senate Bill 25-005 to the Committee on Appropriations.",4,3,0,0,7
1907407,1479441,2025-02-04,Senate,"Senate Appropriations: Adopt amendment J.001",7,0,0,0,7
1907407,1479442,2025-02-04,Senate,"Senate Appropriations: Refer Senate Bill 25-005, as amended, to the Committee of the Whole.",4,1,0,2,7
1907407,1489171,2025-02-13,Senate,"Senate: Committee of the Whole Cow * (s.001)",12,21,0,2,35
1907407,1489700,2025-02-13,Senate,"Senate: Committee of the Whole Adopt Report",22,12,0,1,35
1907407,1489701,2025-02-13,Senate,"Senate: Committee of the Whole Cow * (s.002)",12,22,0,1,35
1907407,1489702,2025-02-13,Senate,"Senate: Committee of the Whole Cow * (s.002)",13,21,0,1,35
1907407,1489703,2025-02-13,Senate,"Senate: Committee of the Whole Cow * (s.003)",12,22,0,1,35
1907407,1489704,2025-02-13,Senate,"Senate: Committee of the Whole Cow * (s.004)",12,22,0,1,35
1907407,1489705,2025-02-13,Senate,"Senate: Committee of the Whole Cow * (s.005)",12,22,0,1,35
1907407,1489706,2025-02-13,Senate,"Senate: Committee of the Whole Cow * (s.009)",13,21,0,1,35
1907407,1489707,2025-02-13,Senate,"Senate: Committee of the Whole Cow * (s.009)",12,22,0,1,35
1907407,1491798,2025-02-18,Senate,"Senate: Third Reading Bill",22,12,0,0,34
1907407,1517792,2025-03-13,House,"House Business Affairs & Labor: Adopt amendment L.014",0,0,13,0,13
1907407,1521868,2025-03-13,House,"House Business Affairs & Labor: Refer Senate Bill 25-005 to the Committee on Appropriations.",7,5,0,1,13
1907407,1537022,2025-04-04,House,"House Appropriations: Refer Senate Bill 25-005 to the Committee of the Whole.",7,4,0,0,11
1907407,1565785,2025-05-06,House,"House: Third Reading Bill",43,22,0,0,65
1907428,1487045,2025-02-11,Senate,"Senate Business, Labor, & Technology: Adopt amendment L.001",7,0,0,0,7
1907428,1494573,2025-02-20,Senate,"Senate: Third Reading Bill",19,12,2,1,34
1907428,1495896,2025-02-20,Senate,"Senate: Third Reading Bill",21,12,0,1,34
1907428,1496641,2025-02-11,Senate,"Senate Business, Labor, & Technology: Adopt amendment L.002",7,0,0,0,7
1907428,1496642,2025-02-11,Senate,"Senate Business, Labor, & Technology: Refer Senate Bill 25-004, as amended, to the Committee of the Whole.",4,3,0,0,7
1907428,1513794,2025-03-11,House,"House Health & Human Services: Refer Senate Bill 25-004 to the Committee of the Whole.",9,4,0,0,13
1907428,1517036,2025-03-13,House,"House: Third Reading Bill",38,22,0,5,65
1907428,1518522,2025-03-17,Senate,"Senate: House Amendments Concur",34,0,0,0,34
1907428,1518523,2025-03-17,Senate,"Senate: House Amendments Repass",23,11,0,0,34
1907428,1519357,2025-03-18,Senate,"Senate: House Amendments Repass",21,12,0,1,34
1907452,1483415,2025-02-06,Senate,"Senate Local Government & Housing: Adopt amendment L.001",4,2,0,1,7
1907452,1484049,2025-02-06,Senate,"Senate Local Government & Housing: Adopt amendment L.002",7,0,0,0,7
1907452,1484050,2025-02-06,Senate,"Senate Local Government & Housing: Refer Senate Bill 25-002, as amended, to the Committee on Appropriations.",4,2,0,1,7
1907452,1527234,2025-03-26,Senate,"Senate Appropriations: Adopt amendment J.001",7,0,0,0,7
1907452,1531128,2025-03-31,Senate,"Senate: Third Reading Bill",23,11,0,1,35
1907452,1532143,2025-03-26,Senate,"Senate Appropriations: Adopt amendment L.003",7,0,0,0,7
1907452,1532144,2025-03-26,Senate,"Senate Appropriations: Adopt amendment L.004",7,0,0,0,7
1907452,1532145,2025-03-26,Senate,"Senate Appropriations: Refer Senate Bill 25-002, as amended, to the Committee of the Whole.",4,3,0,0,7
1907452,1540301,2025-04-08,House,"House Transportation, Housing & Local Government: Adopt amendment L.012 (Attachment D)",13,0,0,0,13
1907452,1543817,2025-04-08,House,"House Transportation, Housing & Local Government: Refer Senate Bill 25-002, as amended, to the Committee on Appropriations.",10,3,0,0,13
1907452,1551135,2025-04-17,House,"House Appropriations: Adopt amendment J.002",11,0,0,0,11
1907452,1552500,2025-04-21,House,"House: Third Reading Amd (l.017)",40,23,0,2,65
1907452,1552501,2025-04-21,House,"House: Third Reading Bill",40,23,0,2,65
1907452,1552502,2025-04-21,House,"House: Third Reading Perm",43,20,0,2,65
1907452,1553451,2025-04-17,House,"House Appropriations: Refer Senate Bill 25-002, as amended, to the Committee of the Whole.",7,4,0,0,11
1907452,1554139,2025-04-22,Senate,"Senate: House Amendments Concur",35,0,0,0,35
1907452,1554140,2025-04-22,Senate,"Senate: House Amendments Repass",26,9,0,0,35
1907452,1555157,2025-04-23,Senate,"Senate: House Amendments Repass",24,11,0,0,35
1907474,1518664,2025-03-17,Senate,"Senate Judiciary: Adopt amendment L.001 (Attachment C)",7,0,0,0,7
1907474,1525876,2025-03-25,Senate,"Senate: Third Reading Bill",35,0,0,0,35
1907474,1533238,2025-04-01,House,"House Judiciary: Refer Senate Bill 25-009 to the Committee of the Whole.",10,0,0,1,11
1907474,1547409,2025-03-17,Senate,"Senate Judiciary: Adopt amendment L.002 (Attachment D)",7,0,0,0,7
1907474,1547410,2025-03-17,Senate,"Senate Judiciary: Adopt amendment L.003 (Attachment E)",7,0,0,0,7
1907474,1547411,2025-03-17,Senate,"Senate Judiciary: Refer Senate Bill 25-009, as amended, to the Committee of the Whole and with a recommendation that it be placed on the consent calendar.",7,0,0,0,7
1907474,1547412,2025-04-14,House,"House: Third Reading Bill",64,0,0,1,65
1907495,1471198,2025-01-08,House,"House: RESOLUTIONS Res",63,0,0,1,64
1907514,1476241,2025-01-29,Senate,"Senate Health & Human Services: Refer Senate Bill 25-010 to the Committee of the Whole.",9,0,0,0,9
1907514,1480789,2025-02-05,Senate,"Senate: Third Reading Amend (l.003)",35,0,0,0,35
1907514,1480790,2025-02-05,Senate,"Senate: Third Reading Bill",35,0,0,0,35
1907514,1487880,2025-02-12,House,"House Health & Human Services: Refer Senate Bill 25-010 to the Committee of the Whole.",13,0,0,0,13
1907514,1492018,2025-02-18,House,"House: Third Reading Bill",64,0,0,1,65
1907534,1471197,2025-01-08,House,"House: RESOLUTIONS Res",63,0,0,1,64
1907534,1471224,2025-01-09,Senate,"Senate: Consideration of Resolutions Resolution",31,0,0,1,32
1907547,1486917,2025-02-11,House,"House Transportation, Housing & Local Government: Adopt amendment L.001",13,0,0,0,13
1907547,1493952,2025-02-11,House,"House Transportation, Housing & Local Government: Refer House Bill 25-1043, as amended, to the Committee of the Whole.",9,4,0,0,13
1907547,1501332,2025-02-27,House,"House: Third Reading Bill",38,24,0,3,65
1907547,1517464,2025-03-13,Senate,"Senate Local Government & Housing: Adopt amendment L.012",7,0,0,0,7
1907547,1518975,2025-03-13,Senate,"Senate Local Government & Housing: Adopt amendment L.014",7,0,0,0,7
1907547,1518976,2025-03-13,Senate,"Senate Local Government & Housing: Refer House Bill 25-1043, as amended, to the Committee of the Whole.",4,3,0,0,7
1907547,1520975,2025-03-19,Senate,"Senate: Third Reading Bill",23,11,0,0,34
1907547,1530282,2025-03-28,House,"House: Senate Amendments Not Cncr",46,17,0,2,65
1907547,1541386,2025-04-09,Senate,"Senate: Conference Committee Report Adopt Ccr",34,0,0,1,35
1907547,1541387,2025-04-09,Senate,"Senate: Conference Committee Report Repass",23,11,0,1,35
1907547,1542220,2025-04-08,Joint,"CC_HB25-1043_2025A: Adopt conference committee report CLHB1043.001",6,0,0,0,6
1907547,1549466,2025-04-15,House,"House: Conference Committee Report Adopt",42,22,0,1,65
1907547,1549467,2025-04-15,House,"House: Conference Committee Report Repass",41,23,0,1,65
1907549,1482606,2025-02-05,Senate,"Senate Education: Adopt amendment L.002",7,0,0,0,7
1907549,1488947,2025-02-05,Senate,"Senate Education: Adopt amendment L.001",7,0,0,0,7
1907549,1488948,2025-02-05,Senate,"Senate Education: Adopt amendment L.003",4,3,0,0,7
1907549,1488949,2025-02-05,Senate,"Senate Education: Refer Senate Bill 25-027, as amended, to the Committee on Appropriations.",4,3,0,0,7
1907549,1545330,2025-04-11,Senate,"Senate Appropriations: Adopt amendment L.005",7,0,0,0,7
1907549,1545687,2025-04-11,Senate,"Senate Appropriations: Adopt amendment J.002",7,0,0,0,7
1907549,1545688,2025-04-11,Senate,"Senate Appropriations: Refer Senate Bill 25-027, as amended, to the Committee of the Whole.",6,1,0,0,7
1907549,1551016,2025-04-17,Senate,"Senate: Third Reading Bill",23,12,0,0,35
1907549,1551017,2025-04-17,Senate,"Senate: Third Reading Bill",22,13,0,0,35
1907549,1556983,2025-04-24,House,"House Education: Refer Senate Bill 25-027, as amended, to the Committee on Finance.",8,5,0,0,13
1907549,1560819,2025-04-29,House,"House Finance: Refer Senate Bill 25-027 to the Committee on Appropriations.",9,4,0,0,13
1907549,1564765,2025-05-03,House,"House Appropriations: Adopt amendment J.003",11,0,0,0,11
1907549,1564766,2025-05-03,House,"House Appropriations: Adopt amendment L.010",11,0,0,0,11
1907549,1564767,2025-05-03,House,"House Appropriations: Refer Senate Bill 25-027, as amended, to the Committee of the Whole.",8,3,0,0,11
1907549,1565128,2025-05-05,House,"House: Third Reading Bill",43,21,0,1,65
1907549,1566593,2025-04-24,House,"House Education: Adopt amendment L.008",13,0,0,0,13
1907549,1566594,2025-04-24,House,"House Education: Refer Senate Bill 25-027, as amended, to the Committee on Finance.",8,5,0,0,13
1907549,1566595,2025-05-06,Senate,"Senate: House Amendments Concur",35,0,0,0,35
1907549,1566596,2025-05-06,Senate,"Senate: House Amendments Repass",23,12,0,0,35
1907553,1479031,2025-02-03,House,"House Finance: Adopt amendment L.001",13,0,0,0,13
1907553,1484918,2025-02-03,House,"House Finance: Adopt amendment L.002",13,0,0,0,13
1907553,1484919,2025-02-03,House,"House Finance: Adopt amendment L.003",13,0,0,0,13
1907553,1484920,2025-02-03,House,"House Finance: Refer House Bill 25-1036, as amended, to the Committee on Appropriations.",12,1,0,0,13
1907555,1498980,2025-02-25,Senate,"Senate Business, Labor, & Technology: Adopt amendment L.004",7,0,0,0,7
1907555,1504287,2025-02-25,Senate,"Senate Business, Labor, & Technology: Adopt amendment L.005",7,0,0,0,7
1907555,1504288,2025-02-25,Senate,"Senate Business, Labor, & Technology: Refer Senate Bill 25-031, as amended, to the Committee on Appropriations.",5,1,0,1,7
1907555,1517935,2025-03-14,Senate,"Senate Appropriations: Refer Senate Bill 25-031 to the Committee of the Whole.",7,0,0,0,7
1907555,1520844,2025-03-19,Senate,"Senate: Third Reading Bill",31,3,0,0,34
1907555,1534520,2025-04-02,House,"House Business Affairs & Labor: Adopt amendment L.010",13,0,0,0,13
1907555,1544078,2025-04-02,House,"House Business Affairs & Labor: Refer Senate Bill 25-031, as amended, to the Committee of the Whole.",7,6,0,0,13
1907555,1547365,2025-04-14,House,"House: Third Reading Bill",47,17,0,1,65
1907555,1549789,2025-04-16,Senate,"Senate: House Amendments Concur",32,0,0,3,35
1907555,1549790,2025-04-16,Senate,"Senate: House Amendments Repass",29,3,0,3,35
1907558,1474911,2025-01-27,House,"House State, Civic, Military, & Veterans Affairs: Adopt amendment L.004 (Attachment F).",11,0,0,0,11
1907558,1480501,2025-01-27,House,"House State, Civic, Military, & Veterans Affairs: Refer House Bill 25-1069, as amended, to the Committee on Appropriations.",11,0,0,0,11
1907558,1517918,2025-03-14,House,"House Appropriations: Refer House Bill 25-1069 to the Committee of the Whole.",11,0,0,0,11
1907558,1547353,2025-04-14,House,"House: Third Reading Bill",63,1,0,1,65
1907558,1554149,2025-04-22,Senate,"Senate State, Veterans, & Military Affairs: Refer House Bill 25-1069 to the Committee of the Whole.",3,2,0,0,5
1907558,1558176,2025-04-25,Senate,"Senate: Committee of the Whole Cow * (s.001)",18,17,0,0,35
1907558,1558177,2025-04-25,Senate,"Senate: Committee of the Whole Cow * (s.001)",17,18,0,0,35
1907561,1473233,2025-01-21,House,"House Judiciary: Adopt amendment L.001 (Attachment A)",11,0,0,0,11
1907561,1474692,2025-01-27,House,"House: Third Reading Bill",56,6,0,3,65
1907561,1485464,2025-02-10,Senate,"Senate Judiciary: Refer House Bill 25-1058 to the Committee of the Whole.",5,2,0,0,7
1907561,1492203,2025-02-18,Senate,"Senate: Third Reading Bill",23,11,0,0,34
1907561,1516133,2025-01-21,House,"House Judiciary: Refer House Bill 25-1058, as amended, to the Committee of the Whole.",8,2,0,1,11
1907566,1477482,2025-01-30,Senate,"Senate Agriculture & Natural Resources: Refer Senate Bill 25-039 to the Committee of the Whole.",6,0,0,1,7
1907566,1487347,2025-02-12,Senate,"Senate: Third Reading Bill",33,0,0,2,35
1907566,1503762,2025-03-03,House,"House Agriculture, Water & Natural Resources: Adopt amendment L.004 (Attachment F)",13,0,0,0,13
1907566,1512736,2025-03-11,House,"House: Third Reading Bill",59,0,0,6,65
1907566,1521453,2025-03-03,House,"House Agriculture, Water & Natural Resources: Refer Senate Bill 25-039, as amended, to the Committee of the Whole.",12,0,0,1,13
1907569,1488980,2025-02-13,House,"House Education: Adopt amendment L.001",13,0,0,0,13
1907569,1493204,2025-02-19,House,"House: Third Reading Bill",60,3,0,2,65
1907569,1496532,2025-02-13,House,"House Education: Refer House Bill 25-1059, as amended, to the Committee of the Whole.",12,0,0,1,13
1907569,1516147,2025-03-12,Senate,"Senate Education: Adopt amendment L.002",7,0,0,0,7
1907569,1518453,2025-03-12,Senate,"Senate Education: Refer House Bill 25-1059, as amended, to the Committee of the Whole and with a recommendation that it be placed on the consent calendar.",6,0,0,1,7
1907569,1519348,2025-03-18,Senate,"Senate: Third Reading Bill",32,1,0,1,34
1907569,1530226,2025-03-28,House,"House: Senate Amendments Concur",53,10,0,2,65
1907569,1530227,2025-03-28,House,"House: Senate Amendments Repass",58,5,0,2,65
1907574,1478959,2025-02-03,House,"House Agriculture, Water & Natural Resources: Refer House Bill 25-1053 to the Committee of the Whole.",12,0,0,1,13
1907574,1483303,2025-02-06,House,"House: Third Reading Bill",64,0,0,1,65
1907574,1499855,2025-02-26,Senate,"Senate Agriculture & Natural Resources: Refer House Bill 25-1053 to the Committee of the Whole and with a recommendation that it be placed on the consent calendar.",6,0,0,1,7
1907574,1503119,2025-03-03,Senate,"Senate: Third Reading Bill",34,0,0,0,34
1907576,1485507,2025-02-10,Senate,"Senate Judiciary: Postpone Senate Bill 25-012 indefinitely.",6,1,0,0,7
1907576,1492255,2025-02-10,Senate,"Senate Judiciary: Postpone Senate Bill 25-012 indefinitely.",7,0,0,0,7
1907576,1492256,2025-02-10,Senate,"Senate Judiciary: Reconsider",7,0,0,0,7
1907581,1475577,2025-01-28,Senate,"Senate Finance: Adopt amendment L.002 (Attachment C)",9,0,0,0,9
1907581,1478093,2025-01-28,Senate,"Senate Finance: Refer Senate Bill 25-016, as amended, to the Committee of the Whole.",7,0,0,2,9
1907581,1483177,2025-02-06,Senate,"Senate: Third Reading Bill",31,0,0,4,35
1907581,1509291,2025-03-10,House,"House Finance: Adopt amendment L.005 (Attachment C).",13,0,0,0,13
1907581,1516965,2025-03-13,House,"House: Third Reading Bill",62,1,0,2,65
1907581,1516966,2025-03-13,House,"House: Third Reading Bill",62,1,0,2,65
1907581,1518467,2025-03-10,House,"House Finance: Refer Senate Bill 25-016, as amended, to the Committee of the Whole.",13,0,0,0,13
1907581,1518468,2025-03-17,Senate,"Senate: House Amendments Concur",34,0,0,0,34
1907581,1518469,2025-03-17,Senate,"Senate: House Amendments Repass",34,0,0,0,34
1907585,1475659,2025-01-28,Senate,"Senate Finance: Refer Senate Bill 25-019 to the Committee of the Whole and with a recommendation that it be placed on the consent calendar.",8,0,0,1,9
1907585,1478684,2025-02-03,Senate,"Senate: Third Reading Bill",35,0,0,0,35
1907585,1495183,2025-02-20,House,"House Finance: Refer Senate Bill 25-019 to the Committee of the Whole.",12,0,0,1,13
1907585,1501439,2025-02-27,House,"House: Third Reading Bill",62,1,0,2,65
1907590,1498002,2025-02-19,Senate,"Senate Transportation & Energy: Adopt amendment L.001",9,0,0,0,9
1907590,1506419,2025-03-05,Senate,"Senate Transportation & Energy: Reconsider amendment L.001",8,0,0,1,9
1907590,1513509,2025-03-11,Senate,"Senate Finance: Refer Senate Bill 25-011 to the Committee on Appropriations.",9,0,0,0,9
1907590,1515835,2025-03-05,Senate,"Senate Transportation & Energy: Adopt amendment L.003",9,0,0,0,9
1907590,1515836,2025-03-05,Senate,"Senate Transportation & Energy: Refer Senate Bill 25-011, as amended, to the Committee on Finance.",8,1,0,0,9
1907590,1553505,2025-04-22,Senate,"Senate Appropriations: Adopt amendment L.005",7,0,0,0,7
1907590,1553506,2025-04-22,Senate,"Senate Appropriations: Adopt amendment L.006",3,4,0,0,7
1907590,1553507,2025-04-22,Senate,"Senate Appropriations: Refer Senate Bill 25-011, as amended, to the Committee of the Whole.",6,1,0,0,7
1907590,1557199,2025-04-24,Senate,"Senate: Committee of the Whole Cow * (s.001)",15,15,0,5,35
1907590,1557200,2025-04-24,Senate,"Senate: Committee of the Whole Cow * (s.001)",14,17,0,4,35
1907590,1558161,2025-04-25,Senate,"Senate: Third Reading Bill",26,9,0,0,35
1907590,1561110,2025-04-29,House,"House Finance: Refer Senate Bill 25-011 to the Committee on Appropriations.",9,4,0,0,13
1907595,1476653,2025-01-29,House,"House Health & Human Services: Adopt amendment L.001 (Attachment C).",13,0,0,0,13
1907595,1484728,2025-02-10,House,"House: Third Reading Bill",54,9,0,2,65
1907595,1497342,2025-01-29,House,"House Health & Human Services: Refer House Bill 25-1002, as amended, to the Committee of the Whole.",13,0,0,0,13
1907595,1499744,2025-02-26,Senate,"Senate: Third Reading Bill",32,1,0,1,34
1907595,1502301,2025-02-20,Senate,"Senate Health & Human Services: Adopt amendment L.018 (Attachment B).",9,0,0,0,9
1907595,1502302,2025-02-20,Senate,"Senate Health & Human Services: Refer House Bill 25-1002, as amended, to the Committee of the Whole and with a recommendation that it be placed on the consent calendar.",9,0,0,0,9
1907595,1502303,2025-02-28,House,"House: Senate Amendments Concur",51,9,0,5,65
1907595,1502304,2025-02-28,House,"House: Senate Amendments Repass",50,10,0,5,65
1907598,1473295,2025-01-22,House,"House Judiciary: Adopt amendment L.001 (Attachment A)",11,0,0,0,11
1907598,1516233,2025-01-22,House,"House Judiciary: Refer House Bill 25-1026, as amended, to the Committee on Appropriations.",8,3,0,0,11
1907598,1537007,2025-04-04,House,"House Appropriations: Adopt amendment J.001",11,0,0,0,11
1907598,1537896,2025-04-04,House,"House Appropriations: Refer House Bill 25-1026, as amended, to the Committee of the Whole.",8,3,0,0,11
1907598,1549230,2025-04-15,House,"House: Committee of the Whole Amd (h.001)",23,41,0,1,65
1907598,1549837,2025-04-16,House,"House: Third Reading Bill",43,22,0,0,65
1907598,1555644,2025-04-23,Senate,"Senate Judiciary: Adopt amendment L.010 (Attachment B)",7,0,0,0,7
1907598,1559831,2025-04-29,Senate,"Senate Appropriations: Refer House Bill 25-1026 to the Committee of the Whole.",4,3,0,0,7
1907598,1561744,2025-04-23,Senate,"Senate Judiciary: Refer House Bill 25-1026, as amended, to the Committee on Appropriations.",5,2,0,0,7
1907598,1561745,2025-04-30,Senate,"Senate: Third Reading Bill",23,12,0,0,35
1907598,1563978,2025-05-01,House,"House: Senate Amendments Concur",43,22,0,0,65
1907598,1563979,2025-05-01,House,"House: Senate Amendments Repass",43,22,0,0,65
1907601,1474892,2025-01-27,House,"House Agriculture, Water & Natural Resources: Refer House Bill 25-1034 to the Committee of the Whole.",13,0,0,0,13
1907601,1478913,2025-02-03,House,"House: Third Reading Bill",56,8,0,1,65
1907601,1487344,2025-02-12,Senate,"Senate Agriculture & Natural Resources: Refer House Bill 25-1034 to the Committee of the Whole and with a recommendation that it be placed on the consent calendar.",6,0,0,1,7
1907601,1493109,2025-02-19,Senate,"Senate: Third Reading Bill",33,1,0,0,34
1907604,1483185,2025-02-06,Senate,"Senate Business, Labor, & Technology: Adopt amendment L.001",7,0,0,0,7
1907604,1483927,2025-02-06,Senate,"Senate Business, Labor, & Technology: Refer Senate Bill 25-033, as amended, to the Committee on Appropriations.",5,2,0,0,7
1907604,1490046,2025-02-14,Senate,"Senate Appropriations: Refer Senate Bill 25-033 to the Committee of the Whole.",6,1,0,0,7
1907604,1495067,2025-02-20,Senate,"Senate: Third Reading Bill",28,5,0,1,34
1907604,1517472,2025-03-13,House,"House Business Affairs & Labor: Refer Senate Bill 25-033 to the Committee on Appropriations.",13,0,0,0,13
1907604,1525987,2025-03-25,House,"House Appropriations: Refer Senate Bill 25-033 to the Committee of the Whole.",8,2,0,1,11
1907604,1532234,2025-04-01,House,"House: Third Reading Bill",55,8,0,2,65
1907612,1554118,2025-04-22,Senate,"Senate Finance: Adopt amendment L.006 (Attachment D)",9,0,0,0,9
1907612,1558004,2025-04-25,Senate,"Senate Appropriations: Adopt amendment J.001",3,4,0,0,7
1907612,1558235,2025-04-22,Senate,"Senate Finance: Refer Senate Bill 25-026, as amended, to the Committee on Appropriations.",9,0,0,0,9
1907612,1558827,2025-04-28,Senate,"Senate: Third Reading Bill",29,5,0,1,35
1907612,1559825,2025-04-25,Senate,"Senate Appropriations: Refer Senate Bill 25-026 to the Committee of the Whole.",6,1,0,0,7
1907612,1561012,2025-04-29,House,"House Finance: Refer Senate Bill 25-026 to the Committee on Appropriations.",9,4,0,0,13
1907612,1563470,2025-05-01,House,"House Appropriations: Adopt amendment J.002",11,0,0,0,11
1907612,1563471,2025-05-01,House,"House Appropriations: Adopt amendment L.008",11,0,0,0,11
1907612,1563472,2025-05-01,House,"House Appropriations: Refer Senate Bill 25-026, as amended, to the Committee of the Whole.",8,3,0,0,11
1907612,1564533,2025-05-02,House,"House: Third Reading Bill",42,22,0,1,65
1907612,1566580,2025-05-06,Senate,"Senate: House Amendments Concur",35,0,0,0,35
1907612,1566581,2025-05-06,Senate,"Senate: House Amendments Repass",30,5,0,0,35
1907616,1479825,2025-02-04,House,"House Health & Human Services: Adopt amendment L.001 (Attachment C).",13,0,0,0,13
1907616,1483325,2025-02-06,House,"House: Committee of the Whole Amd (h.001)",22,42,0,1,65
1907616,1483326,2025-02-06,House,"House: Committee of the Whole Amd (h.002)",22,41,0,2,65
1907616,1484107,2025-02-07,House,"House: Third Reading Bill",42,20,0,3,65
1907616,1497478,2025-02-04,House,"House Health & Human Services: Refer House Bill 25-1027, as amended, to the Committee of the Whole.",10,2,0,1,13
1907616,1506295,2025-03-05,Senate,"Senate Health & Human Services: Adopt amendment L.019 (Attachment D).",9,0,0,0,9
1907616,1517868,2025-03-14,Senate,"Senate: Third Reading Bill",23,11,0,0,34
1907616,1518379,2025-03-17,House,"House: Senate Amendments Concur",43,20,0,2,65
1907616,1518380,2025-03-17,House,"House: Senate Amendments Repass",43,20,0,2,65
1907616,1547242,2025-03-05,Senate,"Senate Health & Human Services: Adopt amendment L.018 (Attachment E).",5,3,0,1,9
1907616,1547243,2025-03-05,Senate,"Senate Health & Human Services: Refer House Bill 25-1027, as amended, to the Committee of the Whole.",6,3,0,0,9
1907623,1501821,2025-02-27,House,"House Energy & Environment: Adopt amendment L.009",13,0,0,0,13
1907623,1517159,2025-02-27,House,"House Energy & Environment: Refer House Bill 25-1042, as amended, to the Committee on Appropriations.",8,3,0,2,13
1907625,1475081,2025-01-27,House,"House Agriculture, Water & Natural Resources: Adopt amendment L.002",4,9,0,0,13
1907625,1484042,2025-01-27,House,"House Agriculture, Water & Natural Resources: Postpone House Bill 25-1074 indefinitely.",9,4,0,0,13
1907625,1484043,2025-01-27,House,"House Agriculture, Water & Natural Resources: Refer House Bill 25-1074 to the Committee of the Whole.",5,8,0,0,13
1907627,1492328,2025-02-18,House,"House Health & Human Services: Adopt amendment L.001 (Attachment D).",13,0,0,0,13
1907627,1502190,2025-02-28,House,"House Appropriations: Refer House Bill 25-1011 to the Committee of the Whole.",7,3,0,1,11
1907627,1506064,2025-03-05,House,"House: Third Reading Bill",38,23,0,4,65
1907627,1507586,2025-02-18,House,"House Health & Human Services: Adopt amendment L.003 (Attachment E).",13,0,0,0,13
1907627,1507587,2025-02-18,House,"House Health & Human Services: Refer House Bill 25-1011, as amended, to the Committee on Appropriations.",8,5,0,0,13
1907627,1532851,2025-04-01,Senate,"Senate Business, Labor, & Technology: Refer House Bill 25-1011, as amended, to the Committee of the Whole.",4,3,0,0,7
1907627,1538522,2025-04-07,Senate,"Senate: Committee of the Whole Cow * (s.001)",15,20,0,0,35
1907627,1539510,2025-04-08,Senate,"Senate: Third Reading Bill",16,18,0,1,35
1907631,1476258,2025-01-29,Senate,"Senate Agriculture & Natural Resources: Postpone Senate Bill 25-029 indefinitely.",4,1,0,2,7
1907635,1516546,2025-03-12,House,"House Judiciary: Adopt amendment L.001 (Attachment A)",11,0,0,0,11
1907635,1537059,2025-03-12,House,"House Judiciary: Postpone House Bill 25-1072 indefinitely using a reversal of the previous roll call. There was no objection to the use of the reverse roll call, therefore, the bill was postponed indefinitely.",7,4,0,0,11
1907635,1537060,2025-03-12,House,"House Judiciary: Refer House Bill 25-1072, as amended, to the Committee of the Whole.",4,7,0,0,11
1907640,1476695,2025-01-29,Senate,"Senate Judiciary: Refer Senate Bill 25-024 to the Committee on Appropriations.",6,1,0,0,7
1907640,1497031,2025-02-14,Senate,"Senate Appropriations: Adopt amendment J.002",7,0,0,0,7
1907640,1497032,2025-02-14,Senate,"Senate Appropriations: Adopt amendment J.004",5,2,0,0,7
1907640,1497033,2025-02-14,Senate,"Senate Appropriations: Adopt amendment L.001",7,0,0,0,7
1907640,1497034,2025-02-14,Senate,"Senate Appropriations: Refer Senate Bill 25-024, as amended, to the Committee of the Whole.",5,2,0,0,7
1907640,1499791,2025-02-26,Senate,"Senate: Third Reading Amend (l.010)",33,0,0,1,34
1907640,1499792,2025-02-26,Senate,"Senate: Third Reading Bill",26,7,0,1,34
1907640,1504359,2025-03-04,House,"House Judiciary: Refer Senate Bill 25-024 to the Committee on Appropriations.",9,2,0,0,11
1907640,1508561,2025-03-07,House,"House Appropriations: Refer Senate Bill 25-024 to the Committee of the Whole.",11,0,0,0,11
1907640,1516963,2025-03-13,House,"House: Third Reading Bill",63,0,0,2,65
1907644,1480830,2025-02-05,House,"House Business Affairs & Labor: Refer House Bill 25-1018 to the Committee of the Whole.",10,2,0,1,13
1907644,1491878,2025-02-18,House,"House: Third Reading Bill",44,20,0,1,65
1907644,1520204,2025-03-18,Senate,"Senate Business, Labor, & Technology: Refer House Bill 25-1018 to the Committee of the Whole.",6,1,0,0,7
1907644,1525222,2025-03-24,Senate,"Senate: Third Reading Bill",21,12,0,2,35
1907644,1530294,2025-03-28,House,"House: Senate Amendments Concur",46,17,0,2,65
1907644,1530295,2025-03-28,House,"House: Senate Amendments Repass",45,18,0,2,65
1907646,1475876,2025-01-28,Senate,"Senate Finance: Adopt amendment L.001 (Attachment E)",9,0,0,0,9
1907646,1478060,2025-01-28,Senate,"Senate Finance: Refer Senate Bill 25-013, as amended, to the Committee on Appropriations.",8,0,0,1,9
1907651,1476710,2025-01-29,Senate,"Senate Agriculture & Natural Resources: Adopt amendment L.001 (Attachment A).",7,0,0,0,7
1907651,1493415,2025-01-29,Senate,"Senate Agriculture & Natural Resources: Adopt amendment L.002 (Attachment B).",7,0,0,0,7
1907651,1493416,2025-01-29,Senate,"Senate Agriculture & Natural Resources: Refer Senate Bill 25-040, as amended, to the Committee on Appropriations.",6,0,0,1,7
1907651,1545654,2025-04-11,Senate,"Senate Appropriations: Adopt amendment J.002",7,0,0,0,7
1907651,1545655,2025-04-11,Senate,"Senate Appropriations: Refer Senate Bill 25-040, as amended, to the Committee of the Whole.",7,0,0,0,7
1907651,1548592,2025-04-15,Senate,"Senate: Third Reading Bill",34,0,0,1,35
1907651,1553002,2025-04-21,House,"House Agriculture, Water & Natural Resources: Refer Senate Bill 25-040 to the Committee on Appropriations.",13,0,0,0,13
1907651,1563366,2025-05-01,House,"House Appropriations: Refer Senate Bill 25-040 to the Committee of the Whole.",8,3,0,0,11
1907651,1564545,2025-05-02,House,"House: Third Reading Bill",57,7,0,1,65
1907651,1565374,2025-05-05,Senate,"Senate: House Amendments Concur",35,0,0,0,35
1907651,1565375,2025-05-05,Senate,"Senate: House Amendments Repass",35,0,0,0,35
1907656,1493239,2025-02-19,House,"House Business Affairs & Labor: Adopt amendment L.001",13,0,0,0,13
1907656,1495522,2025-02-19,House,"House Business Affairs & Labor: Refer House Bill 25-1021, as amended, to the Committee on Finance.",12,1,0,0,13
1907656,1503247,2025-03-03,House,"House Finance: Adopt amendment L.002 (Attachment A).",13,0,0,0,13
1907656,1518555,2025-03-03,House,"House Finance: Refer House Bill 25-1021, as amended, to the Committee on Appropriations.",10,2,0,1,13
1907656,1557960,2025-04-25,House,"House Appropriations: Refer House Bill 25-1021 to the Committee of the Whole.",9,1,0,1,11
1907656,1559024,2025-04-28,House,"House: Third Reading Bill",56,8,0,1,65
1907656,1563562,2025-05-01,Senate,"Senate Finance: Adopt amendment L.006 (Attachment H)",9,0,0,0,9
1907656,1564477,2025-05-02,Senate,"Senate Appropriations: Refer House Bill 25-1021 to the Committee of the Whole and with a recommendation that it be placed on the consent calendar.",7,0,0,0,7
1907656,1564824,2025-05-05,Senate,"Senate: Third Reading Bill",34,1,0,0,35
1907656,1565040,2025-05-01,Senate,"Senate Finance: Refer House Bill 25-1021, as amended, to the Committee on Appropriations.",7,0,0,2,9
1907656,1565214,2025-05-05,House,"House: Senate Amendments Concur",61,3,0,1,65
1907656,1565215,2025-05-05,House,"House: Senate Amendments Repass",57,7,0,1,65
1907659,1475715,2025-01-28,House,"House Health & Human Services: Adopt amendment L.001 (Attachment B).",13,0,0,0,13
1907659,1477237,2025-01-30,House,"House: Committee of the Whole Amd (h.001)",27,38,0,0,65
1907659,1478923,2025-02-03,House,"House: Third Reading Bill",40,24,0,1,65
1907659,1478924,2025-02-03,House,"House: Third Reading Perm",21,43,0,1,65
1907659,1478925,2025-02-03,House,"House: Third Reading Rerefer (2nd)",22,42,0,1,65
1907659,1497579,2025-01-28,House,"House Health & Human Services: Refer House Bill 25-1035, as amended, to the Committee of the Whole.",13,0,0,0,13
1907659,1505900,2025-03-05,Senate,"Senate Health & Human Services: Adopt amendment L.006 (Attachment B).",9,0,0,0,9
1907659,1509109,2025-03-10,Senate,"Senate: Third Reading Bill",27,7,0,0,34
1907659,1518363,2025-03-17,House,"House: Senate Amendments Concur",44,19,0,2,65
1907659,1518364,2025-03-17,House,"House: Senate Amendments Repass",43,20,0,2,65
1907659,1547277,2025-03-05,Senate,"Senate Health & Human Services: Refer House Bill 25-1035, as amended, to the Committee of the Whole.",7,1,0,1,9
1907662,1471429,2025-01-14,House,"House Health & Human Services: Refer House Bill 25-1016 to the Committee of the Whole.",13,0,0,0,13
1907662,1473476,2025-01-23,House,"House: Third Reading Bill",45,17,0,2,64
1907662,1473477,2025-01-23,House,"House: Third Reading Rerefer (2nd)",20,41,0,3,64
1907662,1507426,2025-03-06,Senate,"Senate Health & Human Services: Adopt amendment L.002 (Attachment A).",9,0,0,0,9
1907662,1515859,2025-03-12,Senate,"Senate: Third Reading Bill",34,0,0,0,34
1907662,1518334,2025-03-17,House,"House: Senate Amendments Concur",62,1,0,2,65
1907662,1518335,2025-03-17,House,"House: Senate Amendments Repass",62,1,0,2,65
1907662,1529110,2025-03-06,Senate,"Senate Health & Human Services: Refer House Bill 25-1016, as amended, to the Committee of the Whole and with a recommendation that it be placed on the consent calendar.",9,0,0,0,9
1907667,1475096,2025-01-27,House,"House Finance: Postpone House Bill 25-1052 indefinitely.",9,2,0,2,13
1907671,1492667,2025-02-18,House,"House Health & Human Services: Adopt amendment L.002 (Attachment I).",13,0,0,0,13
1907671,1507355,2025-02-18,House,"House Health & Human Services: Adopt amendment L.001 (Attachment H).",13,0,0,0,13
1907671,1507356,2025-02-18,House,"House Health & Human Services: Adopt amendment L.003 (Attachment J).",13,0,0,0,13
1907671,1507357,2025-02-18,House,"House Health & Human Services: Adopt amendment L.004 (Attachment K).",13,0,0,0,13
1907671,1507358,2025-02-18,House,"House Health & Human Services: Refer House Bill 25-1017, as amended, to the Committee on Appropriations.",13,0,0,0,13
1907671,1545675,2025-04-11,House,"House Appropriations: Adopt amendment J.001",11,0,0,0,11
1907671,1545676,2025-04-11,House,"House Appropriations: Refer House Bill 25-1017, as amended, to the Committee of the Whole.",10,1,0,0,11
1907671,1549823,2025-04-16,House,"House: Third Reading Bill",60,5,0,0,65
1907671,1551455,2025-04-17,Senate,"Senate Health & Human Services: Refer House Bill 25-1017 to the Committee on Appropriations.",9,0,0,0,9
1907671,1553419,2025-04-22,Senate,"Senate Appropriations: Refer House Bill 25-1017 to the Committee of the Whole.",7,0,0,0,7
1907671,1558157,2025-04-25,Senate,"Senate: Third Reading Bill",32,3,0,0,35
1907671,1564058,2025-05-01,House,"House: Senate Amendments Concur",62,1,0,2,65
1907671,1564059,2025-05-01,House,"House: Senate Amendments Repass",63,0,0,2,65
1907674,1483618,2025-02-06,House,"House Education: Adopt amendment L.010 to L.005",10,3,0,0,13
1907674,1492021,2025-02-18,House,"House: Third Reading Bill",59,5,0,1,65
1907674,1496714,2025-02-06,House,"House Education: Adopt amendment L.004",13,0,0,0,13
1907674,1496715,2025-02-06,House,"House Education: Adopt amendment L.005 as amended",9,4,0,0,13
1907674,1496716,2025-02-06,House,"House Education: Refer House Bill 25-1041, as amended, to the Committee of the Whole.",9,4,0,0,13
1907674,1509670,2025-03-10,Senate,"Senate Education: Adopt amendment L.013",3,4,0,0,7
1907674,1514738,2025-03-10,Senate,"Senate Education: Refer House Bill 25-1041 to the Committee of the Whole.",6,1,0,0,7
1907674,1517916,2025-03-14,Senate,"Senate: Third Reading Bill",30,4,0,0,34
1907680,1475673,2025-01-28,House,"House Transportation, Housing & Local Government: Adopt amendment L.001",12,0,0,0,12
1907680,1478649,2025-01-28,House,"House Transportation, Housing & Local Government: Refer House Bill 25-1039, as amended, to the Committee on Appropriations.",7,4,0,1,12
1907680,1548194,2025-04-15,House,"House Appropriations: Refer House Bill 25-1039 to the Committee of the Whole.",8,3,0,0,11
1907680,1552485,2025-04-21,House,"House: Third Reading Bill",41,22,0,2,65
1907680,1558946,2025-04-28,Senate,"Senate Transportation & Energy: Refer House Bill 25-1039 to the Committee on Appropriations.",8,0,0,1,9
1907680,1561797,2025-04-30,Senate,"Senate Appropriations: Refer House Bill 25-1039 to the Committee of the Whole and with a recommendation that it be placed on the consent calendar.",7,0,0,0,7
1907680,1563458,2025-05-01,Senate,"Senate: Third Reading Bill",30,5,0,0,35
1907683,1540323,2025-04-08,House,"House Judiciary: Postpone House Bill 25-1067 indefinitely using a reversal of the previous roll call. There was no objection to the use of the reverse roll call, therefore, the bill was postponed indefinitely.",8,3,0,0,11
1907687,1483243,2025-02-06,Senate,"Senate Health & Human Services: Adopt amendment L.001 (Attachment A).",9,0,0,0,9
1907687,1490073,2025-02-14,Senate,"Senate Appropriations: Adopt amendment L.003",7,0,0,0,7
1907687,1490074,2025-02-14,Senate,"Senate Appropriations: Refer Senate Bill 25-042, as amended, to the Committee of the Whole and with a recommendation that it be placed on the consent calendar.",7,0,0,0,7
1907687,1492139,2025-02-18,Senate,"Senate: Third Reading Bill",31,3,0,0,34
1907687,1502503,2025-02-06,Senate,"Senate Health & Human Services: Adopt amendment L.002 (Attachment B).",9,0,0,0,9
1907687,1502504,2025-02-06,Senate,"Senate Health & Human Services: Refer Senate Bill 25-042, as amended, to the Committee on Appropriations.",9,0,0,0,9
1907687,1513330,2025-03-11,House,"House Health & Human Services: Adopt amendment L.004 (Attachment C).",13,0,0,0,13
1907687,1516954,2025-03-13,House,"House: Third Reading Bill",53,10,0,2,65
1907687,1518457,2025-03-17,Senate,"Senate: House Amendments Concur",34,0,0,0,34
1907687,1518458,2025-03-17,Senate,"Senate: House Amendments Repass",29,5,0,0,34
1907687,1525231,2025-03-11,House,"House Health & Human Services: Refer Senate Bill 25-042, as amended, to the Committee of the Whole.",12,1,0,0,13
1907692,1479791,2025-02-04,Senate,"Senate Business, Labor, & Technology: Adopt amendment L.001 (Attachment C)",7,0,0,0,7
1907692,1490037,2025-02-14,Senate,"Senate Appropriations: Refer Senate Bill 25-037 to the Committee of the Whole.",7,0,0,0,7
1907692,1493486,2025-02-04,Senate,"Senate Business, Labor, & Technology: Adopt amendment L.003 (Attachment D)",7,0,0,0,7
1907692,1493488,2025-02-04,Senate,"Senate Business, Labor, & Technology: Adopt amendment L.004 (Attachment E)",7,0,0,0,7
1907692,1493489,2025-02-04,Senate,"Senate Business, Labor, & Technology: Adopt amendment L.005 (Attachment F).",7,0,0,0,7
1907692,1493490,2025-02-04,Senate,"Senate Business, Labor, & Technology: Refer Senate Bill 25-037, as amended, to the Committee on Appropriations.",6,0,0,1,7
1907692,1495073,2025-02-20,Senate,"Senate: Third Reading Bill",31,2,0,1,34
1907692,1550058,2025-04-16,House,"House Business Affairs & Labor: Adopt amendment L.013",13,0,0,0,13
1907692,1555544,2025-04-16,House,"House Business Affairs & Labor: Adopt amendment L.015",13,0,0,0,13
1907692,1555545,2025-04-16,House,"House Business Affairs & Labor: Adopt amendment L.016",13,0,0,0,13
1907692,1555546,2025-04-16,House,"House Business Affairs & Labor: Refer Senate Bill 25-037, as amended, to the Committee of the Whole.",12,0,0,1,13
1907692,1562330,2025-04-30,House,"House: Third Reading Bill",57,8,0,0,65
1907692,1565041,2025-05-05,Senate,"Senate: House Amendments Not Concur Appt Cc",35,0,0,0,35
1907692,1565213,2025-05-05,House,"House: Conference Committee Report Byd Scp",62,1,0,2,65
1907692,1567689,2025-05-07,House,"House: Conference Committee Report Adopt",61,2,0,2,65
1907692,1567690,2025-05-07,House,"House: Conference Committee Report Repass",58,6,0,1,65
1907692,1567691,2025-05-07,Senate,"Senate: Conference Committee Report Adopt Ccr",35,0,0,0,35
1907692,1567692,2025-05-07,Senate,"Senate: Conference Committee Report Adopt Ccr",35,0,0,0,35
1907692,1567693,2025-05-07,Senate,"Senate: Conference Committee Report Repass",33,2,0,0,35
1907692,1567694,2025-05-07,Senate,"Senate: Conference Committee Report Repass",32,3,0,0,35
1907695,1483178,2025-02-06,Senate,"Senate State, Veterans, & Military Affairs: Adopt amendment L.001 (Attachment B).",5,0,0,0,5
1907695,1508682,2025-02-06,Senate,"Senate State, Veterans, & Military Affairs: Refer Senate Bill 25-034, as amended, to the Committee on Appropriations.",3,2,0,0,5
1907695,1545698,2025-04-11,Senate,"Senate Appropriations: Refer Senate Bill 25-034 to the Committee of the Whole.",4,3,0,0,7
1907695,1551029,2025-04-17,Senate,"Senate: Third Reading Bill",23,12,0,0,35
1907695,1560810,2025-04-29,House,"House State, Civic, Military, & Veterans Affairs: Refer Senate Bill 25-034 to the Committee on Finance.",8,2,0,1,11
1907695,1563868,2025-05-01,House,"House Finance: Refer Senate Bill 25-034 to the Committee on Appropriations.",7,4,0,2,13
1907695,1564763,2025-05-03,House,"House Appropriations: Refer Senate Bill 25-034 to the Committee of the Whole.",7,4,0,0,11
1907695,1564785,2025-05-03,House,"House: Committee of the Whole Amd (h.001)",23,38,0,4,65
1907695,1564786,2025-05-03,House,"House: Committee of the Whole Amd (h.002)",23,38,0,4,65
1907695,1564787,2025-05-03,House,"House: Committee of the Whole Amd (h.003)",27,34,0,4,65
1907695,1564788,2025-05-03,House,"House: Committee of the Whole Amd (h.004)",24,37,0,4,65
1907695,1565116,2025-05-05,House,"House: Third Reading Bill",36,28,0,1,65
1907704,1475079,2025-01-27,House,"House Finance: Adopt amendment L.003 (Attachment G).",13,0,0,0,13
1907704,1485163,2025-01-27,House,"House Finance: Adopt amendment L.001 (Attachment F). The chair ruled that the amendment does not fit under the title of the bill.",0,0,13,0,13
1907704,1485164,2025-01-27,House,"House Finance: Adopt amendment L.004 (Attachment H). The motion was withdrawn.",0,0,13,0,13
1907704,1485165,2025-01-27,House,"House Finance: Refer House Bill 25-1037, as amended, to the Committee on Appropriations.",9,4,0,0,13
1907707,1482529,2025-02-05,House,"House Judiciary: Refer House Bill 25-1013 to the Committee on Appropriations.",7,4,0,0,11
1907707,1517905,2025-03-14,House,"House Appropriations: Refer House Bill 25-1013 to the Committee of the Whole.",8,3,0,0,11
1907707,1527468,2025-03-26,House,"House: Third Reading Bill",44,21,0,0,65
1907707,1553947,2025-04-22,Senate,"Senate State, Veterans, & Military Affairs: Refer House Bill 25-1013, as amended, to the Committee on Appropriations.",3,2,0,0,5
1907707,1558006,2025-04-25,Senate,"Senate Appropriations: Refer House Bill 25-1013 to the Committee of the Whole.",5,2,0,0,7
1907707,1564472,2025-05-02,Senate,"Senate: Third Reading Bill",22,12,0,1,35
1907707,1564636,2025-05-02,Senate,"Senate: Third Reading Amend (l.006)",34,0,0,1,35
1907707,1564637,2025-05-02,Senate,"Senate: Third Reading Bill",22,12,0,1,35
1907707,1564715,2025-05-02,House,"House: Senate Amendments Concur",43,19,0,3,65
1907707,1564716,2025-05-02,House,"House: Senate Amendments Repass",43,19,0,3,65
1907707,1567032,2025-04-22,Senate,"Senate State, Veterans, & Military Affairs: Refer House Bill 25-1013, as amended, to the Committee on Appropriations.",3,2,0,0,5
1907710,1478999,2025-02-03,House,"House Agriculture, Water & Natural Resources: Adopt amendment L.001",13,0,0,0,13
1907710,1484114,2025-02-07,House,"House: Third Reading Bill",42,20,0,3,65
1907710,1486271,2025-02-03,House,"House Agriculture, Water & Natural Resources: Adopt amendment L.002",13,0,0,0,13
1907710,1486272,2025-02-03,House,"House Agriculture, Water & Natural Resources: Adopt amendment L.003",8,3,0,2,13
1907710,1486273,2025-02-03,House,"House Agriculture, Water & Natural Resources: Adopt amendment L.005",13,0,0,0,13
1907710,1486274,2025-02-03,House,"House Agriculture, Water & Natural Resources: Refer House Bill 25-1009, as amended, to the Committee of the Whole.",9,4,0,0,13
1907710,1506113,2025-03-05,Senate,"Senate Agriculture & Natural Resources: Adopt amendment L.011 (Attachment C).",7,0,0,0,7
1907710,1513369,2025-03-11,Senate,"Senate: Third Reading Bill",23,11,0,0,34
1907710,1516990,2025-03-05,Senate,"Senate Agriculture & Natural Resources: Adopt amendment L.012 (Attachment D).",7,0,0,0,7
1907710,1516991,2025-03-05,Senate,"Senate Agriculture & Natural Resources: Adopt amendment L.013 (Attachment E).",7,0,0,0,7
1907710,1516992,2025-03-05,Senate,"Senate Agriculture & Natural Resources: Adopt amendment L.014 (Attachment F).",7,0,0,0,7
1907710,1516993,2025-03-05,Senate,"Senate Agriculture & Natural Resources: Refer House Bill 25-1009, as amended, to the Committee of the Whole.",5,2,0,0,7
1907710,1518392,2025-03-17,House,"House: Senate Amendments Concur",43,20,0,2,65
1907710,1518393,2025-03-17,House,"House: Senate Amendments Repass",43,20,0,2,65
1907712,1471378,2025-01-14,House,"House Health & Human Services: Refer House Bill 25-1022 to the Committee of the Whole.",13,0,0,0,13
1907712,1473496,2025-01-23,House,"House: Third Reading Bill",62,0,0,2,64
1907712,1477478,2025-01-30,Senate,"Senate Health & Human Services: Refer House Bill 25-1022 to the Committee of the Whole and with a recommendation that it be placed on the consent calendar.",9,0,0,0,9
1907712,1480562,2025-02-05,Senate,"Senate: Third Reading Bill",35,0,0,0,35
1907718,1485485,2025-02-10,Senate,"Senate Judiciary: Adopt amendment L.001 (Attachment C)",7,0,0,0,7
1907718,1492299,2025-02-10,Senate,"Senate Judiciary: Postpone Senate Bill 25-044 indefinitely.",4,3,0,0,7
1907718,1492300,2025-02-10,Senate,"Senate Judiciary: Refer Senate Bill 25-044, as amended, to the Committee on Appropriations.",3,4,0,0,7
1907721,1483689,2025-02-06,House,"House Business Affairs & Labor: Adopt amendment L.001",13,0,0,0,13
1907721,1496192,2025-02-06,House,"House Business Affairs & Labor: Adopt amendment L.002",8,5,0,0,13
1907721,1496193,2025-02-06,House,"House Business Affairs & Labor: Adopt amendment L.003",13,0,0,0,13
1907721,1496194,2025-02-06,House,"House Business Affairs & Labor: Refer House Bill 25-1010, as amended, to the Committee of the Whole.",7,6,0,0,13
1907721,1509204,2025-03-10,House,"House: Third Reading Bill",38,24,0,3,65
1907721,1528982,2025-03-27,Senate,"Senate Business, Labor, & Technology: Refer House Bill 25-1010 to the Committee of the Whole.",4,3,0,0,7
1907721,1531097,2025-03-31,Senate,"Senate: Committee of the Whole Cow * (s.001)",14,18,0,3,35
1907721,1531098,2025-03-31,Senate,"Senate: Committee of the Whole Cow * (s.002)",16,16,0,3,35
1907721,1531099,2025-03-31,Senate,"Senate: Committee of the Whole Cow * (s.003)",14,18,0,3,35
1907721,1531100,2025-03-31,Senate,"Senate: Committee of the Whole Cow * (s.004)",17,15,0,3,35
1907721,1537226,2025-04-04,Senate,"Senate: Third Reading Bill",23,11,0,1,35
1907721,1545946,2025-04-11,House,"House: Senate Amendments Concur",41,21,0,3,65
1907721,1545947,2025-04-11,House,"House: Senate Amendments Repass",38,23,0,4,65
1907726,1489878,2025-02-13,House,"House Energy & Environment: Adopt amendment L.001",13,0,0,0,13
1907726,1498650,2025-02-25,House,"House: Third Reading Bill",43,18,0,4,65
1907726,1509685,2025-03-10,Senate,"Senate Transportation & Energy: Adopt amendment L.013",2,7,0,0,9
1907726,1515719,2025-03-10,Senate,"Senate Transportation & Energy: Adopt amendment L.014",3,6,0,0,9
1907726,1515720,2025-03-10,Senate,"Senate Transportation & Energy: Refer House Bill 25-1040 to the Committee of the Whole.",6,3,0,0,9
1907726,1516225,2025-02-13,House,"House Energy & Environment: Adopt amendment L.005",13,0,0,0,13
1907726,1516226,2025-02-13,House,"House Energy & Environment: Refer House Bill 25-1040, as amended, to the Committee of the Whole.",8,5,0,0,13
1907726,1517920,2025-03-14,Senate,"Senate: Third Reading Bill",29,5,0,0,34
1907728,1477480,2025-01-30,Senate,"Senate Agriculture & Natural Resources: Adopt amendment L.001 (Attachment A).",7,0,0,0,7
1907728,1480525,2025-02-05,Senate,"Senate: Third Reading Bill",35,0,0,0,35
1907728,1493960,2025-01-30,Senate,"Senate Agriculture & Natural Resources: Adopt amendment L.002 (Attachment B).",7,0,0,0,7
1907728,1493961,2025-01-30,Senate,"Senate Agriculture & Natural Resources: Adopt amendment L.003 (Attachment C).",7,0,0,0,7
1907728,1493962,2025-01-30,Senate,"Senate Agriculture & Natural Resources: Refer Senate Bill 25-038, as amended, to the Committee of the Whole.",6,0,0,1,7
1907728,1497990,2025-02-24,House,"House Agriculture, Water & Natural Resources: Refer Senate Bill 25-038 to the Committee of the Whole.",13,0,0,0,13
1907728,1502307,2025-02-28,House,"House: Third Reading Bill",60,1,0,4,65
1907734,1494174,2025-02-19,House,"House Transportation, Housing & Local Government: Adopt amendment L.001 (Attachment Z)",13,0,0,0,13
1907734,1521897,2025-02-19,House,"House Transportation, Housing & Local Government: Refer House Bill 25-1032, as amended, to the Committee on Appropriations.",8,4,0,1,13
1907738,1486959,2025-02-11,Senate,"Senate Business, Labor, & Technology: Refer Senate Bill 25-036 to the Committee of the Whole and with a recommendation that it be placed on the consent calendar.",7,0,0,0,7
1907738,1491762,2025-02-18,Senate,"Senate: Third Reading Bill",34,0,0,0,34
1907738,1535088,2025-04-02,House,"House Business Affairs & Labor: Refer Senate Bill 25-036 to the Committee of the Whole.",11,0,0,2,13
1907738,1555614,2025-04-23,House,"House: Third Reading Bill",64,0,0,1,65
1907743,1475676,2025-01-28,Senate,"Senate Finance: Adopt amendment L.001 (Attachment A)",9,0,0,0,9
1907743,1478056,2025-01-28,Senate,"Senate Finance: Refer Senate Bill 25-046, as amended, to the Committee of the Whole and with a recommendation that it be placed on the consent calendar.",8,0,0,1,9
1907743,1478671,2025-02-03,Senate,"Senate: Third Reading Bill",35,0,0,0,35
1907743,1494643,2025-02-20,House,"House Finance: Refer Senate Bill 25-046 to the Committee of the Whole.",12,0,0,1,13
1907743,1504508,2025-03-04,House,"House: Third Reading Bill",61,1,0,3,65
1907749,1488043,2025-02-12,Senate,"Senate Judiciary: Adopt amendment L.001 (Attachment A)",7,0,0,0,7
1907749,1493735,2025-02-12,Senate,"Senate Judiciary: Refer Senate Bill 25-041, as amended, to the Committee on Appropriations.",7,0,0,0,7
1907749,1527252,2025-03-26,Senate,"Senate Appropriations: Adopt amendment L.002",7,0,0,0,7
1907749,1530877,2025-03-31,Senate,"Senate: Third Reading Bill",22,12,0,1,35
1907749,1532924,2025-03-26,Senate,"Senate Appropriations: Refer Senate Bill 25-041, as amended, to the Committee of the Whole.",4,3,0,0,7
1907749,1553881,2025-04-22,House,"House Judiciary: Refer Senate Bill 25-041, as amended, to the Committee of the Whole.",9,2,0,0,11
1907749,1558987,2025-04-28,House,"House: Third Reading Bill",47,18,0,0,65
1907749,1560545,2025-04-29,Senate,"Senate: House Amendments Concur",32,0,0,3,35
1907749,1560546,2025-04-29,Senate,"Senate: House Amendments Repass",20,12,0,3,35
1907752,1475736,2025-01-28,Senate,"Senate Finance: Refer Senate Bill 25-018 to the Committee on Appropriations.",8,0,0,1,9
1907752,1545622,2025-04-11,Senate,"Senate Appropriations: Adopt amendment J.001",3,4,0,0,7
1907752,1545623,2025-04-11,Senate,"Senate Appropriations: Refer Senate Bill 25-018 to the Committee of the Whole.",7,0,0,0,7
1907752,1548528,2025-04-15,Senate,"Senate: Third Reading Bill",34,0,0,1,35
1907752,1552923,2025-04-21,House,"House Finance: Refer Senate Bill 25-018 to the Committee on Appropriations.",13,0,0,0,13
1907752,1557973,2025-04-25,House,"House Appropriations: Adopt amendment J.003",11,0,0,0,11
1907752,1559853,2025-04-25,House,"House Appropriations: Refer Senate Bill 25-018, as amended, to the Committee of the Whole.",11,0,0,0,11
1907752,1562315,2025-04-30,House,"House: Third Reading Bill",64,0,0,1,65
1907752,1564354,2025-05-01,Senate,"Senate: House Amendments Concur",32,0,0,3,35
1907752,1564355,2025-05-01,Senate,"Senate: House Amendments Repass",32,0,0,3,35
1907756,1494631,2025-02-19,Senate,"Senate Agriculture & Natural Resources: Refer Senate Bill 25-015 to the Committee of the Whole and with a recommendation that it be placed on the consent calendar.",6,0,0,1,7
1907756,1498577,2025-02-25,Senate,"Senate: Third Reading Bill",31,0,1,2,34
1907756,1518488,2025-03-17,House,"House Agriculture, Water & Natural Resources: Refer Senate Bill 25-015 to the Committee of the Whole.",12,0,0,1,13
1907756,1527555,2025-03-26,House,"House: Third Reading Bill",65,0,0,0,65
1907760,1473271,2025-01-22,House,"House Transportation, Housing & Local Government: Refer House Bill 25-1019 to the Committee of the Whole.",9,3,0,0,12
1907760,1474859,2025-01-27,House,"House: Third Reading Bill",41,21,0,3,65
1907760,1483324,2025-02-06,Senate,"Senate Local Government & Housing: Refer House Bill 25-1019 to the Committee of the Whole.",4,2,0,1,7
1907760,1487373,2025-02-12,Senate,"Senate: Third Reading Bill",21,12,0,2,35
1907765,1471382,2025-01-14,House,"House Health & Human Services: Refer House Bill 25-1063 to the Committee of the Whole.",12,1,0,0,13
1907765,1473462,2025-01-23,House,"House: Third Reading Bill",46,16,0,2,64
1907765,1507866,2025-03-06,Senate,"Senate Health & Human Services: Refer House Bill 25-1063 to the Committee of the Whole.",6,2,0,1,9
1907765,1515898,2025-03-12,Senate,"Senate: Third Reading Bill",25,9,0,0,34
1907768,1477288,2025-01-30,Senate,"Senate State, Veterans, & Military Affairs: Refer Senate Bill 25-014 to the Committee of the Whole.",3,2,0,0,5
1907768,1480548,2025-02-05,Senate,"Senate: Third Reading Bill",29,6,0,0,35
1907768,1506971,2025-03-05,House,"House Judiciary: Refer Senate Bill 25-014 to the Committee of the Whole.",7,1,0,3,11
1907768,1526132,2025-03-25,House,"House: Third Reading Bill",45,14,0,6,65
1907774,1476585,2025-01-29,House,"House Transportation, Housing & Local Government: Adopt amendment L.001",12,0,0,0,12
1907774,1478905,2025-01-29,House,"House Transportation, Housing & Local Government: Refer House Bill 25-1030, as amended, to the Committee of the Whole.",9,3,0,0,12
1907774,1478906,2025-02-03,House,"House: Committee of the Whole Amd (h.001)",58,5,0,2,65
1907774,1479812,2025-02-04,House,"House: Committee of the Whole Amd (h.002)",22,40,0,3,65
1907774,1480644,2025-02-05,House,"House: Third Reading Bill",41,22,0,2,65
1907774,1495164,2025-02-20,Senate,"Senate Local Government & Housing: Adopt amendment L.005",7,0,0,0,7
1907774,1496245,2025-02-20,Senate,"Senate Local Government & Housing: Adopt amendment L.006",7,0,0,0,7
1907774,1496246,2025-02-20,Senate,"Senate Local Government & Housing: Refer House Bill 25-1030, as amended, to the Committee of the Whole.",5,2,0,0,7
1907774,1499745,2025-02-26,Senate,"Senate: Third Reading Bill",20,13,0,1,34
1907774,1502602,2025-02-28,House,"House: Senate Amendments Concur",40,20,0,5,65
1907774,1502603,2025-02-28,House,"House: Senate Amendments Repass",39,21,0,5,65
1907777,1473342,2025-01-21,House,"House Transportation, Housing & Local Government: Refer House Bill 25-1054 to the Committee of the Whole.",9,2,0,1,12
1907777,1474687,2025-01-27,House,"House: Third Reading Bill",52,10,0,3,65
1907777,1482481,2025-02-05,Senate,"Senate Transportation & Energy: Refer House Bill 25-1054 to the Committee of the Whole and with a recommendation that it be placed on the consent calendar.",8,0,0,1,9
1907777,1484582,2025-02-10,Senate,"Senate: Third Reading Bill",32,1,0,2,35
1907782,1474846,2025-01-27,House,"House Finance: Adopt amendment L.001 (Attachment C).",13,0,0,0,13
1907782,1484911,2025-01-27,House,"House Finance: Refer House Bill 25-1012, as amended, to the Committee on Appropriations.",12,0,0,1,13
1907784,1517178,2025-03-13,Senate,"Senate Health & Human Services: Refer Senate Bill 25-048 to the Committee on Appropriations.",5,3,0,1,9
1907784,1559860,2025-04-29,Senate,"Senate Appropriations: Adopt amendment L.011",7,0,0,0,7
1907784,1559861,2025-04-29,Senate,"Senate Appropriations: Refer Senate Bill 25-048, as amended, to the Committee of the Whole.",5,2,0,0,7
1907784,1560526,2025-04-29,Senate,"Senate: Committee of the Whole Adopt Report",32,1,0,2,35
1907784,1561769,2025-04-30,Senate,"Senate: Third Reading Amend (l.018)",35,0,0,0,35
1907784,1561770,2025-04-30,Senate,"Senate: Third Reading Bill",27,8,0,0,35
1907784,1561771,2025-04-30,Senate,"Senate: Third Reading Bill",26,9,0,0,35
1907784,1564782,2025-05-03,House,"House Health & Human Services: Refer Senate Bill 25-048, as amended, to the Committee of the Whole.",7,6,0,0,13
1907784,1565074,2025-05-05,House,"House: Committee of the Whole Amd (h.001)",20,41,0,4,65
1907784,1565904,2025-05-06,House,"House: Third Reading Bill",41,24,0,0,65
1907784,1565905,2025-05-06,Senate,"Senate: House Amendments Concur",35,0,0,0,35
1907784,1565906,2025-05-06,Senate,"Senate: House Amendments Repass",26,9,0,0,35
1907784,1565907,2025-05-06,Senate,"Senate: House Amendments Repass",25,10,0,0,35
1907784,1567759,2025-05-03,House,"House Health & Human Services: Refer Senate Bill 25-048, as amended, to the Committee of the Whole.",7,6,0,0,13
1907786,1479095,2025-02-03,House,"House Finance: Refer House Bill 25-1066 to the Committee on Appropriations.",4,8,0,1,13
1907786,1485076,2025-02-03,House,"House Finance: Postpone House Bill 25-1066 indefinitely using a reversal of the previous roll call. There was no objection to the use of the reverse roll call, therefore, the bill was postponed indefinitely.",8,4,0,1,13
1907791,1509058,2025-03-10,Senate,"Senate Judiciary: Adopt amendment L.001 (Attachment A)",7,0,0,0,7
1907791,1514900,2025-03-10,Senate,"Senate Judiciary: Adopt amendment L.002 (Attachment B)",7,0,0,0,7
1907791,1514901,2025-03-10,Senate,"Senate Judiciary: Refer Senate Bill 25-020, as amended, to the Committee on Appropriations.",4,3,0,0,7
1907791,1527222,2025-03-26,Senate,"Senate Appropriations: Refer Senate Bill 25-020 to the Committee of the Whole.",4,3,0,0,7
1907791,1530101,2025-03-28,Senate,"Senate: Committee of the Whole Cow * (s.001)",13,21,0,1,35
1907791,1531146,2025-03-31,Senate,"Senate: Third Reading Bill",20,14,0,1,35
1907791,1550108,2025-04-15,House,"House Judiciary: Refer Senate Bill 25-020, as amended, to the Committee of the Whole.",6,5,0,0,11
1907791,1557953,2025-04-25,House,"House: Third Reading Bill",40,23,0,2,65
1907791,1558833,2025-04-28,Senate,"Senate: House Amendments Concur",33,0,0,2,35
1907791,1558834,2025-04-28,Senate,"Senate: House Amendments Repass",20,13,0,2,35
1907795,1478994,2025-02-03,House,"House Finance: Postpone House Bill 25-1071 indefinitely.",10,1,0,2,13
1907801,1477477,2025-01-30,House,"House State, Civic, Military, & Veterans Affairs: Refer House Bill 25-1025 to the Committee of the Whole.",7,3,0,1,11
1907801,1479436,2025-02-04,House,"House: Third Reading Bill",44,18,0,3,65
1907801,1507217,2025-03-06,Senate,"Senate State, Veterans, & Military Affairs: Refer House Bill 25-1025 to the Committee of the Whole.",3,2,0,0,5
1907801,1515816,2025-03-12,Senate,"Senate: Third Reading Bill",22,12,0,0,34
1907804,1475797,2025-01-28,House,"House Transportation, Housing & Local Government: Refer House Bill 25-1046 to the Committee on Appropriations.",5,7,0,0,12
1907804,1478676,2025-01-28,House,"House Transportation, Housing & Local Government: Postpone House Bill 25-1046 indefinitely using a reversal of the previous roll call. There was no objection to the use of the reverse roll call, therefore, the bill was postponed indefinitely.",7,5,0,0,12
1907808,1483357,2025-02-06,House,"House State, Civic, Military, & Veterans Affairs: Adopt amendment L.002 (Attachment C).",11,0,0,0,11
1907808,1484023,2025-02-06,House,"House State, Civic, Military, & Veterans Affairs: Adopt amendment L.003 (Attachment D).",11,0,0,0,11
1907808,1484024,2025-02-06,House,"House State, Civic, Military, & Veterans Affairs: Refer House Bill 25-1065, as amended, to the Committee on Appropriations.",7,4,0,0,11
1907808,1553466,2025-04-22,House,"House Appropriations: Adopt amendment J.001",11,0,0,0,11
1907808,1559835,2025-04-22,House,"House Appropriations: Refer House Bill 25-1065, as amended, to the Committee of the Whole.",10,1,0,0,11
1907808,1561793,2025-04-30,House,"House: Third Reading Bill",50,14,0,1,65
1907808,1563886,2025-05-01,Senate,"Senate State, Veterans, & Military Affairs: Refer House Bill 25-1065 to the Committee on Appropriations.",3,2,0,0,5
1907808,1564490,2025-05-02,Senate,"Senate Appropriations: Refer House Bill 25-1065 to the Committee of the Whole and with a recommendation that it be placed on the consent calendar.",7,0,0,0,7
1907808,1565971,2025-05-06,Senate,"Senate: Third Reading Bill",23,12,0,0,35
1907811,1474915,2025-01-27,House,"House Agriculture, Water & Natural Resources: Adopt amendment L.001",13,0,0,0,13
1907811,1483961,2025-01-27,House,"House Agriculture, Water & Natural Resources: Refer House Bill 25-1014, as amended, to the Committee on Appropriations.",13,0,0,0,13
1907811,1502192,2025-02-28,House,"House Appropriations: Refer House Bill 25-1014 to the Committee of the Whole.",10,0,0,1,11
1907811,1503200,2025-03-03,House,"House: Committee of the Whole Amd (h.001)",57,6,0,2,65
1907811,1505970,2025-03-05,House,"House: Third Reading Bill",61,0,0,4,65
1907811,1529373,2025-03-27,Senate,"Senate Agriculture & Natural Resources: Refer House Bill 25-1014 to the Committee on Appropriations.",7,0,0,0,7
1907811,1545758,2025-04-11,Senate,"Senate Appropriations: Refer House Bill 25-1014 to the Committee of the Whole and with a recommendation that it be placed on the consent calendar.",7,0,0,0,7
1907811,1546886,2025-04-14,Senate,"Senate: Third Reading Bill",33,0,0,2,35
1907817,1477339,2025-01-30,Senate,"Senate Health & Human Services: Adopt amendment L.002 (Attachment B).",9,0,0,0,9
1907817,1490058,2025-02-14,Senate,"Senate Appropriations: Refer Senate Bill 25-045 to the Committee of the Whole.",4,3,0,0,7
1907817,1494613,2025-02-20,Senate,"Senate: Third Reading Bill",23,10,0,1,34
1907817,1499065,2025-01-30,Senate,"Senate Health & Human Services: Refer Senate Bill 25-045, as amended, to the Committee on Appropriations.",6,3,0,0,9
1907817,1521684,2025-03-19,House,"House Health & Human Services: Refer Senate Bill 25-045 to the Committee on Finance.",9,4,0,0,13
1907817,1531280,2025-03-31,House,"House Finance: Refer Senate Bill 25-045 to the Committee on Appropriations.",8,5,0,0,13
1907817,1545329,2025-04-11,House,"House Appropriations: Refer Senate Bill 25-045 to the Committee of the Whole.",7,4,0,0,11
1907817,1555525,2025-04-23,House,"House: Third Reading Bill",39,25,0,1,65
1907822,1516756,2025-03-12,House,"House Judiciary: Refer House Bill 25-1073 to the Committee on Appropriations.",5,6,0,0,11
1907822,1537249,2025-03-12,House,"House Judiciary: Postpone House Bill 25-1073 indefinitely using a reversal of the previous roll call. There was no objection to the use of the reverse roll call, therefore, the bill was postponed indefinitely.",6,5,0,0,11
1907825,1473238,2025-01-22,House,"House Transportation, Housing & Local Government: Adopt amendment L.001",11,1,0,0,12
1907825,1474683,2025-01-27,House,"House: Third Reading Bill",41,21,0,3,65
1907825,1474836,2025-01-22,House,"House Transportation, Housing & Local Government: Refer House Bill 25-1029, as amended, to the Committee of the Whole.",10,2,0,0,12
1907825,1495241,2025-02-20,Senate,"Senate Local Government & Housing: Refer House Bill 25-1029 to the Committee of the Whole.",5,2,0,0,7
1907825,1508635,2025-03-07,Senate,"Senate: Third Reading Bill",19,12,0,3,34
1907825,1509165,2025-03-10,House,"House: Senate Amendments Concur",40,21,0,4,65
1907825,1509166,2025-03-10,House,"House: Senate Amendments Repass",40,22,0,3,65
1907831,1483683,2025-02-06,House,"House Energy & Environment: Refer House Bill 25-1051 to the Committee of the Whole.",4,9,0,0,13
1907831,1484855,2025-02-06,House,"House Energy & Environment: Postpone House Bill 25-1051 indefinitely using a reversal of the previous roll call. There was no objection to the use of the reverse roll call, therefore, the bill was postponed indefinitely.",9,4,0,0,13
1907833,1501673,2025-02-27,House,"House Business Affairs & Labor: Adopt amendment L.003",13,0,0,0,13
1907833,1504463,2025-02-27,House,"House Business Affairs & Labor: Postpone House Bill 25-1055 indefinitely using a reversal of the previous roll call. There was no objection to the use of the reverse roll call, therefore, the bill was postponed indefinitely.",8,5,0,0,13
1907833,1504464,2025-02-27,House,"House Business Affairs & Labor: Refer House Bill 25-1055, as amended, to the Committee on Appropriations.",5,8,0,0,13
1907836,1475716,2025-01-28,House,"House Health & Human Services: Adopt amendment L.001 (Attachment D).",13,0,0,0,13
1907836,1480643,2025-02-05,House,"House: Third Reading Bill",59,4,0,2,65
1907836,1497685,2025-01-28,House,"House Health & Human Services: Adopt amendment L.002 (Attachment E).",13,0,0,0,13
1907836,1497686,2025-01-28,House,"House Health & Human Services: Refer House Bill 25-1070, as amended, to the Committee of the Whole.",12,1,0,0,13
1907836,1507939,2025-03-06,Senate,"Senate Health & Human Services: Refer House Bill 25-1070 to the Committee of the Whole and with a recommendation that it be placed on the consent calendar.",6,0,0,3,9
1907836,1515880,2025-03-12,Senate,"Senate: Third Reading Bill",34,0,0,0,34
1907841,1471222,2025-01-09,House,"House: RESOLUTIONS Res",58,0,0,6,64
1907841,1471232,2025-01-10,Senate,"Senate: Consideration of Resolutions Resolution",28,0,0,4,32
1907846,1476286,2025-01-29,House,"House Business Affairs & Labor: Adopt amendment L.004",13,0,0,0,13
1907846,1478659,2025-02-03,House,"House: Third Reading Bill",62,0,0,3,65
1907846,1484243,2025-01-29,House,"House Business Affairs & Labor: Adopt amendment L.002",13,0,0,0,13
1907846,1484244,2025-01-29,House,"House Business Affairs & Labor: Refer House Bill 25-1077, as amended, to the Committee of the Whole.",13,0,0,0,13
1907846,1501062,2025-02-27,Senate,"Senate Business, Labor, & Technology: Refer House Bill 25-1077 to the Committee of the Whole and with a recommendation that it be placed on the consent calendar.",7,0,0,0,7
1907846,1504496,2025-03-04,Senate,"Senate: Third Reading Bill",33,0,0,1,34
1907849,1483445,2025-02-05,House,"House Health & Human Services: Refer House Bill 25-1068 to the Committee of the Whole.",4,8,0,1,13
1907849,1497458,2025-02-05,House,"House Health & Human Services: Postpone House Bill 25-1068 indefinitely.",8,4,0,1,13
1907852,1477476,2025-01-30,House,"House Education: Adopt amendment L.001",13,0,0,0,13
1907852,1479439,2025-02-04,House,"House: Third Reading Bill",50,12,0,3,65
1907852,1483493,2025-01-30,House,"House Education: Refer House Bill 25-1006, as amended, to the Committee of the Whole.",13,0,0,0,13
1907852,1527896,2025-03-26,Senate,"Senate Education: Refer House Bill 25-1006 to the Committee of the Whole.",4,2,0,1,7
1907852,1537097,2025-04-04,Senate,"Senate: Third Reading Bill",29,6,0,0,35
1907852,1549439,2025-04-15,House,"House: Senate Amendments Not Cncr",58,6,0,1,65
1907852,1557040,2025-04-24,Senate,"Senate: Conference Committee Report Adopt Ccr",32,0,0,3,35
1907852,1557041,2025-04-24,Senate,"Senate: Conference Committee Report Repass",23,9,0,3,35
1907852,1564036,2025-05-01,House,"House: Conference Committee Report Adopt",50,15,0,0,65
1907852,1564037,2025-05-01,House,"House: Conference Committee Report Repass",50,15,0,0,65
1907854,1486770,2025-02-11,House,"House Transportation, Housing & Local Government: Adopt amendment L.007",4,9,0,0,13
1907854,1493913,2025-02-11,House,"House Transportation, Housing & Local Government: Adopt amendment L.006",13,0,0,0,13
1907854,1493914,2025-02-11,House,"House Transportation, Housing & Local Government: Adopt amendment L.009",4,9,0,0,13
1907854,1493915,2025-02-11,House,"House Transportation, Housing & Local Government: Refer House Bill 25-1056, as amended, to the Committee of the Whole.",9,4,0,0,13
1907854,1499917,2025-02-26,House,"House: Committee of the Whole Amd (h.001)",13,51,0,1,65
1907854,1501023,2025-02-27,House,"House: Third Reading Bill",35,28,0,2,65
1907854,1516194,2025-03-12,Senate,"Senate Local Government & Housing: Adopt amendment L.028",7,0,0,0,7
1907854,1519634,2025-03-18,Senate,"Senate: Third Reading Bill",28,5,0,1,34
1907854,1521609,2025-03-12,Senate,"Senate Local Government & Housing: Adopt amendment L.029",7,0,0,0,7
1907854,1521610,2025-03-12,Senate,"Senate Local Government & Housing: Refer House Bill 25-1056, as amended, to the Committee of the Whole.",5,2,0,0,7
1907854,1530177,2025-03-28,House,"House: Senate Amendments Not Cncr",62,1,0,2,65
1907854,1538181,2025-04-07,House,"House: Conference Committee Report Byd Scp",52,7,0,6,65
1907854,1543994,2025-04-10,Senate,"Senate: Conference Committee Report Adopt Ccr",33,0,0,2,35
1907854,1543995,2025-04-10,Senate,"Senate: Conference Committee Report Repass",29,4,0,2,35
1907854,1545969,2025-04-09,Joint,"CC_HB25-1056_2025A: Adopt first draft report on first conference committee on House Bill 25-1056",5,0,0,1,6
1907854,1549430,2025-04-15,House,"House: Conference Committee Report Adopt",47,17,0,1,65
1907854,1549431,2025-04-15,House,"House: Conference Committee Report Repass",41,23,0,1,65
1907863,1476525,2025-01-29,Senate,"Senate Transportation & Energy: Postpone Senate Bill 25-022 indefinitely.",9,0,0,0,9
1907866,1479002,2025-02-03,House,"House Agriculture, Water & Natural Resources: Adopt amendment L.001",13,0,0,0,13
1907866,1483141,2025-02-06,House,"House: Third Reading Bill",45,19,0,1,65
1907866,1486144,2025-02-03,House,"House Agriculture, Water & Natural Resources: Adopt amendment L.002",13,0,0,0,13
1907866,1486145,2025-02-03,House,"House Agriculture, Water & Natural Resources: Adopt amendment L.003",13,0,0,0,13
1907866,1486146,2025-02-03,House,"House Agriculture, Water & Natural Resources: Adopt amendment L.005",9,3,0,1,13
1907866,1486147,2025-02-03,House,"House Agriculture, Water & Natural Resources: Refer House Bill 25-1023, as amended, to the Committee of the Whole.",11,2,0,0,13
1907866,1551651,2025-04-17,Senate,"Senate Agriculture & Natural Resources: Adopt amendment L.007 (Attachment B).",7,0,0,0,7
1907866,1554128,2025-04-17,Senate,"Senate Agriculture & Natural Resources: Refer House Bill 25-1023, as amended, to the Committee of the Whole.",4,3,0,0,7
1907866,1555128,2025-04-23,Senate,"Senate: Third Reading Bill",25,10,0,0,35
1907866,1563874,2025-05-01,House,"House: Senate Amendments Concur",43,20,0,2,65
1907866,1563875,2025-05-01,House,"House: Senate Amendments Repass",42,21,0,2,65
1907872,1494800,2025-02-20,Senate,"Senate Business, Labor, & Technology: Adopt amendment L.001",7,0,0,0,7
1907872,1496595,2025-02-20,Senate,"Senate Business, Labor, & Technology: Refer Senate Bill 25-035, as amended, to the Committee of the Whole and with a recommendation that it be placed on the consent calendar.",7,0,0,0,7
1907872,1498825,2025-02-25,Senate,"Senate: Third Reading Bill",31,1,0,2,34
1907872,1536404,2025-04-03,House,"House Business Affairs & Labor: Refer Senate Bill 25-035 to the Committee of the Whole.",12,0,0,1,13
1907872,1547447,2025-04-14,House,"House: Third Reading Bill",64,0,0,1,65
1907875,1492792,2025-02-18,House,"House Transportation, Housing & Local Government: Adopt amendment L.005 (Attachment E)",13,0,0,0,13
1907875,1497609,2025-02-18,House,"House Transportation, Housing & Local Government: Refer House Bill 25-1007, as amended, to the Committee of the Whole.",12,1,0,0,13
1907875,1498663,2025-02-25,House,"House: Third Reading Bill",44,17,0,4,65
1907875,1521240,2025-03-19,Senate,"Senate Transportation & Energy: Refer House Bill 25-1007 to the Committee of the Whole and with a recommendation that it be placed on the consent calendar.",8,0,0,1,9
1907875,1525849,2025-03-25,Senate,"Senate: Third Reading Bill",33,2,0,0,35
1907879,1475051,2025-01-27,House,"House State, Civic, Military, & Veterans Affairs: Adopt amendment L.001 (Attachment I).",11,0,0,0,11
1907879,1480663,2025-01-27,House,"House State, Civic, Military, & Veterans Affairs: Adopt amendment L.002 (Attachment J).",11,0,0,0,11
1907879,1480664,2025-01-27,House,"House State, Civic, Military, & Veterans Affairs: Postpone House Bill 25-1048 indefinitely using a reversal of the previous roll call. There was no objection to the use of the reverse roll call, therefore, the bill was postponed indefinitely.",6,5,0,0,11
1907879,1480665,2025-01-27,House,"House State, Civic, Military, & Veterans Affairs: Refer House Bill 25-1048, as amended, to the Committee on Appropriations.",5,6,0,0,11
1907885,1477762,2025-01-30,House,"House Business Affairs & Labor: Adopt amendment L.002 (Attachment F)",13,0,0,0,13
1907885,1479449,2025-02-04,House,"House: Third Reading Bill",57,5,0,3,65
1907885,1496458,2025-01-30,House,"House Business Affairs & Labor: Refer House Bill 25-1075, as amended, to the Committee of the Whole.",13,0,0,0,13
1907885,1528943,2025-03-27,Senate,"Senate Business, Labor, & Technology: Adopt amendment L.003",7,0,0,0,7
1907885,1532265,2025-04-01,Senate,"Senate: Third Reading Bill",34,1,0,0,35
1907885,1540389,2025-03-27,Senate,"Senate Business, Labor, & Technology: Refer House Bill 25-1075, as amended, to the Committee of the Whole and with a recommendation that it be placed on the consent calendar.",7,0,0,0,7
1907885,1546028,2025-04-11,House,"House: Senate Amendments Concur",59,3,0,3,65
1907885,1546029,2025-04-11,House,"House: Senate Amendments Repass",55,7,0,3,65
1907888,1474770,2025-01-27,House,"House State, Civic, Military, & Veterans Affairs: Refer House Bill 25-1057 to the Committee on Appropriations.",10,1,0,0,11
1907888,1553360,2025-04-22,House,"House Appropriations: Adopt amendment L.002",11,0,0,0,11
1907888,1555500,2025-04-23,House,"House: Third Reading Bill",57,7,0,1,65
1907888,1559875,2025-04-22,House,"House Appropriations: Refer House Bill 25-1057, as amended, to the Committee of the Whole.",9,2,0,0,11
1907888,1560535,2025-04-29,Senate,"Senate State, Veterans, & Military Affairs: Refer House Bill 25-1057, as amended, to the Committee on Appropriations.",3,0,0,2,5
1907888,1563503,2025-05-01,Senate,"Senate Appropriations: Refer House Bill 25-1057 to the Committee of the Whole and with a recommendation that it be placed on the consent calendar.",7,0,0,0,7
1907888,1564468,2025-05-02,Senate,"Senate: Third Reading Bill",33,1,0,1,35
1907888,1564713,2025-05-02,House,"House: Senate Amendments Concur",61,1,0,3,65
1907888,1564714,2025-05-02,House,"House: Senate Amendments Repass",57,5,0,3,65
1907888,1567052,2025-04-29,Senate,"Senate State, Veterans, & Military Affairs: Refer House Bill 25-1057, as amended, to the Committee on Appropriations.",3,0,0,2,5
1907892,1516402,2025-03-12,Senate,"Senate Transportation & Energy: Adopt amendment L.001",9,0,0,0,9
1907892,1545693,2025-04-11,Senate,"Senate Appropriations: Refer Senate Bill 25-030 to the Committee of the Whole.",4,3,0,0,7
1907892,1547364,2025-03-12,Senate,"Senate Transportation & Energy: Adopt amendment L.002",9,0,0,0,9
1907892,1547366,2025-03-12,Senate,"Senate Transportation & Energy: Refer Senate Bill 25-030, as amended, to the Committee on Appropriations.",6,3,0,0,9
1907892,1553398,2025-04-22,Senate,"Senate: Third Reading Bill",22,13,0,0,35
1907892,1559324,2025-04-28,House,"House Transportation, Housing & Local Government: Refer Senate Bill 25-030 to the Committee of the Whole.",8,5,0,0,13
1907892,1563487,2025-05-01,House,"House: Third Reading Bill",40,23,0,2,65
1907898,1473321,2025-01-22,House,"House Transportation, Housing & Local Government: Adopt amendment L.001",12,0,0,0,12
1907898,1474228,2025-01-24,House,"House: Committee of the Whole Amd (h.001)",19,40,0,5,64
1907898,1474695,2025-01-27,House,"House: Third Reading Bill",58,4,0,3,65
1907898,1474880,2025-01-22,House,"House Transportation, Housing & Local Government: Adopt amendment L.002",12,0,0,0,12
1907898,1474881,2025-01-22,House,"House Transportation, Housing & Local Government: Adopt amendment L.003",12,0,0,0,12
1907898,1474882,2025-01-22,House,"House Transportation, Housing & Local Government: Refer House Bill 25-1076, as amended, to the Committee of the Whole.",12,0,0,0,12
1907898,1482465,2025-02-05,Senate,"Senate Transportation & Energy: Adopt amendment L.005",9,0,0,0,9
1907898,1484575,2025-02-05,Senate,"Senate Transportation & Energy: Refer House Bill 25-1076, as amended, to the Committee of the Whole and with a recommendation that it be placed on the consent calendar.",8,0,0,1,9
1907898,1484576,2025-02-10,Senate,"Senate: Third Reading Bill",33,0,0,2,35
1907898,1492009,2025-02-18,House,"House: Senate Amendments Concur",56,8,0,1,65
1907898,1492010,2025-02-18,House,"House: Senate Amendments Repass",52,12,0,1,65
1907900,1486432,2025-02-11,Senate,"Senate Finance: Adopt amendment L.001 (Attachment B)",9,0,0,0,9
1907900,1490146,2025-02-11,Senate,"Senate Finance: Refer Senate Bill 25-028, as amended, to the Committee of the Whole and with a recommendation that it be placed on the consent calendar.",9,0,0,0,9
1907900,1491751,2025-02-18,Senate,"Senate: Third Reading Bill",34,0,0,0,34
1907900,1503611,2025-03-03,House,"House Finance: Refer Senate Bill 25-028 to the Committee of the Whole.",13,0,0,0,13
1907900,1509190,2025-03-10,House,"House: Third Reading Bill",62,0,0,3,65
1907903,1479668,2025-02-04,Senate,"Senate Finance: Postpone Senate Bill 25-025 indefinitely.",8,0,0,1,9
1907907,1497915,2025-02-24,Senate,"Senate Judiciary: Adopt amendment L.001 (Attachment B)",7,0,0,0,7
1907907,1500329,2025-02-24,Senate,"Senate Judiciary: Adopt amendment L.002 (Attachment C)",7,0,0,0,7
1907907,1500330,2025-02-24,Senate,"Senate Judiciary: Adopt amendment L.003 (Attachment D)",7,0,0,0,7
1907907,1500331,2025-02-24,Senate,"Senate Judiciary: Adopt amendment L.004 (Attachment E)",7,0,0,0,7
1907907,1500332,2025-02-24,Senate,"Senate Judiciary: Adopt amendment L.005 (Attachment F)",7,0,0,0,7
1907907,1500333,2025-02-24,Senate,"Senate Judiciary: Refer Senate Bill 25-043, as amended, to the Committee on Appropriations.",5,2,0,0,7
1907914,1475059,2025-01-27,House,"House Agriculture, Water & Natural Resources: Postpone House Bill 25-1064 indefinitely.",13,0,0,0,13
1907917,1477766,2025-01-30,House,"House Business Affairs & Labor: Refer House Bill 25-1001 to the Committee on Finance.",8,5,0,0,13
1907917,1497822,2025-02-24,House,"House Finance: Adopt amendment L.005 (Attachment B).",10,1,0,2,13
1907917,1500169,2025-02-24,House,"House Finance: Adopt amendment L.008 (Attachment C). The motion was withdrawn.",0,0,12,1,13
1907917,1500170,2025-02-24,House,"House Finance: Adopt amendment L.011 (Attachment D).",13,0,0,0,13
1907917,1500171,2025-02-24,House,"House Finance: Adopt amendment L.012 (Attachment E).",13,0,0,0,13
1907917,1500172,2025-02-24,House,"House Finance: Refer House Bill 25-1001, as amended, to the Committee on Appropriations.",8,5,0,0,13
1907917,1526015,2025-03-25,House,"House Appropriations: Adopt amendment J.001",11,0,0,0,11
1907917,1534027,2025-04-02,House,"House: Third Reading Bill",42,22,0,1,65
1907917,1537177,2025-03-25,House,"House Appropriations: Refer House Bill 25-1001, as amended, to the Committee of the Whole.",6,3,0,2,11
1907917,1551201,2025-04-17,Senate,"Senate Business, Labor, & Technology: Refer House Bill 25-1001 to the Committee on Appropriations.",4,3,0,0,7
1907917,1561829,2025-04-30,Senate,"Senate Appropriations: Adopt amendment J.003",4,3,0,0,7
1907917,1561830,2025-04-30,Senate,"Senate Appropriations: Refer House Bill 25-1001, as amended, to the Committee of the Whole.",4,3,0,0,7
1907917,1565927,2025-05-06,Senate,"Senate: Third Reading Amend (l.041)",35,0,0,0,35
1907917,1565928,2025-05-06,Senate,"Senate: Third Reading Bill",23,12,0,0,35
1907917,1567165,2025-05-07,House,"House: Senate Amendments Concur",41,22,0,2,65
1907917,1567166,2025-05-07,House,"House: Senate Amendments Repass",41,22,0,2,65
1907921,1487918,2025-02-12,House,"House Judiciary: Adopt amendment L.005",11,0,0,0,11
1907921,1509588,2025-03-10,House,"House Finance: Postpone House Bill 25-1028 indefinitely.",12,0,0,1,13
1907921,1517320,2025-02-12,House,"House Judiciary: Adopt amendment L.004",10,1,0,0,11
1907921,1517321,2025-02-12,House,"House Judiciary: Refer House Bill 25-1028, as amended, to the Committee on Finance.",7,4,0,0,11
1907926,1493815,2025-02-19,House,"House Transportation, Housing & Local Government: Adopt amendment L.004 (Attachment H)",13,0,0,0,13
1907926,1502286,2025-02-28,House,"House: Third Reading Amd (l.007)",58,3,0,4,65
1907926,1502287,2025-02-28,House,"House: Third Reading Bill",38,23,0,4,65
1907926,1502288,2025-02-28,House,"House: Third Reading Perm",54,7,0,4,65
1907926,1521738,2025-02-19,House,"House Transportation, Housing & Local Government: Adopt amendment L.001 (Attachment J)",13,0,0,0,13
1907926,1521739,2025-02-19,House,"House Transportation, Housing & Local Government: Adopt amendment L.003 (Attachment I)",0,0,13,0,13
1907926,1521740,2025-02-19,House,"House Transportation, Housing & Local Government: Adopt amendment L.006 (Attachment K)",13,0,0,0,13
1907926,1521741,2025-02-19,House,"House Transportation, Housing & Local Government: Refer House Bill 25-1060, as amended, to the Committee of the Whole.",7,5,0,1,13
1907926,1529270,2025-03-27,Senate,"Senate Local Government & Housing: Refer House Bill 25-1060 to the Committee of the Whole.",4,3,0,0,7
1907926,1537184,2025-04-04,Senate,"Senate: Third Reading Bill",21,14,0,0,35
1907930,1499499,2025-02-25,Senate,"Senate State, Veterans, & Military Affairs: Refer Senate Bill 25-047 to the Committee of the Whole.",2,3,0,0,5
1907930,1514610,2025-02-25,Senate,"Senate State, Veterans, & Military Affairs: Postpone Senate Bill 25-047 indefinitely using a reversal of the previous roll call. There was no objection to the use of the reverse roll call, therefore, the bill was postponed indefinitely.",3,2,0,0,5
1907935,1473427,2025-01-22,House,"House Judiciary: Refer House Bill 25-1015 to the Committee of the Whole.",11,0,0,0,11
1907935,1475063,2025-01-27,House,"House: Third Reading Bill",62,0,0,3,65
1907935,1516499,2025-03-12,Senate,"Senate Judiciary: Refer House Bill 25-1015 to the Committee of the Whole.",6,1,0,0,7
1907935,1519683,2025-03-18,Senate,"Senate: Third Reading Bill",32,1,0,1,34
1907938,1475113,2025-01-27,House,"House Finance: Refer House Bill 25-1045 to the Committee on Appropriations.",4,9,0,0,13
1907938,1486978,2025-01-27,House,"House Finance: Postpone House Bill 25-1045 indefinitely using a reversal of the previous roll call. There was no objection to the use of the reverse roll call, therefore, the bill was postponed indefinitely.",9,4,0,0,13
1907939,1476306,2025-01-29,House,"House Health & Human Services: Refer House Bill 25-1024 to the Committee of the Whole.",13,0,0,0,13
1907939,1478928,2025-02-03,House,"House: Third Reading Bill",60,4,0,1,65
1907939,1521245,2025-03-19,Senate,"Senate Health & Human Services: Refer House Bill 25-1024 to the Committee of the Whole.",7,2,0,0,9
1907939,1525834,2025-03-25,Senate,"Senate: Third Reading Bill",30,5,0,0,35
1907945,1473252,2025-01-22,House,"House Judiciary: Adopt amendment L.001 (Attachment B)",11,0,0,0,11
1907945,1516070,2025-01-22,House,"House Judiciary: Refer House Bill 25-1049, as amended, to the Committee on Appropriations.",9,1,0,1,11
1907945,1537009,2025-04-04,House,"House Appropriations: Adopt amendment L.002",11,0,0,0,11
1907945,1537897,2025-04-04,House,"House Appropriations: Refer House Bill 25-1049, as amended, to the Committee of the Whole.",9,2,0,0,11
1907945,1548151,2025-04-15,House,"House: Third Reading Bill",44,17,0,4,65
1907945,1555552,2025-04-23,Senate,"Senate Judiciary: Refer House Bill 25-1049 to the Committee of the Whole and with a recommendation that it be placed on the consent calendar.",7,0,0,0,7
1907945,1558825,2025-04-28,Senate,"Senate: Third Reading Bill",26,8,0,1,35
1907948,1477471,2025-01-30,Senate,"Senate Agriculture & Natural Resources: Postpone Senate Bill 25-021 indefinitely.",6,0,0,1,7
1907957,1515801,2025-03-12,Senate,"Senate Health & Human Services: Adopt amendment L.001 (Attachment B).",9,0,0,0,9
1907957,1529382,2025-03-12,Senate,"Senate Health & Human Services: Adopt amendment L.002 (Attachment D).",9,0,0,0,9
1907957,1529383,2025-03-12,Senate,"Senate Health & Human Services: Refer Senate Bill 25-017, as amended, to the Committee on Appropriations.",7,2,0,0,9
1907957,1559862,2025-04-29,Senate,"Senate Appropriations: Adopt amendment L.005",7,0,0,0,7
1907957,1559863,2025-04-29,Senate,"Senate Appropriations: Refer Senate Bill 25-017, as amended, to the Committee of the Whole.",6,1,0,0,7
1907957,1561856,2025-04-30,Senate,"Senate: Third Reading Bill",25,10,0,0,35
1907957,1564779,2025-05-03,House,"House Health & Human Services: Refer Senate Bill 25-017 to the Committee of the Whole.",10,2,0,1,13
1907957,1565067,2025-05-05,House,"House: Third Reading Bill",42,22,0,1,65
1907959,1526599,2025-03-25,House,"House Judiciary: Adopt amendment L.001 (Attachment D)",11,0,0,0,11
1907959,1531395,2025-03-31,House,"House: Third Reading Bill",63,0,0,2,65
1907959,1541798,2025-04-09,Senate,"Senate Judiciary: Adopt amendment L.022 (Attachment D)",7,0,0,0,7
1907959,1546036,2025-04-09,Senate,"Senate Judiciary: Refer House Bill 25-1031, as amended, to the Committee of the Whole and with a recommendation that it be placed on the consent calendar.",7,0,0,0,7
1907959,1546891,2025-04-14,Senate,"Senate: Third Reading Bill",33,0,0,2,35
1907959,1549454,2025-04-15,House,"House: Senate Amendments Concur",63,1,0,1,65
1907959,1549455,2025-04-15,House,"House: Senate Amendments Repass",64,0,0,1,65
1907959,1552526,2025-03-25,House,"House Judiciary: Adopt amendment L.006 (Attachment E)",11,0,0,0,11
1907959,1552527,2025-03-25,House,"House Judiciary: Adopt amendment L.007 (Attachment J)",11,0,0,0,11
1907959,1552528,2025-03-25,House,"House Judiciary: Adopt amendment L.009 (Attachment F)",11,0,0,0,11
1907959,1552529,2025-03-25,House,"House Judiciary: Adopt amendment L.012 (Attachment K)",11,0,0,0,11
1907959,1552530,2025-03-25,House,"House Judiciary: Adopt amendment L.014 (Attachment G)",11,0,0,0,11
1907959,1552531,2025-03-25,House,"House Judiciary: Adopt amendment L.015 (Attachment H)",11,0,0,0,11
1907959,1552532,2025-03-25,House,"House Judiciary: Adopt amendment L.016 (Attachment I)",11,0,0,0,11
1907959,1552533,2025-03-25,House,"House Judiciary: Adopt amendment L.018 (Attachment L)",11,0,0,0,11
1907959,1552534,2025-03-25,House,"House Judiciary: Refer House Bill 25-1031, as amended, to the Committee of the Whole.",9,2,0,0,11
1907962,1476267,2025-01-29,House,"House Business Affairs & Labor: Refer House Bill 25-1005 to the Committee on Finance.",12,1,0,0,13
1907962,1483318,2025-02-06,House,"House Finance: Adopt amendment L.008 (Attachment C).",13,0,0,0,13
1907962,1484707,2025-02-06,House,"House Finance: Adopt amendment L.001 (Attachment A), as amended.",13,0,0,0,13
1907962,1484708,2025-02-06,House,"House Finance: Adopt amendment L.002 (Attachment B).",13,0,0,0,13
1907962,1484709,2025-02-06,House,"House Finance: Adopt amendment L.009 (Attachment D).",13,0,0,0,13
1907962,1484710,2025-02-06,House,"House Finance: Refer House Bill 25-1005, as amended, to the Committee on Appropriations.",7,6,0,0,13
1907962,1508433,2025-03-07,House,"House Appropriations: Refer House Bill 25-1005 to the Committee of the Whole.",8,2,0,1,11
1907962,1516209,2025-03-12,House,"House: Committee of the Whole Amd (h.002)",19,42,0,4,65
1907962,1516210,2025-03-12,House,"House: Committee of the Whole Amd (h.004)",19,42,0,4,65
1907962,1516211,2025-03-12,House,"House: Committee of the Whole Amd (h.005)",20,41,0,4,65
1907962,1516979,2025-03-13,House,"House: Third Reading Bill",43,17,0,5,65
1907962,1525838,2025-03-25,Senate,"Senate Finance: Refer House Bill 25-1005 to the Committee on Appropriations.",7,2,0,0,9
1907962,1527216,2025-03-26,Senate,"Senate Appropriations: Refer House Bill 25-1005 to the Committee of the Whole.",4,2,0,1,7
1907962,1528660,2025-03-27,Senate,"Senate: Committee of the Whole Adopt Report",34,0,0,1,35
1907962,1529858,2025-03-28,Senate,"Senate: Third Reading Bill",28,5,0,2,35
1907966,1485033,2025-02-10,House,"House Agriculture, Water & Natural Resources: Adopt amendment L.001",13,0,0,0,13
1907966,1500391,2025-02-10,House,"House Agriculture, Water & Natural Resources: Refer House Bill 25-1078, as amended, to the Committee on Appropriations.",9,4,0,0,13
1907966,1557949,2025-04-25,House,"House Appropriations: Adopt amendment L.011",11,0,0,0,11
1907966,1559053,2025-04-28,House,"House: Third Reading Bill",37,27,0,1,65
1907966,1559054,2025-04-28,House,"House: Third Reading Refer (fin)",28,37,0,0,65
1907966,1560214,2025-04-25,House,"House Appropriations: Adopt amendment L.005",6,5,0,0,11
1907966,1560215,2025-04-25,House,"House Appropriations: Refer House Bill 25-1078, as amended, to the Committee of the Whole.",6,5,0,0,11
1907966,1563776,2025-05-01,Senate,"Senate Agriculture & Natural Resources: Refer House Bill 25-1078, as amended, to the Committee on Appropriations.",7,0,0,0,7
1907966,1566224,2025-05-06,Senate,"Senate Appropriations: Postpone House Bill 25-1078 indefinitely using a reversal of the previous roll call. There was no objection to the use of the reverse roll call, therefore, the bill was postponed indefinitely.",4,3,0,0,7
1907966,1566225,2025-05-06,Senate,"Senate Appropriations: Refer House Bill 25-1078 to the Committee of the Whole.",3,4,0,0,7
1907970,1484950,2025-02-10,House,"House State, Civic, Military, & Veterans Affairs: Postpone House Bill 25-1047 indefinitely.",11,0,0,0,11
1907976,1472633,2025-01-21,House,"House Judiciary: Refer House Bill 25-1008 to the Committee on Appropriations.",6,5,0,0,11
1907980,1477487,2025-01-30,Senate,"Senate Local Government & Housing: Refer Senate Bill 25-023 to the Committee of the Whole and with a recommendation that it be placed on the consent calendar.",7,0,0,0,7
1907980,1482620,2025-02-05,Senate,"Senate: Third Reading Bill",35,0,0,0,35
1907980,1521639,2025-03-19,House,"House Transportation, Housing & Local Government: Refer Senate Bill 25-023 to the Committee of the Whole.",11,0,0,2,13
1907980,1526081,2025-03-25,House,"House: Third Reading Bill",58,1,0,6,65
1907983,1492056,2025-02-18,House,"House Judiciary: Adopt amendment L.002",11,0,0,0,11
1907983,1519002,2025-02-18,House,"House Judiciary: Refer House Bill 25-1062, as amended, to the Committee on Appropriations.",6,5,0,0,11
1907983,1537024,2025-04-04,House,"House Appropriations: Adopt amendment J.001",11,0,0,0,11
1907983,1537892,2025-04-04,House,"House Appropriations: Refer House Bill 25-1062, as amended, to the Committee of the Whole.",9,2,0,0,11
1907983,1545965,2025-04-11,House,"House: Third Reading Bill",50,12,0,3,65
1907983,1555147,2025-04-22,Senate,"Senate State, Veterans, & Military Affairs: Refer House Bill 25-1062 to the Committee on Appropriations.",3,2,0,0,5
1907983,1559893,2025-04-29,Senate,"Senate Appropriations: Adopt amendment J.002",7,0,0,0,7
1907983,1559894,2025-04-29,Senate,"Senate Appropriations: Refer House Bill 25-1062, as amended, to the Committee of the Whole.",6,1,0,0,7
1907983,1562250,2025-04-30,Senate,"Senate: Third Reading Bill",28,7,0,0,35
1907983,1563913,2025-05-01,House,"House: Senate Amendments Concur",58,7,0,0,65
1907983,1563914,2025-05-01,House,"House: Senate Amendments Repass",54,11,0,0,65
1907987,1487819,2025-02-12,House,"House Transportation, Housing & Local Government: Postpone House Bill 25-1044 indefinitely.",10,0,0,3,13
1907990,1483481,2025-02-06,Senate,"Senate Health & Human Services: Adopt amendment L.001 (Attachment E).",9,0,0,0,9
1907990,1502442,2025-02-06,Senate,"Senate Health & Human Services: Postpone Senate Bill 25-032 indefinitely using a reversal of the previous roll call. There was no objection to the use of the reverse roll call, therefore, the bill was postponed indefinitely.",6,3,0,0,9
1907990,1502443,2025-02-06,Senate,"Senate Health & Human Services: Refer Senate Bill 25-032, as amended, to the Committee of the Whole.",3,6,0,0,9
1907993,1489754,2025-02-13,House,"House Education: Adopt amendment L.001",13,0,0,0,13
1907993,1496689,2025-02-13,House,"House Education: Adopt amendment L.002",13,0,0,0,13
1907993,1496690,2025-02-13,House,"House Education: Adopt amendment L.003",13,0,0,0,13
1907993,1496691,2025-02-13,House,"House Education: Refer House Bill 25-1038, as amended, to the Committee on Appropriations.",11,0,0,2,13
1907993,1556448,2025-04-24,House,"House Appropriations: Refer House Bill 25-1038 to the Committee of the Whole.",10,1,0,0,11
1907993,1557975,2025-04-25,House,"House: Third Reading Bill",55,8,0,2,65
1907993,1562938,2025-04-30,Senate,"Senate Education: Refer House Bill 25-1038 to the Committee of the Whole and with a recommendation that it be placed on the consent calendar.",7,0,0,0,7
1907993,1564471,2025-05-02,Senate,"Senate: Third Reading Bill",34,0,0,1,35
1907998,1475726,2025-01-28,House,"House Judiciary: Refer House Bill 25-1050 to the Committee of the Whole.",10,0,0,1,11
1907998,1478871,2025-02-03,House,"House: Third Reading Bill",59,5,0,1,65
1907998,1497942,2025-02-24,Senate,"Senate Judiciary: Refer House Bill 25-1050 to the Committee of the Whole and with a recommendation that it be placed on the consent calendar.",7,0,0,0,7
1907998,1502350,2025-02-28,Senate,"Senate: Third Reading Bill",29,0,0,5,34
1908002,1489347,2025-02-13,House,"House Education: Adopt amendment L.001",13,0,0,0,13
1908002,1496706,2025-02-13,House,"House Education: Adopt amendment L.002",13,0,0,0,13
1908002,1496707,2025-02-13,House,"House Education: Adopt amendment L.004",13,0,0,0,13
1908002,1496708,2025-02-13,House,"House Education: Refer House Bill 25-1061, as amended, to the Committee on Appropriations.",13,0,0,0,13
1908002,1557956,2025-04-25,House,"House Appropriations: Adopt amendment J.001",11,0,0,0,11
1908002,1559026,2025-04-28,House,"House: Third Reading Bill",52,12,0,1,65
1908002,1560180,2025-04-25,House,"House Appropriations: Adopt amendment L.005",11,0,0,0,11
1908002,1560181,2025-04-25,House,"House Appropriations: Refer House Bill 25-1061, as amended, to the Committee of the Whole.",8,3,0,0,11
1908002,1563557,2025-05-01,Senate,"Senate Appropriations: Refer House Bill 25-1061 to the Committee of the Whole.",6,1,0,0,7
1908002,1564464,2025-05-02,Senate,"Senate: Third Reading Bill",32,2,0,1,35
1908005,1477469,2025-01-30,House,"House Business Affairs & Labor: Adopt amendment L.001",13,0,0,0,13
1908005,1496401,2025-01-30,House,"House Business Affairs & Labor: Adopt amendment L.002",8,5,0,0,13
1908005,1496402,2025-01-30,House,"House Business Affairs & Labor: Refer House Bill 25-1020, as amended, to the Committee on Finance.",11,2,0,0,13
1908005,1501279,2025-02-27,House,"House Finance: Postpone House Bill 25-1020 indefinitely.",12,1,0,0,13
1908008,1495492,2025-02-20,House,"House Business Affairs & Labor: Adopt amendment L.001",13,0,0,0,13
1908008,1505062,2025-02-20,House,"House Business Affairs & Labor: Refer House Bill 25-1004, as amended, to the Committee of the Whole.",7,5,0,1,13
1908008,1527615,2025-03-26,House,"House: Third Reading Bill",43,22,0,0,65
1908008,1549162,2025-04-15,Senate,"Senate Business, Labor, & Technology: Refer House Bill 25-1004, as amended, to the Committee of the Whole.",3,2,0,2,7
1908008,1558937,2025-04-28,Senate,"Senate: Third Reading Bill",22,12,0,1,35
1908008,1563941,2025-05-01,House,"House: Senate Amendments Concur",42,21,0,2,65
1908008,1563942,2025-05-01,House,"House: Senate Amendments Repass",42,21,0,2,65
1908011,1475759,2025-01-28,House,"House Health & Human Services: Adopt amendment L.001 (Attachment H).",13,0,0,0,13
1908011,1478911,2025-02-03,House,"House: Third Reading Bill",64,0,0,1,65
1908011,1497616,2025-01-28,House,"House Health & Human Services: Adopt amendment L.002 (Attachment I).",13,0,0,0,13
1908011,1497617,2025-01-28,House,"House Health & Human Services: Refer House Bill 25-1003, as amended, to the Committee of the Whole.",13,0,0,0,13
1908011,1516126,2025-03-12,Senate,"Senate Health & Human Services: Refer House Bill 25-1003 to the Committee of the Whole and with a recommendation that it be placed on the consent calendar.",8,0,0,1,9
1908011,1519356,2025-03-18,Senate,"Senate: Third Reading Bill",33,0,0,1,34
1908964,1471220,2025-01-09,Senate,"Senate: Consideration of Resolutions Resolution",31,0,0,1,32
1909208,1471221,2025-01-09,Senate,"Senate: Consideration of Resolutions Resolution",31,0,0,1,32
1909208,1471314,2025-01-13,House,"House: RESOLUTIONS Amd (l.001)",63,0,0,1,64
1909208,1471315,2025-01-13,House,"House: RESOLUTIONS Res",63,0,0,1,64
1909208,1471583,2025-01-14,Senate,"Senate: House Amendments Concur",31,0,0,4,35
1909208,1471584,2025-01-14,Senate,"Senate: House Amendments Repass",31,0,0,4,35
1909446,1471312,2025-01-13,House,"House: RESOLUTIONS Res",63,0,0,1,64
1912353,1471425,2025-01-14,House,"House Health & Human Services: Refer House Bill 25-1033 to the Committee of the Whole.",13,0,0,0,13
1912353,1473987,2025-01-23,House,"House: Third Reading Bill",55,7,0,2,64
1912353,1483556,2025-02-06,Senate,"Senate Health & Human Services: Refer House Bill 25-1033 to the Committee of the Whole.",8,1,0,0,9
1912353,1487523,2025-02-12,Senate,"Senate: Third Reading Bill",28,5,0,2,35
1915999,1493111,2025-02-19,House,"House Business Affairs & Labor: Adopt amendment L.001",13,0,0,0,13
1915999,1495347,2025-02-19,House,"House Business Affairs & Labor: Refer House Bill 25-1080, as amended, to the Committee on Finance.",12,1,0,0,13
1915999,1522696,2025-03-20,House,"House Finance: Adopt amendment L.005 (Attachment A).",13,0,0,0,13
1915999,1531372,2025-03-31,House,"House: Third Reading Bill",52,12,0,1,65
1915999,1544162,2025-03-20,House,"House Finance: Refer House Bill 25-1080, as amended, to the Committee of the Whole.",12,0,0,1,13
1915999,1544163,2025-04-10,Senate,"Senate Business, Labor, & Technology: Refer House Bill 25-1080 to the Committee of the Whole.",6,1,0,0,7
1915999,1548660,2025-04-15,Senate,"Senate: Third Reading Bill",25,9,0,1,35
1916100,1471754,2025-01-15,House,"House: RESOLUTIONS Amd (l.001)",59,0,0,5,64
1916100,1471755,2025-01-15,House,"House: RESOLUTIONS Res",60,0,0,4,64
1916100,1471911,2025-01-16,Senate,"Senate: Consideration of Resolutions Resolution",32,0,0,3,35
1916202,1474992,2025-01-27,House,"House Agriculture, Water & Natural Resources: Referred to Full House for final action.",13,0,0,0,13
1916202,1476231,2025-01-29,House,"House: RESOLUTIONS Res",64,0,0,1,65
1916202,1483545,2025-02-06,Senate,"Senate Agriculture & Natural Resources: Referred to Full Senate for final action.",7,0,0,0,7
1916202,1486850,2025-02-11,Senate,"Senate: Consideration of Resolutions Resolution",33,0,0,2,35
1916303,1475724,2025-01-28,House,"House Judiciary: Adopt amendment L.001 (Attachment A)",11,0,0,0,11
1916303,1477335,2025-01-30,House,"House: Committee of the Whole Amd (h.001)",65,0,0,0,65
1916303,1478945,2025-02-03,House,"House: Third Reading Bill",44,20,0,1,65
1916303,1498023,2025-02-24,Senate,"Senate Judiciary: Refer House Bill 25-1081 to the Committee of the Whole and with a recommendation that it be placed on the consent calendar.",7,0,0,0,7
1916303,1502194,2025-02-28,Senate,"Senate: Third Reading Bill",20,9,0,5,34
1916303,1516944,2025-01-28,House,"House Judiciary: Adopt amendment L.003 (Attachment B)",11,0,0,0,11
1916303,1516945,2025-01-28,House,"House Judiciary: Refer House Bill 25-1081, as amended, to the Committee of the Whole.",7,4,0,0,11
1916405,1476698,2025-01-29,House,"House Transportation, Housing & Local Government: Adopt amendment L.001",7,4,0,1,12
1916405,1479078,2025-01-29,House,"House Transportation, Housing & Local Government: Refer House Bill 25-1079, as amended, to the Committee on Appropriations.",7,4,0,1,12
1916405,1553535,2025-04-22,House,"House Appropriations: Adopt amendment J.001",11,0,0,0,11
1916405,1559492,2025-04-28,House,"House: Third Reading Bill",41,23,0,1,65
1916405,1560757,2025-04-22,House,"House Appropriations: Refer House Bill 25-1079, as amended, to the Committee of the Whole.",7,4,0,0,11
1916405,1564047,2025-05-01,Senate,"Senate State, Veterans, & Military Affairs: Refer House Bill 25-1079 to the Committee on Appropriations.",3,2,0,0,5
1916506,1476247,2025-01-29,Senate,"Senate Agriculture & Natural Resources: Refer Senate Bill 25-049 to the Committee on Appropriations.",6,1,0,0,7
1916506,1527271,2025-03-26,Senate,"Senate Appropriations: Refer Senate Bill 25-049 to the Committee of the Whole.",6,1,0,0,7
1916506,1531138,2025-03-31,Senate,"Senate: Third Reading Bill",31,3,0,1,35
1916506,1536455,2025-04-03,House,"House Agriculture, Water & Natural Resources: Refer Senate Bill 25-049 to the Committee on Finance.",13,0,0,0,13
1916506,1552747,2025-04-21,House,"House Finance: Refer Senate Bill 25-049 to the Committee on Appropriations.",12,1,0,0,13
1916506,1556412,2025-04-24,House,"House Appropriations: Refer Senate Bill 25-049 to the Committee of the Whole.",10,0,0,1,11
1916506,1562356,2025-04-30,House,"House: Third Reading Bill",57,8,0,0,65
1916604,1513306,2025-03-11,Senate,"Senate State, Veterans, & Military Affairs: Adopt amendment L.006 (Attachment A).",5,0,0,0,5
1916604,1524121,2025-03-11,Senate,"Senate State, Veterans, & Military Affairs: Adopt amendment L.007 (Attachment B).",5,0,0,0,5
1916604,1524122,2025-03-11,Senate,"Senate State, Veterans, & Military Affairs: Refer Senate Bill 25-050, as amended, to the Committee on Appropriations.",3,1,0,1,5
1916604,1553497,2025-04-22,Senate,"Senate Appropriations: Refer Senate Bill 25-050 to the Committee of the Whole.",4,3,0,0,7
1916604,1558167,2025-04-25,Senate,"Senate: Third Reading Bill",23,12,0,0,35
1916604,1561058,2025-04-29,House,"House State, Civic, Military, & Veterans Affairs: Refer Senate Bill 25-050 to the Committee on Appropriations.",8,2,0,1,11
1916604,1563456,2025-05-01,House,"House Appropriations: Refer Senate Bill 25-050 to the Committee of the Whole.",7,4,0,0,11
1916604,1564557,2025-05-02,House,"House: Third Reading Amd (l.010)",22,42,0,1,65
1916604,1564558,2025-05-02,House,"House: Third Reading Bill",42,22,0,1,65
1916604,1564559,2025-05-02,House,"House: Third Reading Perm",23,40,0,2,65
1916604,1564560,2025-05-02,House,"House: Third Reading Perm",22,41,0,2,65
1916604,1564561,2025-05-02,House,"House: Third Reading Perm",22,41,0,2,65
1916604,1564562,2025-05-02,House,"House: Third Reading Perm",55,9,0,1,65
1917010,1471346,2025-01-14,Senate,"Senate: Consideration of Resolutions Resolution",31,0,0,4,35
1917010,1471717,2025-01-15,House,"House: RESOLUTIONS Res",60,0,0,4,64
1919064,1479065,2025-02-03,House,"House State, Civic, Military, & Veterans Affairs: Adopt amendment L.001 (Attachment B).",0,0,11,0,11
1919064,1483917,2025-02-03,House,"House State, Civic, Military, & Veterans Affairs: Adopt amendment L.002 (Attachment C).",11,0,0,0,11
1919064,1483918,2025-02-03,House,"House State, Civic, Military, & Veterans Affairs: Adopt amendment L.003 (Attachment D).",11,0,0,0,11
1919064,1483919,2025-02-03,House,"House State, Civic, Military, & Veterans Affairs: Refer House Bill 25-1082, as amended, to the Committee on Appropriations.",11,0,0,0,11
1919064,1526023,2025-03-25,House,"House Appropriations: Adopt amendment J.001",11,0,0,0,11
1919064,1531327,2025-03-31,House,"House: Third Reading Bill",64,0,0,1,65
1919064,1537278,2025-03-25,House,"House Appropriations: Refer House Bill 25-1082, as amended, to the Committee of the Whole.",10,0,0,1,11
1919064,1551590,2025-04-17,Senate,"Senate State, Veterans, & Military Affairs: Refer House Bill 25-1082 to the Committee on Appropriations.",4,0,0,1,5
1919064,1559808,2025-04-29,Senate,"Senate Appropriations: Refer House Bill 25-1082 to the Committee of the Whole and with a recommendation that it be placed on the consent calendar.",7,0,0,0,7
1919064,1561751,2025-04-30,Senate,"Senate: Third Reading Bill",35,0,0,0,35
1919986,1523433,2025-03-20,Senate,"Senate Agriculture & Natural Resources: Adopt amendment L.001 (Attachment E).",7,0,0,0,7
1919986,1531176,2025-03-20,Senate,"Senate Agriculture & Natural Resources: Adopt amendment L.003 (Attachment F).",7,0,0,0,7
1919986,1531177,2025-03-20,Senate,"Senate Agriculture & Natural Resources: Refer Senate Bill 25-053, as amended, to the Committee on Appropriations.",4,3,0,0,7
1919986,1545629,2025-04-11,Senate,"Senate Appropriations: Adopt amendment J.001",7,0,0,0,7
1919986,1545630,2025-04-11,Senate,"Senate Appropriations: Refer Senate Bill 25-053, as amended, to the Committee of the Whole.",4,3,0,0,7
1919986,1551031,2025-04-17,Senate,"Senate: Third Reading Bill",24,11,0,0,35
1919986,1552724,2025-04-21,House,"House Agriculture, Water & Natural Resources: Refer Senate Bill 25-053 to the Committee on Appropriations.",8,5,0,0,13
1919986,1557971,2025-04-25,House,"House Appropriations: Refer Senate Bill 25-053 to the Committee of the Whole.",7,4,0,0,11
1919986,1559041,2025-04-28,House,"House: Third Reading Bill",40,24,0,1,65
1920240,1476589,2025-01-29,Senate,"Senate Transportation & Energy: Refer Senate Bill 25-051 to the Committee of the Whole and with a recommendation that it be placed on the consent calendar.",9,0,0,0,9
1920240,1479505,2025-02-04,Senate,"Senate: Third Reading Bill",35,0,0,0,35
1920240,1521131,2025-03-19,House,"House Transportation, Housing & Local Government: Refer Senate Bill 25-051 to the Committee of the Whole.",11,0,0,2,13
1920240,1526085,2025-03-25,House,"House: Third Reading Bill",60,1,0,4,65
1920504,1476593,2025-01-29,Senate,"Senate Transportation & Energy: Refer Senate Bill 25-052, as amended, to the Committee of the Whole.",7,2,0,0,9
1920504,1479418,2025-02-04,Senate,"Senate: Third Reading Bill",23,12,0,0,35
1920504,1499110,2025-02-25,House,"House Transportation, Housing & Local Government: Refer Senate Bill 25-052 to the Committee of the Whole.",8,3,0,2,13
1920504,1502275,2025-02-28,House,"House: Third Reading Bill",41,19,0,5,65
1920847,1479367,2025-02-03,House,"House Agriculture, Water & Natural Resources: Refer House Bill 25-1084 to the Committee of the Whole.",11,1,0,1,13
1920847,1483110,2025-02-06,House,"House: Third Reading Bill",48,15,0,2,65
1920847,1500545,2025-02-26,Senate,"Senate Agriculture & Natural Resources: Refer House Bill 25-1084 to the Committee of the Whole and with a recommendation that it be placed on the consent calendar.",6,0,0,1,7
1920847,1503520,2025-03-03,Senate,"Senate: Third Reading Bill",32,2,0,0,34
1921498,1478986,2025-02-03,House,"House State, Civic, Military, & Veterans Affairs: Adopt amendment L.001 (Attachment G).",11,0,0,0,11
1921498,1484057,2025-02-03,House,"House State, Civic, Military, & Veterans Affairs: Refer House Bill 25-1083, as amended, to the Committee on Appropriations.",11,0,0,0,11
1921498,1548067,2025-04-15,House,"House Appropriations: Refer House Bill 25-1083 to the Committee of the Whole.",11,0,0,0,11
1921498,1552484,2025-04-21,House,"House: Third Reading Bill",63,0,0,2,65
1921498,1557176,2025-04-24,Senate,"Senate State, Veterans, & Military Affairs: Refer House Bill 25-1083 to the Committee on Appropriations.",5,0,0,0,5
1921498,1561753,2025-04-30,Senate,"Senate Appropriations: Refer House Bill 25-1083 to the Committee of the Whole and with a recommendation that it be placed on the consent calendar.",7,0,0,0,7
1921498,1563522,2025-05-01,Senate,"Senate: Third Reading Bill",35,0,0,0,35
1922508,1487335,2025-02-12,Senate,"Senate Agriculture & Natural Resources: Adopt amendment L.001 (Attachment A).",7,0,0,0,7
1922508,1508435,2025-02-12,Senate,"Senate Agriculture & Natural Resources: Adopt amendment L.002 (Attachment B).",7,0,0,0,7
1922508,1508436,2025-02-12,Senate,"Senate Agriculture & Natural Resources: Refer Senate Bill 25-054, as amended, to the Committee on Appropriations.",6,0,0,1,7
1922508,1545348,2025-04-11,Senate,"Senate Appropriations: Adopt amendment J.001",7,0,0,0,7
1922508,1545863,2025-04-11,Senate,"Senate Appropriations: Refer Senate Bill 25-054, as amended, to the Committee of the Whole.",7,0,0,0,7
1922508,1547348,2025-04-14,Senate,"Senate: Third Reading Bill",33,0,0,2,35
1922508,1552727,2025-04-21,House,"House Agriculture, Water & Natural Resources: Refer Senate Bill 25-054 to the Committee on Appropriations.",13,0,0,0,13
1922508,1557970,2025-04-25,House,"House Appropriations: Refer Senate Bill 25-054 to the Committee of the Whole.",11,0,0,0,11
1922508,1559021,2025-04-28,House,"House: Third Reading Bill",63,1,0,1,65
1922856,1477468,2025-01-30,Senate,"Senate Health & Human Services: Refer Senate Bill 25-055 to the Committee of the Whole.",6,3,0,0,9
1922856,1480549,2025-02-05,Senate,"Senate: Third Reading Bill",23,12,0,0,35
1922856,1499849,2025-02-26,House,"House Energy & Environment: Adopt amendment L.001",13,0,0,0,13
1922856,1517313,2025-02-26,House,"House Energy & Environment: Refer Senate Bill 25-055, as amended, to the Committee on Appropriations.",9,4,0,0,13
1922856,1545335,2025-04-11,House,"House Appropriations: Adopt amendment J.001",11,0,0,0,11
1922856,1545747,2025-04-11,House,"House Appropriations: Refer Senate Bill 25-055, as amended, to the Committee of the Whole.",8,3,0,0,11
1922856,1551025,2025-04-17,House,"House: Third Reading Bill",41,22,0,2,65
1922856,1552640,2025-04-21,Senate,"Senate: House Amendments Concur",28,7,0,0,35
1922856,1552641,2025-04-21,Senate,"Senate: House Amendments Repass",23,12,0,0,35
1924343,1472088,2025-01-17,House,"House: RESOLUTIONS Res",63,0,0,1,64
1924343,1472576,2025-01-21,Senate,"Senate: Consideration of Resolutions Resolution",31,0,0,4,35
1927178,1480067,2025-02-04,Senate,"Senate Finance: Refer Senate Bill 25-056 to the Committee on Appropriations.",4,5,0,0,9
1927178,1484538,2025-02-04,Senate,"Senate Finance: Postpone Senate Bill 25-056 indefinitely using a reversal of the previous roll call. There was no objection to the use of the reverse roll call, therefore, the bill was postponed indefinitely.",5,4,0,0,9
1928694,1473037,2025-01-22,Senate,"Senate: Consideration of Resolutions Resolution",21,11,0,3,35
1928694,1474191,2025-01-24,House,"House: RESOLUTIONS Amd (l.002)",19,41,0,4,64
1928694,1474192,2025-01-24,House,"House: RESOLUTIONS Res",42,18,0,4,64
1929053,1472730,2025-01-21,Senate,"Senate: Consideration of Resolutions Resolution",31,0,0,4,35
1933741,1485441,2025-02-10,Senate,"Senate Education: Adopt amendment L.007",3,4,0,0,7
1933741,1493027,2025-02-19,Senate,"Senate: Third Reading Bill",22,12,0,0,34
1933741,1508480,2025-02-10,Senate,"Senate Education: Adopt amendment L.004",5,2,0,0,7
1933741,1508481,2025-02-10,Senate,"Senate Education: Adopt amendment L.005",7,0,0,0,7
1933741,1508482,2025-02-10,Senate,"Senate Education: Adopt amendment L.006",7,0,0,0,7
1933741,1508483,2025-02-10,Senate,"Senate Education: Refer Senate Bill 25-063, as amended, to the Committee of the Whole.",5,2,0,0,7
1933741,1527929,2025-03-26,House,"House Education: Refer Senate Bill 25-063 to the Committee of the Whole.",7,5,0,1,13
1933741,1535879,2025-04-03,House,"House: Committee of the Whole Amd (h.003)",21,42,0,2,65
1933741,1536479,2025-04-03,House,"House: Committee of the Whole Amd (h.001)",22,42,0,1,65
1933741,1536480,2025-04-03,House,"House: Committee of the Whole Amd (h.002)",21,43,0,1,65
1933741,1536481,2025-04-03,House,"House: Committee of the Whole Amd (h.004)",21,43,0,1,65
1933741,1536482,2025-04-03,House,"House: Committee of the Whole Amd (h.005)",21,43,0,1,65
1933741,1547492,2025-04-14,House,"House: Third Reading Bill",42,22,0,1,65
1933741,1549755,2025-04-16,Senate,"Senate: House Amendments Concur",32,0,0,3,35
1933741,1549756,2025-04-16,Senate,"Senate: House Amendments Repass",21,11,0,3,35
1933754,1479713,2025-02-04,Senate,"Senate State, Veterans, & Military Affairs: Refer Senate Bill 25-059 to the Committee of the Whole.",3,2,0,0,5
1933754,1487303,2025-02-12,Senate,"Senate: Third Reading Bill",24,9,0,2,35
1933754,1518978,2025-03-17,House,"House State, Civic, Military, & Veterans Affairs: Refer Senate Bill 25-059 to the Committee of the Whole.",8,3,0,0,11
1933754,1530144,2025-03-28,House,"House: Committee of the Whole Amd (h.001)",22,41,0,2,65
1933754,1530814,2025-03-31,House,"House: Third Reading Bill",41,23,0,1,65
1933766,1479910,2025-02-04,Senate,"Senate State, Veterans, & Military Affairs: Refer Senate Bill 25-057 to the Committee on Appropriations.",2,3,0,0,5
1933766,1508806,2025-02-04,Senate,"Senate State, Veterans, & Military Affairs: Postpone Senate Bill 25-057 indefinitely using a reversal of the previous roll call. There was no objection to the use of the reverse roll call, therefore, the bill was postponed indefinitely.",3,2,0,0,5
1933779,1486330,2025-02-11,Senate,"Senate State, Veterans, & Military Affairs: Postpone Senate Bill 25-065 indefinitely.",5,0,0,0,5
1933793,1482210,2025-02-05,Senate,"Senate Judiciary: Adopt amendment L.002 (Attachment D)",7,0,0,0,7
1933793,1485854,2025-02-11,Senate,"Senate: Third Reading Bill",22,11,0,2,35
1933793,1486352,2025-02-11,Senate,"Senate: Third Reading Bill",21,11,0,3,35
1933793,1487608,2025-02-05,Senate,"Senate Judiciary: Refer Senate Bill 25-062, as amended, to the Committee of the Whole.",5,2,0,0,7
1933793,1520071,2025-03-18,House,"House Judiciary: Refer Senate Bill 25-062 to the Committee of the Whole.",7,4,0,0,11
1933793,1534051,2025-04-02,House,"House: Third Reading Bill",40,21,0,4,65
1933804,1518742,2025-03-17,Senate,"Senate Judiciary: Adopt amendment L.001 (Attachment F)",7,0,0,0,7
1933804,1524522,2025-03-21,Senate,"Senate: Third Reading Bill",34,0,0,1,35
1933804,1547265,2025-03-17,Senate,"Senate Judiciary: Adopt amendment L.002 (Attachment G)",7,0,0,0,7
1933804,1547266,2025-03-17,Senate,"Senate Judiciary: Refer Senate Bill 25-061, as amended, to the Committee of the Whole and with a recommendation that it be placed on the consent calendar.",7,0,0,0,7
1933804,1560697,2025-04-29,House,"House State, Civic, Military, & Veterans Affairs: Refer Senate Bill 25-061, as amended, to the Committee of the Whole.",6,3,0,2,11
1933804,1563516,2025-05-01,House,"House: Third Reading Bill",58,6,0,1,65
1933804,1564708,2025-05-02,Senate,"Senate: House Amendments Concur",35,0,0,0,35
1933804,1564709,2025-05-02,Senate,"Senate: House Amendments Repass",35,0,0,0,35
1933804,1565561,2025-04-29,House,"House State, Civic, Military, & Veterans Affairs: Refer Senate Bill 25-061, as amended, to the Committee of the Whole.",6,3,0,2,11
1933817,1482557,2025-02-05,Senate,"Senate Judiciary: Adopt amendment L.002 (Attachment B)",7,0,0,0,7
1933817,1484594,2025-02-10,Senate,"Senate: Third Reading Bill",33,0,0,2,35
1933817,1484595,2025-02-10,Senate,"Senate: Third Reading Reconsideration",33,0,0,2,35
1933817,1487625,2025-02-05,Senate,"Senate Judiciary: Adopt amendment L.003 (Attachment C)",7,0,0,0,7
1933817,1487626,2025-02-05,Senate,"Senate Judiciary: Refer Senate Bill 25-060, as amended, to the Committee of the Whole and with a recommendation that it be placed on the consent calendar.",6,0,0,1,7
1933817,1521922,2025-03-19,House,"House Judiciary: Adopt amendment L.006 (Attachment D)",5,5,0,1,11
1933817,1534122,2025-04-02,House,"House: Third Reading Bill",51,11,0,3,65
1933817,1552264,2025-03-19,House,"House Judiciary: Refer Senate Bill 25-060 to the Committee of the Whole.",7,4,0,0,11
1933829,1499768,2025-02-26,Senate,"Senate Health & Human Services: Adopt amendment L.001 (Attachment A).",9,0,0,0,9
1933829,1502290,2025-02-26,Senate,"Senate Health & Human Services: Refer Senate Bill 25-058, as amended, to the Committee of the Whole.",8,1,0,0,9
1933829,1504655,2025-03-04,Senate,"Senate: Third Reading Bill",32,1,0,1,34
1933829,1521119,2025-03-19,House,"House Business Affairs & Labor: Adopt amendment L.004",13,0,0,0,13
1933829,1524041,2025-03-19,House,"House Business Affairs & Labor: Refer Senate Bill 25-058, as amended, to the Committee of the Whole.",13,0,0,0,13
1933829,1532298,2025-04-01,House,"House: Third Reading Bill",61,2,0,2,65
1933829,1536509,2025-04-03,Senate,"Senate: House Amendments Concur",34,0,0,1,35
1933829,1536510,2025-04-03,Senate,"Senate: House Amendments Repass",33,1,0,1,35
1933841,1482534,2025-02-05,Senate,"Senate Education: Adopt amendment L.003",7,0,0,0,7
1933841,1489015,2025-02-05,Senate,"Senate Education: Refer Senate Bill 25-064, as amended, to the Committee on Appropriations.",5,2,0,0,7
1933841,1553482,2025-04-22,Senate,"Senate Appropriations: Adopt amendment L.005",7,0,0,0,7
1933841,1553483,2025-04-22,Senate,"Senate Appropriations: Refer Senate Bill 25-064, as amended, to the Committee of the Whole.",4,3,0,0,7
1933841,1557977,2025-04-25,Senate,"Senate: Third Reading Bill",26,9,0,0,35
1933841,1560994,2025-04-29,House,"House State, Civic, Military, & Veterans Affairs: Refer Senate Bill 25-064 to the Committee on Appropriations.",8,2,0,1,11
1935338,1482700,2025-02-05,Senate,"Senate Judiciary: Adopt amendment L.001 (Attachment E)",7,0,0,0,7
1935338,1508603,2025-02-05,Senate,"Senate Judiciary: Refer Senate Bill 25-075, as amended, to the Committee on Appropriations.",7,0,0,0,7
1935338,1548042,2025-04-15,Senate,"Senate Appropriations: Refer Senate Bill 25-075 to the Committee of the Whole.",4,3,0,0,7
1935338,1551563,2025-04-17,Senate,"Senate: Committee of the Whole Cow * (s.001)",35,0,0,0,35
1935338,1552634,2025-04-21,Senate,"Senate: Third Reading Bill",33,2,0,0,35
1935338,1562621,2025-04-30,House,"House Judiciary: Refer Senate Bill 25-075, as amended, to the Committee on Finance.",11,0,0,0,11
1935338,1564002,2025-05-01,House,"House Finance: Adopt amendment L.006 (Attachment B).",13,0,0,0,13
1935338,1564666,2025-05-01,House,"House Finance: Refer Senate Bill 25-075, as amended, to the Committee on Appropriations.",11,0,0,2,13
1935338,1564770,2025-05-03,House,"House Appropriations: Refer Senate Bill 25-075 to the Committee of the Whole.",11,0,0,0,11
1935338,1565114,2025-05-05,House,"House: Third Reading Bill",63,1,0,1,65
1935338,1566616,2025-05-06,Senate,"Senate: House Amendments Concur",35,0,0,0,35
1935338,1566617,2025-05-06,Senate,"Senate: House Amendments Repass",35,0,0,0,35
1935402,1482289,2025-02-05,House,"House Health & Human Services: Refer House Bill 25-1086 to the Committee of the Whole.",12,0,0,1,13
1935402,1491760,2025-02-18,House,"House: Third Reading Bill",64,0,0,1,65
1935402,1523267,2025-03-20,Senate,"Senate Health & Human Services: Refer House Bill 25-1086 to the Committee of the Whole and with a recommendation that it be placed on the consent calendar.",8,0,0,1,9
1935402,1528030,2025-03-26,Senate,"Senate: Third Reading Bill",34,0,0,1,35
1935471,1479806,2025-02-04,Senate,"Senate Finance: Adopt amendment L.001 (Attachment C)",9,0,0,0,9
1935471,1481185,2025-02-04,Senate,"Senate Finance: Adopt amendment L.002 (Attachment D)",9,0,0,0,9
1935471,1481187,2025-02-04,Senate,"Senate Finance: Refer Senate Bill 25-072, as amended, to the Committee on Appropriations.",9,0,0,0,9
1935471,1558035,2025-04-25,Senate,"Senate Appropriations: Adopt amendment L.003",7,0,0,0,7
1935471,1558806,2025-04-28,Senate,"Senate: Third Reading Bill",30,4,0,1,35
1935471,1559773,2025-04-25,Senate,"Senate Appropriations: Adopt amendment J.002",7,0,0,0,7
1935471,1559774,2025-04-25,Senate,"Senate Appropriations: Refer Senate Bill 25-072, as amended, to the Committee of the Whole.",7,0,0,0,7
1935471,1560444,2025-04-29,House,"House Finance: Adopt amendment L.007 (Attachment D).",13,0,0,0,13
1935471,1564689,2025-04-29,House,"House Finance: Adopt amendment L.006 (Attachment C).",13,0,0,0,13
1935471,1564690,2025-04-29,House,"House Finance: Adopt amendment L.008 (Attachment E).",13,0,0,0,13
1935471,1564691,2025-04-29,House,"House Finance: Refer Senate Bill 25-072, as amended, to the Committee on Appropriations.",8,5,0,0,13
1935471,1567648,2025-05-07,House,"House: Third Reading Bill",47,18,0,0,65
1935471,1567649,2025-05-07,Senate,"Senate: House Amendments Concur",32,3,0,0,35
1935471,1567650,2025-05-07,Senate,"Senate: House Amendments Repass",27,8,0,0,35
1935542,1493124,2025-02-18,Senate,"Senate Business, Labor, & Technology: Refer Senate Bill 25-070 to the Committee of the Whole.",6,1,0,0,7
1935542,1497466,2025-02-24,Senate,"Senate: Third Reading Bill",28,3,0,3,34
1935542,1521083,2025-03-19,House,"House Business Affairs & Labor: Refer Senate Bill 25-070 to the Committee of the Whole.",12,1,0,0,13
1935542,1555497,2025-04-23,House,"House: Third Reading Bill",48,16,0,1,65
1935542,1558137,2025-04-25,Senate,"Senate: House Amendments Concur",32,3,0,0,35
1935542,1558138,2025-04-25,Senate,"Senate: House Amendments Repass",30,5,0,0,35
1935609,1487507,2025-02-12,Senate,"Senate Transportation & Energy: Adopt amendment L.001",9,0,0,0,9
1935609,1498099,2025-02-12,Senate,"Senate Transportation & Energy: Adopt amendment L.002",9,0,0,0,9
1935609,1498100,2025-02-12,Senate,"Senate Transportation & Energy: Adopt amendment L.003",9,0,0,0,9
1935609,1498101,2025-02-12,Senate,"Senate Transportation & Energy: Refer Senate Bill 25-069, as amended, to the Committee on Appropriations.",9,0,0,0,9
1935609,1548033,2025-04-15,Senate,"Senate Appropriations: Refer Senate Bill 25-069 to the Committee of the Whole.",4,3,0,0,7
1935609,1552483,2025-04-21,Senate,"Senate: Third Reading Bill",33,2,0,0,35
1935609,1554104,2025-04-22,House,"House Transportation, Housing & Local Government: Refer Senate Bill 25-069 to the Committee on Finance.",12,1,0,0,13
1935609,1557162,2025-04-24,House,"House Finance: Refer Senate Bill 25-069 to the Committee on Appropriations.",10,3,0,0,13
1935609,1559650,2025-04-29,House,"House Appropriations: Refer Senate Bill 25-069 to the Committee of the Whole.",8,2,0,1,11
1935609,1562299,2025-04-30,House,"House: Third Reading Bill",54,11,0,0,65
1935682,1476718,2025-01-29,House,"House Health & Human Services: Adopt amendment L.001 (Attachment A).",13,0,0,0,13
1935682,1478956,2025-02-03,House,"House: Third Reading Bill",64,0,0,1,65
1935682,1497454,2025-01-29,House,"House Health & Human Services: Refer House Bill 25-1085, as amended, to the Committee of the Whole.",13,0,0,0,13
1935682,1523728,2025-03-20,Senate,"Senate Health & Human Services: Refer House Bill 25-1085 to the Committee of the Whole and with a recommendation that it be placed on the consent calendar.",8,0,0,1,9
1935682,1527997,2025-03-26,Senate,"Senate: Third Reading Bill",34,0,0,1,35
1935754,1486535,2025-02-11,Senate,"Senate State, Veterans, & Military Affairs: Refer Senate Bill 25-074 to the Committee on Appropriations.",2,3,0,0,5
1935754,1518023,2025-02-11,Senate,"Senate State, Veterans, & Military Affairs: Postpone Senate Bill 25-074 indefinitely using a reversal of the previous roll call. There was no objection to the use of the reverse roll call, therefore, the bill was postponed indefinitely.",3,2,0,0,5
1935825,1498170,2025-02-24,House,"House State, Civic, Military, & Veterans Affairs: Adopt amendment L.003 (Attachment E).",11,0,0,0,11
1935825,1503021,2025-02-24,House,"House State, Civic, Military, & Veterans Affairs: Postpone House Bill 25-1089 indefinitely using a reversal of the previous roll call. There was no objection to the use of the reverse roll call, therefore, the bill was postponed indefinitely.",6,5,0,0,11
1935825,1503022,2025-02-24,House,"House State, Civic, Military, & Veterans Affairs: Refer House Bill 25-1089, as amended, to the Committee of the Whole.",5,6,0,0,11
1935890,1493338,2025-02-19,Senate,"Senate Education: Refer Senate Bill 25-073, as amended, to the Committee of the Whole and with a recommendation that it be placed on the consent calendar.",7,0,0,0,7
1935890,1498654,2025-02-25,Senate,"Senate: Third Reading Bill",32,0,0,2,34
1935964,1486547,2025-02-11,House,"House Health & Human Services: Refer House Bill 25-1088 to the Committee on Appropriations.",12,1,0,0,13
1935964,1548056,2025-04-15,House,"House Appropriations: Adopt amendment J.001",11,0,0,0,11
1935964,1551047,2025-04-17,House,"House: Third Reading Bill",63,0,0,2,65
1935964,1557669,2025-04-24,Senate,"Senate Health & Human Services: Refer House Bill 25-1088 to the Committee on Appropriations.",9,0,0,0,9
1935964,1560237,2025-04-15,House,"House Appropriations: Refer House Bill 25-1088, as amended, to the Committee of the Whole.",9,2,0,0,11
1935964,1561750,2025-04-30,Senate,"Senate Appropriations: Refer House Bill 25-1088 to the Committee of the Whole and with a recommendation that it be placed on the consent calendar.",7,0,0,0,7
1935964,1563484,2025-05-01,Senate,"Senate: Third Reading Bill",35,0,0,0,35
1936035,1485217,2025-02-10,Senate,"Senate Education: Refer Senate Bill 25-067 to the Committee of the Whole and with a recommendation that it be placed on the consent calendar.",6,0,0,1,7
1936035,1492495,2025-02-18,Senate,"Senate: Third Reading Bill",34,0,0,0,34
1936035,1520921,2025-03-19,House,"House Education: Refer Senate Bill 25-067 to the Committee of the Whole.",13,0,0,0,13
1936035,1526144,2025-03-25,House,"House: Third Reading Bill",59,2,0,4,65
1936035,1527856,2025-03-26,Senate,"Senate: House Amendments Concur",34,0,0,1,35
1936035,1527857,2025-03-26,Senate,"Senate: House Amendments Repass",34,0,0,1,35
1936106,1488298,2025-02-12,Senate,"Senate Transportation & Energy: Refer Senate Bill 25-068 to the Committee of the Whole and with a recommendation that it be placed on the consent calendar.",9,0,0,0,9
1936106,1494158,2025-02-19,Senate,"Senate: Third Reading Bill",34,0,0,0,34
1936106,1517742,2025-03-13,House,"House Energy & Environment: Adopt amendment L.001",13,0,0,0,13
1936106,1518982,2025-03-13,House,"House Energy & Environment: Refer Senate Bill 25-068, as amended, to the Committee of the Whole.",13,0,0,0,13
1936106,1521712,2025-03-19,House,"House: Third Reading Bill",63,1,0,1,65
1936106,1522766,2025-03-20,Senate,"Senate: House Amendments Concur",33,0,0,1,34
1936106,1522767,2025-03-20,Senate,"Senate: House Amendments Repass",33,0,0,1,34
1936175,1517612,2025-03-13,Senate,"Senate Health & Human Services: Adopt amendment L.002 (Attachment H).",9,0,0,0,9
1936175,1527515,2025-03-26,Senate,"Senate: Third Reading Bill",30,4,0,1,35
1936175,1529412,2025-03-13,Senate,"Senate Health & Human Services: Adopt amendment L.001 (Attachment J).",9,0,0,0,9
1936175,1529413,2025-03-13,Senate,"Senate Health & Human Services: Adopt amendment L.003 (Attachment I).",9,0,0,0,9
1936175,1529414,2025-03-13,Senate,"Senate Health & Human Services: Refer Senate Bill 25-071, as amended, to the Committee of the Whole.",7,2,0,0,9
1936175,1564783,2025-05-03,House,"House Health & Human Services: Refer Senate Bill 25-071 to the Committee of the Whole.",12,1,0,0,13
1936175,1565113,2025-05-05,House,"House: Committee of the Whole Amd (h.001)",17,47,0,1,65
1936175,1565811,2025-05-06,House,"House: Third Reading Bill",57,8,0,0,65
1936247,1513823,2025-03-11,Senate,"Senate Business, Labor, & Technology: Postpone Senate Bill 25-076 indefinitely.",6,0,0,1,7
1936318,1493825,2025-02-19,House,"House Health & Human Services: Adopt amendment L.002 (Attachment A).",13,0,0,0,13
1936318,1501330,2025-02-27,House,"House: Third Reading Bill",63,0,0,2,65
1936318,1507365,2025-02-19,House,"House Health & Human Services: Refer House Bill 25-1087, as amended, to the Committee of the Whole.",11,0,0,2,13
1936318,1527334,2025-03-26,Senate,"Senate Health & Human Services: Adopt amendment L.006 (Attachment A).",9,0,0,0,9
1936318,1531135,2025-03-26,Senate,"Senate Health & Human Services: Refer House Bill 25-1087, as amended, to the Committee of the Whole and with a recommendation that it be placed on the consent calendar.",9,0,0,0,9
1936318,1537186,2025-04-04,Senate,"Senate: Third Reading Bill",35,0,0,0,35
1936318,1546005,2025-04-11,House,"House: Senate Amendments Concur",62,0,0,3,65
1936318,1546006,2025-04-11,House,"House: Senate Amendments Repass",62,0,0,3,65
1936386,1499765,2025-02-26,Senate,"Senate Health & Human Services: Postpone Senate Bill 25-066 indefinitely.",9,0,0,0,9
1938107,1504750,2025-03-04,Senate,"Senate Finance: Postpone Senate Bill 25-080 indefinitely.",9,0,0,0,9
1938187,1494297,2025-02-19,Senate,"Senate Judiciary: Adopt amendment L.001 (Attachment G)",7,0,0,0,7
1938187,1502189,2025-02-28,Senate,"Senate: Third Reading Bill",25,4,0,5,34
1938187,1508594,2025-02-19,Senate,"Senate Judiciary: Adopt amendment L.002 (Attachment H)",7,0,0,0,7
1938187,1508595,2025-02-19,Senate,"Senate Judiciary: Adopt amendment L.003 (Attachment I)",7,0,0,0,7
1938187,1508596,2025-02-19,Senate,"Senate Judiciary: Adopt amendment L.004 (Attachment J)",2,5,0,0,7
1938187,1508597,2025-02-19,Senate,"Senate Judiciary: Refer Senate Bill 25-079, as amended, to the Committee of the Whole.",7,0,0,0,7
1938187,1547521,2025-04-14,House,"House Finance: Adopt amendment L.008 (Attachment B).",13,0,0,0,13
1938187,1557957,2025-04-25,House,"House: Third Reading Bill",48,14,0,3,65
1938187,1558816,2025-04-28,Senate,"Senate: House Amendments Concur",33,0,0,2,35
1938187,1558817,2025-04-28,Senate,"Senate: House Amendments Repass",33,0,0,2,35
1938187,1564596,2025-04-14,House,"House Finance: Refer Senate Bill 25-079, as amended, to the Committee of the Whole.",9,3,0,1,13
1938273,1493472,2025-02-18,Senate,"Senate Finance: Adopt amendment L.001 (Attachment A)",9,0,0,0,9
1938273,1493473,2025-02-18,Senate,"Senate Finance: Adopt amendment L.002 (Attachment B)",9,0,0,0,9
1938273,1493474,2025-02-18,Senate,"Senate Finance: Refer Senate Bill 25-081, as amended, to the Committee on Appropriations.",6,3,0,0,9
1938273,1508593,2025-03-07,Senate,"Senate Appropriations: Refer Senate Bill 25-081 to the Committee of the Whole.",4,3,0,0,7
1938273,1515986,2025-03-12,Senate,"Senate: Third Reading Bill",22,12,0,0,34
1938273,1552713,2025-04-21,House,"House Finance: Adopt amendment L.008 (Attachment C).",13,0,0,0,13
1938273,1555562,2025-04-21,House,"House Finance: Reconsider the prior motion on Senate Bill 25-081.",11,2,0,0,13
1938273,1558189,2025-04-25,House,"House: Third Reading Bill",40,23,0,2,65
1938273,1558865,2025-04-28,Senate,"Senate: House Amendments Concur",30,3,0,2,35
1938273,1558866,2025-04-28,Senate,"Senate: House Amendments Repass",22,11,0,2,35
1938273,1564618,2025-04-21,House,"House Finance: Adopt amendment L.006 (Attachment G).",13,0,0,0,13
1938273,1564619,2025-04-21,House,"House Finance: Adopt amendment L.009 (Attachment D).",13,0,0,0,13
1938273,1564620,2025-04-21,House,"House Finance: Adopt amendment L.010 (Attachment E).",13,0,0,0,13
1938273,1564621,2025-04-21,House,"House Finance: Adopt amendment L.011 (Attachment F).",13,0,0,0,13
1938273,1564622,2025-04-21,House,"House Finance: Refer Senate Bill 25-081, as amended, to the Committee of the Whole.",10,3,0,0,13
1938273,1564623,2025-04-21,House,"House Finance: Refer Senate Bill 25-081, as amended, to the Committee on Appropriations.",8,5,0,0,13
1938361,1502118,2025-02-27,Senate,"Senate Health & Human Services: Adopt amendment L.001 (Attachment D).",9,0,0,0,9
1938361,1506227,2025-03-05,Senate,"Senate: Third Reading Bill",34,0,0,0,34
1938361,1520195,2025-03-18,House,"House Health & Human Services: Refer Senate Bill 25-078 to the Committee of the Whole.",12,0,0,1,13
1938361,1522773,2025-03-20,House,"House: Third Reading Bill",63,0,0,2,65
1938361,1531554,2025-02-27,Senate,"Senate Health & Human Services: Refer Senate Bill 25-078, as amended, to the Committee of the Whole and with a recommendation that it be placed on the consent calendar.",9,0,0,0,9
1938454,1507647,2025-03-06,Senate,"Senate Business, Labor, & Technology: Adopt amendment L.001",7,0,0,0,7
1938454,1515866,2025-03-12,Senate,"Senate: Third Reading Bill",29,5,0,0,34
1938454,1519369,2025-03-06,Senate,"Senate Business, Labor, & Technology: Adopt amendment L.002",7,0,0,0,7
1938454,1519370,2025-03-06,Senate,"Senate Business, Labor, & Technology: Refer Senate Bill 25-083, as amended, to the Committee of the Whole.",5,1,0,1,7
1938454,1536810,2025-04-03,House,"House Business Affairs & Labor: Adopt amendment L.004",6,7,0,0,13
1938454,1543932,2025-04-03,House,"House Business Affairs & Labor: Adopt amendment L.005",13,0,0,0,13
1938454,1543933,2025-04-03,House,"House Business Affairs & Labor: Adopt amendment L.008",9,4,0,0,13
1938454,1543934,2025-04-03,House,"House Business Affairs & Labor: Refer Senate Bill 25-083, as amended, to the Committee of the Whole.",13,0,0,0,13
1938454,1546024,2025-04-11,House,"House: Committee of the Whole Amd (h.001)",32,29,0,4,65
1938454,1547391,2025-04-14,House,"House: Third Reading Bill",56,8,0,1,65
1938454,1552700,2025-04-21,Senate,"Senate: House Amendments Concur",35,0,0,0,35
1938454,1552701,2025-04-21,Senate,"Senate: House Amendments Repass",28,7,0,0,35
1938537,1501843,2025-02-27,Senate,"Senate Health & Human Services: Adopt amendment L.002 (Attachment C).",9,0,0,0,9
1938537,1505955,2025-03-05,Senate,"Senate: Third Reading Bill",29,5,0,0,34
1938537,1528164,2025-03-26,House,"House Health & Human Services: Adopt amendment L.005 (Attachment F).",13,0,0,0,13
1938537,1529306,2025-03-26,House,"House Health & Human Services: Refer Senate Bill 25-085, as amended, to the Committee of the Whole.",13,0,0,0,13
1938537,1530830,2025-03-31,House,"House: Third Reading Bill",50,13,0,2,65
1938537,1531198,2025-02-27,Senate,"Senate Health & Human Services: Refer Senate Bill 25-085, as amended, to the Committee of the Whole.",7,2,0,0,9
1938537,1537179,2025-04-04,Senate,"Senate: House Amendments Concur",35,0,0,0,35
1938537,1537180,2025-04-04,Senate,"Senate: House Amendments Repass",28,7,0,0,35
1938627,1480824,2025-02-05,Senate,"Senate Judiciary: Refer Senate Bill 25-082 to the Committee of the Whole and with a recommendation that it be placed on the consent calendar.",7,0,0,0,7
1938627,1484638,2025-02-10,Senate,"Senate: Third Reading Bill",33,0,0,2,35
1938627,1492629,2025-02-18,House,"House Judiciary: Refer Senate Bill 25-082 to the Committee of the Whole.",8,0,0,3,11
1938627,1499298,2025-02-25,House,"House: Third Reading Bill",51,10,0,4,65
1938720,1502532,2025-02-26,Senate,"Senate Health & Human Services: Adopt amendment L.001 (Attachment B).",9,0,0,0,9
1938720,1502533,2025-02-26,Senate,"Senate Health & Human Services: Adopt amendment L.002 (Attachment C).",9,0,0,0,9
1938720,1506602,2025-03-05,Senate,"Senate Health & Human Services: Refer Senate Bill 25-084 to the Committee on Appropriations.",8,0,0,1,9
1938720,1558222,2025-04-25,Senate,"Senate Appropriations: Adopt amendment L.003",7,0,0,0,7
1938720,1558927,2025-04-28,Senate,"Senate: Third Reading Bill",34,0,0,1,35
1938720,1560109,2025-04-25,Senate,"Senate Appropriations: Adopt amendment J.002",7,0,0,0,7
1938720,1560110,2025-04-25,Senate,"Senate Appropriations: Refer Senate Bill 25-084, as amended, to the Committee of the Whole and with a recommendation that it be placed on the consent calendar.",7,0,0,0,7
1938720,1563277,2025-04-30,House,"House Health & Human Services: Refer Senate Bill 25-084 to the Committee on Appropriations.",12,0,0,1,13
1938720,1564775,2025-05-03,House,"House Appropriations: Adopt amendment J.004",11,0,0,0,11
1938720,1564776,2025-05-03,House,"House Appropriations: Refer Senate Bill 25-084, as amended, to the Committee of the Whole.",9,2,0,0,11
1938720,1565935,2025-05-06,House,"House: Third Reading Bill",63,2,0,0,65
1938720,1565936,2025-05-06,Senate,"Senate: House Amendments Concur",35,0,0,0,35
1938720,1565937,2025-05-06,Senate,"Senate: House Amendments Repass",35,0,0,0,35
1938807,1493695,2025-02-19,Senate,"Senate Judiciary: Adopt amendment L.001 (Attachment B)",7,0,0,0,7
1938807,1500007,2025-02-26,Senate,"Senate: Third Reading Bill",28,5,0,1,34
1938807,1508557,2025-02-19,Senate,"Senate Judiciary: Adopt amendment L.002 (Attachment C)",7,0,0,0,7
1938807,1508558,2025-02-19,Senate,"Senate Judiciary: Adopt amendment L.003 (Attachment D)",7,0,0,0,7
1938807,1508559,2025-02-19,Senate,"Senate Judiciary: Adopt amendment L.004 (Attachment E)",7,0,0,0,7
1938807,1508560,2025-02-19,Senate,"Senate Judiciary: Refer Senate Bill 25-086, as amended, to the Committee of the Whole.",6,1,0,0,7
1938807,1516368,2025-03-12,House,"House Health & Human Services: Refer Senate Bill 25-086 to the Committee of the Whole.",11,2,0,0,13
1938807,1530965,2025-03-31,House,"House: Third Reading Bill",46,18,0,1,65
1938807,1537169,2025-04-04,Senate,"Senate: House Amendments Concur",35,0,0,0,35
1938807,1537170,2025-04-04,Senate,"Senate: House Amendments Repass",29,6,0,0,35
1938807,1557959,2025-04-25,Senate,"Senate: Veto Consideration Bill",29,6,0,0,35
1938807,1558993,2025-04-28,House,"House: VETO Lo",51,13,0,1,65
1938894,1494965,2025-02-20,Senate,"Senate State, Veterans, & Military Affairs: Refer Senate Bill 25-077 to the Committee of the Whole.",4,1,0,0,5
1938894,1500057,2025-02-26,Senate,"Senate: Third Reading Bill",27,6,0,1,34
1938894,1509636,2025-03-10,House,"House State, Civic, Military, & Veterans Affairs: Adopt amendment L.002 (Attachment C).",11,0,0,0,11
1938894,1524037,2025-03-10,House,"House State, Civic, Military, & Veterans Affairs: Refer Senate Bill 25-077, as amended, to the Committee of the Whole.",8,3,0,0,11
1938894,1531213,2025-03-31,House,"House: Third Reading Bill",45,19,0,1,65
1939330,1494049,2025-02-19,House,"House Judiciary: Adopt amendment L.002 (Attachment B)",11,0,0,0,11
1939330,1502281,2025-02-28,House,"House: Committee of the Whole Amd (h.001)",21,39,0,5,65
1939330,1502282,2025-02-28,House,"House: Committee of the Whole Amd (h.002)",22,38,0,5,65
1939330,1502283,2025-02-28,House,"House: Committee of the Whole Amd (h.003)",21,39,0,5,65
1939330,1504544,2025-03-04,House,"House: Third Reading Bill",41,21,0,3,65
1939330,1521652,2025-03-19,Senate,"Senate Judiciary: Adopt amendment L.022 (Attachment A)",7,0,0,0,7
1939330,1526499,2025-02-19,House,"House Judiciary: Adopt amendment L.001 (Attachment C)",11,0,0,0,11
1939330,1526500,2025-02-19,House,"House Judiciary: Refer House Bill 25-1090, as amended, to the Committee of the Whole.",7,4,0,0,11
1939330,1527493,2025-03-26,Senate,"Senate: Third Reading Bill",22,12,0,1,35
1939330,1530159,2025-03-28,House,"House: Senate Amendments Concur",41,21,0,3,65
1939330,1530160,2025-03-28,House,"House: Senate Amendments Repass",41,21,0,3,65
1939330,1533802,2025-03-19,Senate,"Senate Judiciary: Adopt amendment L.018 (Attachment C)",4,3,0,0,7
1939330,1533803,2025-03-19,Senate,"Senate Judiciary: Adopt amendment L.019 (Attachment D)",2,5,0,0,7
1939330,1533804,2025-03-19,Senate,"Senate Judiciary: Adopt amendment L.020 (Attachment E)",3,4,0,0,7
1939330,1533805,2025-03-19,Senate,"Senate Judiciary: Adopt amendment L.023 (Attachment B)",7,0,0,0,7
1939330,1533806,2025-03-19,Senate,"Senate Judiciary: Refer House Bill 25-1090, as amended, to the Committee of the Whole.",4,3,0,0,7
1939410,1493772,2025-02-19,House,"House Transportation, Housing & Local Government: Refer House Bill 25-1092 to the Committee of the Whole.",5,8,0,0,13
1939410,1521782,2025-02-19,House,"House Transportation, Housing & Local Government: Postpone House Bill 25-1092 indefinitely using a reversal of the previous roll call. There was no objection to the use of the reverse roll call, therefore, the bill was postponed indefinitely.",8,5,0,0,13
1939489,1479057,2025-02-03,House,"House State, Civic, Military, & Veterans Affairs: Refer House Bill 25-1091 to the Committee of the Whole.",11,0,0,0,11
1939489,1480818,2025-02-05,House,"House: Third Reading Bill",55,8,0,2,65
1939489,1508173,2025-03-06,Senate,"Senate State, Veterans, & Military Affairs: Refer House Bill 25-1091 to the Committee of the Whole and with a recommendation that it be placed on the consent calendar.",4,0,0,1,5
1939489,1516335,2025-03-12,Senate,"Senate: Third Reading Amend (l.001)",33,1,0,0,34
1939489,1516336,2025-03-12,Senate,"Senate: Third Reading Bill",30,4,0,0,34
1939489,1519029,2025-03-17,House,"House: Senate Amendments Concur",56,7,0,2,65
1939489,1519030,2025-03-17,House,"House: Senate Amendments Repass",59,4,0,2,65
1939914,1474890,2025-01-27,House,"House: RESOLUTIONS Res",61,0,0,4,65
1939914,1477091,2025-01-30,Senate,"Senate: Consideration of Resolutions Resolution",33,0,0,2,35
1942878,1492836,2025-02-18,House,"House Transportation, Housing & Local Government: Refer House Bill 25-1110 to the Committee of the Whole.",12,0,0,1,13
1942878,1499320,2025-02-25,House,"House: Third Reading Bill",53,8,0,4,65
1942878,1521886,2025-03-19,Senate,"Senate Transportation & Energy: Refer House Bill 25-1110 to the Committee of the Whole and with a recommendation that it be placed on the consent calendar.",8,0,0,1,9
1942878,1526828,2025-03-25,Senate,"Senate: Third Reading Bill",34,1,0,0,35
1942887,1503864,2025-03-03,House,"House Finance: Adopt amendment L.001 (Attachment E).",13,0,0,0,13
1942887,1520403,2025-03-03,House,"House Finance: Adopt amendment L.002 (Attachment F).",13,0,0,0,13
1942887,1520404,2025-03-03,House,"House Finance: Postpone House Bill 25-1095 indefinitely using a reversal of the previous roll call. There was no objection to the use of the reverse roll call, therefore, the bill was postponed indefinitely.",11,2,0,0,13
1942887,1520405,2025-03-03,House,"House Finance: Refer House Bill 25-1095, as amended, to the Committee of the Whole.",2,11,0,0,13
1942895,1499314,2025-02-25,House,"House Health & Human Services: Adopt amendment L.001 (Attachment J).",13,0,0,0,13
1942895,1506519,2025-03-05,House,"House: Committee of the Whole Amd (h.001)",22,37,0,6,65
1942895,1508794,2025-03-07,House,"House: Third Reading Bill",38,26,0,1,65
1942895,1516375,2025-02-25,House,"House Health & Human Services: Adopt amendment L.002 (Attachment K).",13,0,0,0,13
1942895,1516376,2025-02-25,House,"House Health & Human Services: Refer House Bill 25-1109, as amended, to the Committee of the Whole.",8,5,0,0,13
1942895,1524107,2025-03-20,Senate,"Senate State, Veterans, & Military Affairs: Refer House Bill 25-1109 to the Committee of the Whole.",3,2,0,0,5
1942895,1527582,2025-03-26,Senate,"Senate: Third Reading Bill",22,12,0,1,35
1942911,1501858,2025-02-27,House,"House Energy & Environment: Adopt amendment L.001",13,0,0,0,13
1942911,1517267,2025-02-27,House,"House Energy & Environment: Adopt amendment L.002",13,0,0,0,13
1942911,1517268,2025-02-27,House,"House Energy & Environment: Refer House Bill 25-1118, as amended, to the Committee on Appropriations.",12,1,0,0,13
1942919,1485652,2025-02-10,House,"House Finance: Adopt amendment L.001 (Attachment A).",13,0,0,0,13
1942919,1485653,2025-02-10,House,"House Finance: Refer House Bill 25-1101, as amended, to the Committee on Appropriations.",9,4,0,0,13
1942945,1486391,2025-02-11,House,"House Judiciary: Adopt amendment L.003 (Attachment C)",11,0,0,0,11
1942945,1519473,2025-02-11,House,"House Judiciary: Adopt amendment L.001 (Attachment B)",7,3,0,1,11
1942945,1519474,2025-02-11,House,"House Judiciary: Refer House Bill 25-1098, as amended, to the Committee on Appropriations.",7,3,0,1,11
1942945,1545334,2025-04-11,House,"House Appropriations: Adopt amendment L.005",11,0,0,0,11
1942945,1546175,2025-04-11,House,"House Appropriations: Adopt amendment J.001",11,0,0,0,11
1942945,1546176,2025-04-11,House,"House Appropriations: Refer House Bill 25-1098, as amended, to the Committee of the Whole.",10,1,0,0,11
1942945,1548334,2025-04-15,House,"House: Third Reading Bill",41,20,0,4,65
1942945,1559615,2025-04-28,Senate,"Senate Judiciary: Refer House Bill 25-1098 to the Committee on Appropriations.",7,0,0,0,7
1942945,1562238,2025-04-30,Senate,"Senate Appropriations: Refer House Bill 25-1098 to the Committee of the Whole.",6,1,0,0,7
1942945,1564513,2025-05-02,Senate,"Senate: Third Reading Amend (l.010)",34,0,0,1,35
1942945,1564514,2025-05-02,Senate,"Senate: Third Reading Bill",30,4,0,1,35
1942945,1564720,2025-05-02,House,"House: Senate Amendments Concur",45,17,0,3,65
1942945,1564721,2025-05-02,House,"House: Senate Amendments Repass",43,19,0,3,65
1942953,1499249,2025-02-25,House,"House Transportation, Housing & Local Government: Refer House Bill 25-1112, as amended, to the Committee on Appropriations.",9,4,0,0,13
1942953,1517903,2025-03-14,House,"House Appropriations: Adopt amendment L.009",11,0,0,0,11
1942953,1521580,2025-02-19,House,"House Transportation, Housing & Local Government: Adopt amendment L.005 (Attachment U)",13,0,0,0,13
1942953,1521581,2025-02-19,House,"House Transportation, Housing & Local Government: Adopt amendment L.006 (Attachment V)",13,0,0,0,13
1942953,1521582,2025-02-19,House,"House Transportation, Housing & Local Government: Refer House Bill 25-1112, as amended, to the Committee on Appropriations.",6,6,0,1,13
1942953,1531382,2025-03-31,House,"House: Third Reading Bill",53,11,0,1,65
1942953,1537306,2025-03-14,House,"House Appropriations: Adopt amendment L.008",11,0,0,0,11
1942953,1537307,2025-03-14,House,"House Appropriations: Refer House Bill 25-1112, as amended, to the Committee of the Whole.",8,3,0,0,11
1942953,1550246,2025-04-16,Senate,"Senate Transportation & Energy: Refer House Bill 25-1112 to the Committee on Appropriations.",6,2,0,1,9
1942953,1558005,2025-04-25,Senate,"Senate Appropriations: Refer House Bill 25-1112 to the Committee of the Whole.",6,1,0,0,7
1942953,1558824,2025-04-28,Senate,"Senate: Third Reading Bill",30,4,0,1,35
1942963,1476243,2025-01-29,House,"House: RESOLUTIONS Res",64,0,0,1,65
1942963,1485583,2025-02-10,Senate,"Senate: Consideration of Resolutions Resolution",33,0,0,2,35
1942974,1492813,2025-02-18,House,"House Transportation, Housing & Local Government: Adopt amendment L.001",13,0,0,0,13
1942974,1497450,2025-02-18,House,"House Transportation, Housing & Local Government: Adopt amendment L.002",13,0,0,0,13
1942974,1497451,2025-02-18,House,"House Transportation, Housing & Local Government: Adopt amendment L.003",13,0,0,0,13
1942974,1497452,2025-02-18,House,"House Transportation, Housing & Local Government: Refer House Bill 25-1117, as amended, to the Committee of the Whole.",8,5,0,0,13
1942974,1527488,2025-03-26,House,"House: Third Reading Bill",41,24,0,0,65
1942974,1547498,2025-04-14,Senate,"Senate Transportation & Energy: Adopt amendment L.012",9,0,0,0,9
1942974,1551530,2025-04-17,Senate,"Senate: Third Reading Bill",22,13,0,0,35
1942974,1552066,2025-04-14,Senate,"Senate Transportation & Energy: Refer House Bill 25-1117, as amended, to the Committee of the Whole.",5,3,0,1,9
1942974,1555082,2025-04-23,House,"House: Senate Amendments Concur",43,20,0,2,65
1942974,1555083,2025-04-23,House,"House: Senate Amendments Repass",41,22,0,2,65
1942996,1480072,2025-02-04,House,"House Judiciary: Adopt amendment L.001",11,0,0,0,11
1942996,1517244,2025-02-04,House,"House Judiciary: Adopt amendment L.002",11,0,0,0,11
1942996,1517245,2025-02-04,House,"House Judiciary: Postpone House Bill 25-1104 indefinitely using a reversal of the previous roll call. There was no objection to the use of the reverse roll call, therefore, the bill was postponed indefinitely.",7,4,0,0,11
1942996,1517246,2025-02-04,House,"House Judiciary: Refer House Bill 25-1104, as amended, to the Committee of the Whole.",4,7,0,0,11
1943010,1538831,2025-04-07,House,"House State, Civic, Military, & Veterans Affairs: Refer House Bill 25-1100 to the Committee of the Whole.",5,6,0,0,11
1943010,1551837,2025-04-07,House,"House State, Civic, Military, & Veterans Affairs: Postpone House Bill 25-1100 indefinitely using a reversal of the previous roll call. There was no objection to the use of the reverse roll call, therefore, the bill was postponed indefinitely.",6,5,0,0,11
1943011,1475318,2025-01-28,House,"House: RESOLUTIONS Res",62,0,0,3,65
1943011,1477305,2025-01-30,Senate,"Senate: Consideration of Resolutions Resolution",33,0,0,2,35
1943023,1498541,2025-02-24,House,"House Finance: Refer HCR25-1001 to the Committee on Appropriations.",6,7,0,0,13
1943023,1503079,2025-02-24,House,"House Finance: Postpone HCR25-1001 indefinitely using a reversal of the previous roll call. There was no objection to the use of the reverse roll call, therefore, the bill was postponed indefinitely.",7,6,0,0,13
1943035,1507839,2025-03-06,House,"House Energy & Environment: Postpone House Bill 25-1099 indefinitely.",12,0,0,1,13
1943057,1494301,2025-02-19,House,"House Transportation, Housing & Local Government: Adopt amendment L.002 (Attachment X)",13,0,0,0,13
1943057,1504523,2025-03-04,House,"House: Third Reading Amd (l.005)",60,2,0,3,65
1943057,1504524,2025-03-04,House,"House: Third Reading Bill",53,9,0,3,65
1943057,1504525,2025-03-04,House,"House: Third Reading Perm",61,1,0,3,65
1943057,1521787,2025-02-19,House,"House Transportation, Housing & Local Government: Refer House Bill 25-1108, as amended, to the Committee of the Whole.",11,2,0,0,13
1943057,1544566,2025-04-10,Senate,"Senate Local Government & Housing: Adopt amendment L.006 (Attachment B).",6,1,0,0,7
1943057,1546044,2025-04-10,Senate,"Senate Local Government & Housing: Refer House Bill 25-1108, as amended, to the Committee of the Whole and with a recommendation that it be placed on the consent calendar.",7,0,0,0,7
1943057,1546923,2025-04-14,Senate,"Senate: Third Reading Bill",33,0,0,2,35
1943057,1549427,2025-04-15,House,"House: Senate Amendments Concur",50,14,0,1,65
1943057,1549428,2025-04-15,House,"House: Senate Amendments Repass",52,12,0,1,65
1943069,1494224,2025-02-19,House,"House Health & Human Services: Adopt amendment L.002 (Attachment R).",13,0,0,0,13
1943069,1507550,2025-02-19,House,"House Health & Human Services: Adopt amendment L.003 (Attachment S).",13,0,0,0,13
1943069,1507551,2025-02-19,House,"House Health & Human Services: Refer House Bill 25-1094, as amended, to the Committee on Appropriations.",10,3,0,0,13
1943069,1508441,2025-03-07,House,"House Appropriations: Refer House Bill 25-1094 to the Committee of the Whole.",8,2,0,1,11
1943069,1518345,2025-03-17,House,"House: Third Reading Bill",48,15,0,2,65
1943069,1557668,2025-04-24,Senate,"Senate Health & Human Services: Adopt amendment L.033 (Attachment P).",9,0,0,0,9
1943069,1561780,2025-04-30,Senate,"Senate Appropriations: Refer House Bill 25-1094 to the Committee of the Whole.",7,0,0,0,7
1943069,1563926,2025-04-24,Senate,"Senate Health & Human Services: Refer House Bill 25-1094, as amended, to the Committee on Appropriations.",7,2,0,0,9
1943069,1566588,2025-05-06,Senate,"Senate: Third Reading Bill",29,6,0,0,35
1943069,1567154,2025-05-07,House,"House: Senate Amendments Concur",56,8,0,1,65
1943069,1567155,2025-05-07,House,"House: Senate Amendments Repass",49,16,0,0,65
1943078,1485524,2025-02-10,House,"House State, Civic, Military, & Veterans Affairs: Refer House Bill 25-1102 to the Committee of the Whole.",2,8,0,1,11
1943078,1489001,2025-02-10,House,"House State, Civic, Military, & Veterans Affairs: Postpone House Bill 25-1102 indefinitely using a reversal of the previous roll call. There was no objection to the use of the reverse roll call, therefore, the bill was postponed indefinitely.",8,2,0,1,11
1943090,1494993,2025-02-20,House,"House Agriculture, Water & Natural Resources: Adopt amendment L.001",13,0,0,0,13
1943090,1504630,2025-03-04,House,"House: Third Reading Bill",41,21,0,3,65
1943090,1509113,2025-02-20,House,"House Agriculture, Water & Natural Resources: Adopt amendment L.003",13,0,0,0,13
1943090,1509114,2025-02-20,House,"House Agriculture, Water & Natural Resources: Refer House Bill 25-1113, as amended, to the Committee of the Whole.",9,3,0,1,13
1943090,1529305,2025-03-27,Senate,"Senate Agriculture & Natural Resources: Adopt amendment L.010 (Attachment B).",7,0,0,0,7
1943090,1535822,2025-03-27,Senate,"Senate Agriculture & Natural Resources: Refer House Bill 25-1113, as amended, to the Committee of the Whole.",5,2,0,0,7
1943090,1537190,2025-04-04,Senate,"Senate: Third Reading Bill",24,11,0,0,35
1943090,1545995,2025-04-11,House,"House: Senate Amendments Concur",41,21,0,3,65
1943090,1545996,2025-04-11,House,"House: Senate Amendments Repass",41,21,0,3,65
1943112,1498410,2025-02-24,House,"House Finance: Adopt amendment L.001 (Attachment I).",13,0,0,0,13
1943112,1503074,2025-02-24,House,"House Finance: Postpone House Bill 25-1111 indefinitely using a reversal of the previous roll call. There was no objection to the use of the reverse roll call, therefore, the bill was postponed indefinitely.",8,5,0,0,13
1943112,1503075,2025-02-24,House,"House Finance: Refer House Bill 25-1111, as amended, to the Committee on Appropriations.",5,8,0,0,13
1943122,1493703,2025-02-19,House,"House Health & Human Services: Adopt amendment L.003 (Attachment F).",13,0,0,0,13
1943122,1507665,2025-02-19,House,"House Health & Human Services: Adopt amendment L.004 (Attachment G).",13,0,0,0,13
1943122,1507666,2025-02-19,House,"House Health & Human Services: Adopt amendment L.005 (Attachment H).",13,0,0,0,13
1943122,1507667,2025-02-19,House,"House Health & Human Services: Adopt amendment L.006 (Attachment I).",13,0,0,0,13
1943122,1507669,2025-02-19,House,"House Health & Human Services: Refer House Bill 25-1097, as amended, to the Committee on Appropriations.",9,4,0,0,13
1943122,1537023,2025-04-04,House,"House Appropriations: Adopt amendment L.007",11,0,0,0,11
1943122,1537891,2025-04-04,House,"House Appropriations: Refer House Bill 25-1097, as amended, to the Committee of the Whole.",7,4,0,0,11
1943122,1547519,2025-04-14,House,"House: Third Reading Bill",41,23,0,1,65
1943122,1557695,2025-04-24,Senate,"Senate Health & Human Services: Adopt amendment L.010 (Attachment M).",6,3,0,0,9
1943122,1561818,2025-04-30,Senate,"Senate: Third Reading Bill",31,4,0,0,35
1943122,1564033,2025-04-24,Senate,"Senate Health & Human Services: Refer House Bill 25-1097, as amended, to the Committee of the Whole.",6,3,0,0,9
1943122,1564034,2025-05-01,House,"House: Senate Amendments Concur",43,22,0,0,65
1943122,1564035,2025-05-01,House,"House: Senate Amendments Repass",44,21,0,0,65
1943134,1487131,2025-02-11,House,"House Judiciary: Adopt amendment L.001 (Attachment A)",11,0,0,0,11
1943134,1502236,2025-02-28,House,"House Appropriations: Refer House Bill 25-1116 to the Committee of the Whole.",10,0,0,1,11
1943134,1506083,2025-03-05,House,"House: Third Reading Bill",59,0,0,6,65
1943134,1519107,2025-02-11,House,"House Judiciary: Refer House Bill 25-1116, as amended, to the Committee on Appropriations.",11,0,0,0,11
1943134,1538616,2025-04-07,Senate,"Senate Judiciary: Refer House Bill 25-1116 to the Committee of the Whole and with a recommendation that it be placed on the consent calendar.",7,0,0,0,7
1943134,1545099,2025-04-10,Senate,"Senate: Third Reading Bill",33,0,0,2,35
1943143,1494722,2025-02-20,House,"House Agriculture, Water & Natural Resources: Refer House Bill 25-1115 to the Committee on Appropriations.",13,0,0,0,13
1943143,1502175,2025-02-28,House,"House Appropriations: Adopt amendment J.001",11,0,0,0,11
1943143,1505341,2025-03-04,House,"House: Third Reading Bill",52,9,0,4,65
1943143,1509224,2025-02-28,House,"House Appropriations: Refer House Bill 25-1115, as amended, to the Committee of the Whole.",8,2,0,1,11
1943143,1529231,2025-03-27,Senate,"Senate Agriculture & Natural Resources: Refer House Bill 25-1115 to the Committee on Appropriations.",7,0,0,0,7
1943143,1545702,2025-04-11,Senate,"Senate Appropriations: Refer House Bill 25-1115 to the Committee of the Whole and with a recommendation that it be placed on the consent calendar.",7,0,0,0,7
1943143,1546895,2025-04-14,Senate,"Senate: Third Reading Bill",32,1,0,2,35
1943193,1489185,2025-02-13,House,"House Energy & Environment: Postpone House Bill 25-1106 indefinitely.",12,0,0,1,13
1943228,1487491,2025-02-12,House,"House Transportation, Housing & Local Government: Adopt amendment L.001",13,0,0,0,13
1943228,1492033,2025-02-12,House,"House Transportation, Housing & Local Government: Refer House Bill 25-1093, as amended, to the Committee of the Whole.",11,1,0,1,13
1943228,1492034,2025-02-18,House,"House: Third Reading Bill",43,21,0,1,65
1943228,1507559,2025-03-06,Senate,"Senate Local Government & Housing: Adopt amendment L.005",7,0,0,0,7
1943228,1507987,2025-03-06,Senate,"Senate Local Government & Housing: Refer House Bill 25-1093, as amended, to the Committee of the Whole.",4,3,0,0,7
1943228,1517885,2025-03-14,Senate,"Senate: Third Reading Amend (l.008)",34,0,0,0,34
1943228,1517886,2025-03-14,Senate,"Senate: Third Reading Bill",21,13,0,0,34
1943228,1518361,2025-03-17,House,"House: Senate Amendments Concur",48,15,0,2,65
1943228,1518362,2025-03-17,House,"House: Senate Amendments Repass",47,16,0,2,65
1943264,1482549,2025-02-05,House,"House Judiciary: Adopt amendment L.001 (Attachment B)",11,0,0,0,11
1943264,1490486,2025-02-14,House,"House: Committee of the Whole Amd (h.001)",19,42,0,4,65
1943264,1490487,2025-02-14,House,"House: Committee of the Whole Amd (h.002)",22,39,0,4,65
1943264,1491807,2025-02-18,House,"House: Third Reading Bill",42,22,0,1,65
1943264,1504615,2025-03-03,Senate,"Senate Judiciary: L.007",7,0,0,0,7
1943264,1504616,2025-03-03,Senate,"Senate Judiciary: Refer House Bill 25-1114, as amended, to the Committee of the Whole.",4,3,0,0,7
1943264,1508566,2025-03-07,Senate,"Senate: Third Reading Bill",23,8,0,3,34
1943264,1511448,2025-03-10,House,"House: Senate Amendments Concur",41,21,0,3,65
1943264,1511449,2025-03-10,House,"House: Senate Amendments Repass",40,22,0,3,65
1943264,1519230,2025-02-05,House,"House Judiciary: Adopt amendment L.002 (Attachment C)",11,0,0,0,11
1943264,1519231,2025-02-05,House,"House Judiciary: Refer House Bill 25-1114, as amended, to the Committee of the Whole.",8,3,0,0,11
1943299,1495314,2025-02-20,House,"House Energy & Environment: Adopt amendment L.001",13,0,0,0,13
1943299,1515877,2025-02-20,House,"House Energy & Environment: Adopt amendment L.002",13,0,0,0,13
1943299,1515878,2025-02-20,House,"House Energy & Environment: Adopt amendment L.003",13,0,0,0,13
1943299,1515879,2025-02-20,House,"House Energy & Environment: Refer House Bill 25-1096, as amended, to the Committee on Finance.",9,4,0,0,13
1943299,1523270,2025-03-20,House,"House Finance: Adopt amendment L.006 (Attachment F).",13,0,0,0,13
1943299,1531351,2025-03-31,House,"House: Third Reading Bill",42,22,0,1,65
1943299,1543857,2025-03-20,House,"House Finance: Refer House Bill 25-1096, as amended, to the Committee of the Whole.",9,4,0,0,13
1943299,1550202,2025-04-16,Senate,"Senate Transportation & Energy: Refer House Bill 25-1096 to the Committee of the Whole.",5,1,0,3,9
1943299,1552667,2025-04-21,Senate,"Senate: Committee of the Whole Adopt Report",29,6,0,0,35
1943299,1558802,2025-04-28,Senate,"Senate: Third Reading Bill",24,10,0,1,35
1943335,1495692,2025-02-20,House,"House Finance: Adopt amendment L.001",13,0,0,0,13
1943335,1498198,2025-02-20,House,"House Finance: Refer House Bill 25-1103, as amended, to the Committee on Appropriations.",11,1,0,1,13
1943370,1485655,2025-02-10,House,"House State, Civic, Military, & Veterans Affairs: Refer House Bill 25-1107 to the Committee on Appropriations.",3,8,0,0,11
1943370,1490731,2025-02-10,House,"House State, Civic, Military, & Veterans Affairs: Postpone House Bill 25-1107 indefinitely using a reversal of the previous roll call. There was no objection to the use of the reverse roll call, therefore, the bill was postponed indefinitely.",8,3,0,0,11
1943404,1520585,2025-03-17,House,"House Finance: Adopt amendment L.001 (Attachment I).",13,0,0,0,13
1943404,1522480,2025-03-17,House,"House Finance: Adopt amendment L.002 (Attachment J).",13,0,0,0,13
1943404,1522481,2025-03-17,House,"House Finance: Refer House Bill 25-1105, as amended, to the Committee on Appropriations.",11,2,0,0,13
1943404,1537063,2025-04-04,House,"House Appropriations: Refer House Bill 25-1105 to the Committee of the Whole.",6,5,0,0,11
1943404,1547092,2025-04-14,House,"House: Third Reading Amd (l.009)",46,18,0,1,65
1943404,1547093,2025-04-14,House,"House: Third Reading Bill",44,20,0,1,65
1943404,1547094,2025-04-14,House,"House: Third Reading Perm",50,14,0,1,65
1943404,1553782,2025-04-22,Senate,"Senate Finance: Refer House Bill 25-1105 to the Committee on Appropriations.",8,1,0,0,9
1943404,1558197,2025-04-25,Senate,"Senate Appropriations: Refer House Bill 25-1105 to the Committee of the Whole.",6,1,0,0,7
1943404,1558198,2025-04-25,Senate,"Senate: Committee of the Whole Adopt Report",35,0,0,0,35
1943404,1559020,2025-04-28,Senate,"Senate: Third Reading Bill",31,3,0,1,35
1944599,1508384,2025-03-06,House,"House Energy & Environment: Refer House Bill 25-1126 to the Committee on Finance.",9,4,0,0,13
1944599,1518683,2025-03-17,House,"House Finance: Adopt amendment L.004 (Attachment A).",13,0,0,0,13
1944599,1522790,2025-03-17,House,"House Finance: Refer House Bill 25-1126, as amended, to the Committee on Appropriations.",8,5,0,0,13
1944631,1495052,2025-02-20,House,"House State, Civic, Military, & Veterans Affairs: Adopt amendment L.001 (Attachment C).",11,0,0,0,11
1944631,1496636,2025-02-20,House,"House State, Civic, Military, & Veterans Affairs: Refer House Bill 25-1128, as amended, to the Committee on Finance.",8,3,0,0,11
1944631,1509750,2025-03-10,House,"House Finance: Postpone House Bill 25-1128 indefinitely.",13,0,0,0,13
1944665,1486179,2025-02-11,House,"House Health & Human Services: Refer House Bill 25-1124 to the Committee of the Whole.",10,3,0,0,13
1944665,1489974,2025-02-14,House,"House: Committee of the Whole Amd (h.001)",60,1,0,4,65
1944665,1493967,2025-02-19,House,"House: Third Reading Bill",41,22,0,2,65
1944665,1522940,2025-03-20,Senate,"Senate Health & Human Services: Refer House Bill 25-1124 to the Committee of the Whole.",8,1,0,0,9
1944665,1527568,2025-03-26,Senate,"Senate: Third Reading Bill",34,0,0,1,35
1944700,1493560,2025-02-19,House,"House Transportation, Housing & Local Government: Adopt amendment L.002 (Attachment A)",13,0,0,0,13
1944700,1521676,2025-02-19,House,"House Transportation, Housing & Local Government: Adopt amendment L.003 (Attachment B)",13,0,0,0,13
1944700,1521677,2025-02-19,House,"House Transportation, Housing & Local Government: Adopt amendment L.004 (Attachment C)",13,0,0,0,13
1944700,1521678,2025-02-19,House,"House Transportation, Housing & Local Government: Adopt amendment L.005 (Attachment D)",13,0,0,0,13
1944700,1521679,2025-02-19,House,"House Transportation, Housing & Local Government: Adopt amendment L.007 (Attachment E)",13,0,0,0,13
1944700,1521680,2025-02-19,House,"House Transportation, Housing & Local Government: Refer House Bill 25-1122, as amended, to the Committee on Appropriations.",12,1,0,0,13
1944700,1553365,2025-04-22,House,"House Appropriations: Refer House Bill 25-1122 to the Committee of the Whole.",10,1,0,0,11
1944700,1555502,2025-04-23,House,"House: Third Reading Bill",55,9,0,1,65
1944700,1559098,2025-04-28,Senate,"Senate Transportation & Energy: Refer House Bill 25-1122 to the Committee on Appropriations.",5,4,0,0,9
1944700,1561733,2025-04-30,Senate,"Senate Appropriations: Refer House Bill 25-1122 to the Committee of the Whole.",6,1,0,0,7
1944700,1565818,2025-05-06,Senate,"Senate: Third Reading Bill",27,8,0,0,35
1944734,1482427,2025-02-05,House,"House Judiciary: Adopt amendment L.003 (Attachment A)",11,0,0,0,11
1944734,1484597,2025-02-10,House,"House: Third Reading Bill",50,13,0,2,65
1944734,1498415,2025-02-24,Senate,"Senate Judiciary: Refer House Bill 25-1129 to the Committee of the Whole.",5,2,0,0,7
1944734,1502345,2025-02-28,Senate,"Senate: Third Reading Bill",23,6,0,5,34
1944734,1519037,2025-02-05,House,"House Judiciary: Refer House Bill 25-1129, as amended, to the Committee of the Whole.",7,4,0,0,11
1944765,1507905,2025-03-06,House,"House Business Affairs & Labor: Adopt amendment L.001",13,0,0,0,13
1944765,1525990,2025-03-25,House,"House Appropriations: Refer House Bill 25-1130 to the Committee of the Whole.",6,3,0,2,11
1944765,1531235,2025-03-31,House,"House: Third Reading Bill",40,22,0,3,65
1944765,1553761,2025-03-06,House,"House Business Affairs & Labor: Refer House Bill 25-1130, as amended, to the Committee on Appropriations.",8,5,0,0,13
1944765,1554456,2025-04-22,Senate,"Senate Business, Labor, & Technology: Refer House Bill 25-1130 to the Committee of the Whole.",4,3,0,0,7
1944765,1558195,2025-04-25,Senate,"Senate: Committee of the Whole Cow * (s.001)",12,23,0,0,35
1944765,1558818,2025-04-28,Senate,"Senate: Third Reading Bill",22,12,0,1,35
1944800,1485402,2025-02-06,House,"House Education: Refer House Bill 25-1131 to the Committee of the Whole.",13,0,0,0,13
1944800,1489443,2025-02-13,House,"House: Third Reading Bill",65,0,0,0,65
1944800,1504001,2025-03-03,Senate,"Senate Education: Refer House Bill 25-1131 to the Committee of the Whole and with a recommendation that it be placed on the consent calendar.",7,0,0,0,7
1944800,1508571,2025-03-07,Senate,"Senate: Third Reading Bill",31,0,0,3,34
1944835,1487211,2025-02-11,House,"House Transportation, Housing & Local Government: Adopt amendment L.001",13,0,0,0,13
1944835,1493640,2025-02-11,House,"House Transportation, Housing & Local Government: Refer House Bill 25-1127, as amended, to the Committee on Finance.",9,4,0,0,13
1944835,1501302,2025-02-27,House,"House Finance: Adopt amendment L.002",8,5,0,0,13
1944835,1501884,2025-02-27,House,"House Finance: Refer House Bill 25-1127, as amended, to the Committee on Appropriations.",8,5,0,0,13
1944867,1489387,2025-02-13,House,"House Energy & Environment: Adopt amendment L.002",13,0,0,0,13
1944867,1503606,2025-03-03,House,"House Finance: Refer House Bill 25-1120 to the Committee on Appropriations.",7,5,0,1,13
1944867,1515749,2025-02-13,House,"House Energy & Environment: Refer House Bill 25-1120, as amended, to the Committee on Finance.",9,4,0,0,13
1944901,1502188,2025-02-28,House,"House Appropriations: Refer House Bill 25-1125 to the Committee of the Whole.",3,7,0,1,11
1944901,1509177,2025-02-28,House,"House Appropriations: Postpone House Bill 25-1125 indefinitely using a reversal of the previous roll call. There was no objection to the use of the reverse roll call, therefore, the bill was postponed indefinitely.",7,3,0,1,11
1944933,1489685,2025-02-13,House,"House Business Affairs & Labor: Adopt amendment L.002",13,0,0,0,13
1944933,1496197,2025-02-13,House,"House Business Affairs & Labor: Adopt amendment L.004",13,0,0,0,13
1944933,1496198,2025-02-13,House,"House Business Affairs & Labor: Refer House Bill 25-1133, as amended, to the Committee of the Whole.",7,6,0,0,13
1944933,1496913,2025-02-21,House,"House: Committee of the Whole Amd (h.001)",22,37,0,6,65
1944933,1496914,2025-02-21,House,"House: Committee of the Whole Amd (h.002)",24,35,0,6,65
1944933,1498807,2025-02-25,House,"House: Third Reading Amd (l.047)",60,1,0,4,65
1944933,1498808,2025-02-25,House,"House: Third Reading Bill",38,27,0,0,65
1944933,1498809,2025-02-25,House,"House: Third Reading Perm",56,5,0,4,65
1944933,1498810,2025-02-25,House,"House: Third Reading Rerefer (bus)",22,39,0,4,65
1944933,1520018,2025-03-18,Senate,"Senate State, Veterans, & Military Affairs: Adopt amendment L.048 (Attachment E).",5,0,0,0,5
1944933,1524042,2025-03-18,Senate,"Senate State, Veterans, & Military Affairs: Adopt amendment L.049 (Attachment F).",5,0,0,0,5
1944933,1524043,2025-03-18,Senate,"Senate State, Veterans, & Military Affairs: Adopt amendment L.050 (Attachment G).",5,0,0,0,5
1944933,1524044,2025-03-18,Senate,"Senate State, Veterans, & Military Affairs: Refer House Bill 25-1133, as amended, to the Committee of the Whole.",3,2,0,0,5
1944933,1525364,2025-03-24,Senate,"Senate: Committee of the Whole Cow * (s.001)",13,18,0,4,35
1944933,1525366,2025-03-24,Senate,"Senate: Committee of the Whole Cow * (s.002)",13,18,0,4,35
1944933,1525845,2025-03-25,Senate,"Senate: Third Reading Bill",19,16,0,0,35
1944933,1530222,2025-03-28,House,"House: Senate Amendments Concur",43,20,0,2,65
1944933,1530223,2025-03-28,House,"House: Senate Amendments Repass",38,25,0,2,65
1944965,1500647,2025-02-26,Senate,"Senate Education: Adopt amendment L.002",7,0,0,0,7
1944965,1504389,2025-03-04,Senate,"Senate: Third Reading Bill",21,12,0,1,34
1944965,1508157,2025-02-26,Senate,"Senate Education: Adopt amendment L.003",7,0,0,0,7
1944965,1508158,2025-02-26,Senate,"Senate Education: Refer Senate Bill 25-087, as amended, to the Committee of the Whole.",4,3,0,0,7
1944965,1523279,2025-03-20,House,"House Education: Adopt amendment L.005",13,0,0,0,13
1944965,1531194,2025-03-31,House,"House: Third Reading Bill",58,5,0,2,65
1944965,1537382,2025-04-04,Senate,"Senate: House Amendments Concur",34,1,0,0,35
1944965,1537383,2025-04-04,Senate,"Senate: House Amendments Repass",23,12,0,0,35
1944965,1542540,2025-03-20,House,"House Education: Refer Senate Bill 25-087, as amended, to the Committee of the Whole.",12,1,0,0,13
1945000,1501130,2025-02-27,House,"House Finance: Adopt amendment L.003 (Attachment D).",13,0,0,0,13
1945000,1502044,2025-02-27,House,"House Finance: Refer House Bill 25-1121, as amended, to the Committee on Appropriations.",13,0,0,0,13
1945000,1557990,2025-04-25,House,"House Appropriations: Refer House Bill 25-1121 to the Committee of the Whole.",11,0,0,0,11
1945000,1561972,2025-04-30,House,"House: Third Reading Amd (l.004)",64,1,0,0,65
1945000,1561973,2025-04-30,House,"House: Third Reading Bill",64,1,0,0,65
1945000,1561974,2025-04-30,House,"House: Third Reading Perm",63,2,0,0,65
1945000,1563921,2025-05-01,Senate,"Senate Finance: Refer House Bill 25-1121 to the Committee on Appropriations.",7,1,0,1,9
1945000,1564462,2025-05-02,Senate,"Senate Appropriations: Refer House Bill 25-1121 to the Committee of the Whole and with a recommendation that it be placed on the consent calendar.",7,0,0,0,7
1945000,1564827,2025-05-05,Senate,"Senate: Third Reading Bill",35,0,0,0,35
1945035,1494484,2025-02-19,House,"House Health & Human Services: Adopt amendment L.001 (Attachment P).",13,0,0,0,13
1945035,1502176,2025-02-28,House,"House Appropriations: Adopt amendment J.001",8,2,0,1,11
1945035,1504240,2025-03-04,House,"House: Third Reading Bill",41,20,0,4,65
1945035,1507731,2025-02-19,House,"House Health & Human Services: Refer House Bill 25-1132, as amended, to the Committee on Appropriations.",9,4,0,0,13
1945035,1509307,2025-02-28,House,"House Appropriations: Refer House Bill 25-1132, as amended, to the Committee of the Whole.",8,2,0,1,11
1945035,1528663,2025-03-27,Senate,"Senate State, Veterans, & Military Affairs: Refer House Bill 25-1132 to the Committee of the Whole.",3,2,0,0,5
1945035,1537421,2025-04-04,Senate,"Senate: Third Reading Bill",27,7,0,1,35
1945067,1501802,2025-02-27,House,"House Energy & Environment: Adopt amendment L.001",13,0,0,0,13
1945067,1517391,2025-02-27,House,"House Energy & Environment: Adopt amendment L.002",13,0,0,0,13
1945067,1517392,2025-02-27,House,"House Energy & Environment: Adopt amendment L.005",13,0,0,0,13
1945067,1517393,2025-02-27,House,"House Energy & Environment: Postpone House Bill 25-1119 indefinitely using a reversal of the previous roll call. There was no objection to the use of the reverse roll call, therefore, the bill was postponed indefinitely.",8,5,0,0,13
1945067,1517394,2025-02-27,House,"House Energy & Environment: Refer House Bill 25-1119, as amended, to the Committee on Appropriations.",5,8,0,0,13
1945093,1499327,2025-02-25,House,"House Judiciary: Adopt amendment L.001 (Attachment B)",11,0,0,0,11
1945093,1526728,2025-02-25,House,"House Judiciary: Adopt amendment L.003 (Attachment C)",7,4,0,0,11
1945093,1526729,2025-02-25,House,"House Judiciary: Adopt amendment L.004 (Attachment D)",11,0,0,0,11
1945093,1526730,2025-02-25,House,"House Judiciary: Adopt amendment L.005 (Attachment E)",11,0,0,0,11
1945093,1526731,2025-02-25,House,"House Judiciary: Refer House Bill 25-1123, as amended, to the Committee of the Whole.",7,4,0,0,11
1945093,1559042,2025-04-28,House,"House: Third Reading Amd (l.009)",43,22,0,0,65
1945093,1559043,2025-04-28,House,"House: Third Reading Bill",39,26,0,0,65
1945093,1559044,2025-04-28,House,"House: Third Reading Perm",43,22,0,0,65
1945093,1564336,2025-05-01,Senate,"Senate Local Government & Housing: Adopt amendment L.010",7,0,0,0,7
1945093,1564534,2025-05-01,Senate,"Senate Local Government & Housing: Postpone House Bill 25-1123 indefinitely using a reversal of the previous roll call. There was no objection to the use of the reverse roll call, therefore, the bill was postponed indefinitely.",4,3,0,0,7
1945093,1564535,2025-05-01,Senate,"Senate Local Government & Housing: Refer House Bill 25-1123, as amended, to the Committee of the Whole.",3,4,0,0,7
1945998,1478120,2025-01-31,Senate,"Senate: Consideration of Resolutions Resolution",34,0,0,1,35
1947451,1498272,2025-02-24,House,"House Finance: Adopt amendment L.002 (Attachment K).",13,0,0,0,13
1947451,1503036,2025-02-24,House,"House Finance: Postpone House Bill 25-1139 indefinitely using a reversal of the previous roll call. There was no objection to the use of the reverse roll call, therefore, the bill was postponed indefinitely.",10,3,0,0,13
1947451,1503037,2025-02-24,House,"House Finance: Refer House Bill 25-1139, as amended, to the Committee on Appropriations.",3,10,0,0,13
1947458,1493019,2025-02-19,House,"House Education: Adopt amendment L.001",13,0,0,0,13
1947458,1496486,2025-02-19,House,"House Education: Refer House Bill 25-1135, as amended, to the Committee of the Whole.",12,1,0,0,13
1947458,1498658,2025-02-25,House,"House: Third Reading Bill",49,16,0,0,65
1947458,1527935,2025-03-26,Senate,"Senate Education: Adopt amendment L.002",7,0,0,0,7
1947458,1534614,2025-03-26,Senate,"Senate Education: Refer House Bill 25-1135, as amended, to the Committee of the Whole.",7,0,0,0,7
1947458,1537136,2025-04-04,Senate,"Senate: Third Reading Bill",33,1,0,1,35
1947458,1546002,2025-04-11,House,"House: Senate Amendments Concur",49,13,0,3,65
1947458,1546003,2025-04-11,House,"House: Senate Amendments Repass",46,16,0,3,65
1947468,1492530,2025-02-18,House,"House Transportation, Housing & Local Government: Adopt amendment L.006",13,0,0,0,13
1947468,1497695,2025-02-18,House,"House Transportation, Housing & Local Government: Postpone House Bill 25-1144 indefinitely using a reversal of the previous roll call. There was no objection to the use of the reverse roll call, therefore, the bill was postponed indefinitely.",9,4,0,0,13
1947468,1497696,2025-02-18,House,"House Transportation, Housing & Local Government: Refer House Bill 25-1144, as amended, to the Committee on Appropriations.",4,9,0,0,13
1947477,1498348,2025-02-24,House,"House Finance: Refer House Bill 25-1156 to the Committee on Appropriations.",12,0,0,1,13
1947488,1494261,2025-02-19,House,"House Judiciary: This is a conceptual amendment",11,0,0,0,11
1947488,1526631,2025-02-19,House,"House Judiciary: Adopt amendment L.002 (Attachment D)",11,0,0,0,11
1947488,1526632,2025-02-19,House,"House Judiciary: Postpone House Bill 25-1142 indefinitely using a reversal of the previous roll call. There was no objection to the use of the reverse roll call, therefore, the bill was postponed indefinitely.",7,4,0,0,11
1947488,1526633,2025-02-19,House,"House Judiciary: Refer House Bill 25-1142, as amended, to the Committee on Appropriations.",4,7,0,0,11
1947498,1492714,2025-02-18,House,"House Judiciary: Postpone House Bill 25-1140 indefinitely.",9,0,0,2,11
1947507,1498266,2025-02-24,House,"House Finance: Postpone House Bill 25-1150 indefinitely.",12,0,0,1,13
1947518,1485447,2025-02-10,House,"House State, Civic, Military, & Veterans Affairs: Refer House Bill 25-1143 to the Committee on Appropriations.",2,8,0,1,11
1947518,1490725,2025-02-10,House,"House State, Civic, Military, & Veterans Affairs: Postpone House Bill 25-1143 indefinitely using a reversal of the previous roll call. There was no objection to the use of the reverse roll call, therefore, the bill was postponed indefinitely.",8,2,0,1,11
1947528,1501003,2025-02-26,House,"House Judiciary: Adopt amendment L.001 (Attachment J)",11,0,0,0,11
1947528,1505977,2025-03-05,House,"House: Third Reading Bill",39,23,0,3,65
1947528,1531345,2025-03-31,Senate,"Senate Judiciary: Refer House Bill 25-1148 to the Committee of the Whole.",4,3,0,0,7
1947528,1532438,2025-02-26,House,"House Judiciary: Adopt amendment L.002 (Attachment K)",11,0,0,0,11
1947528,1532439,2025-02-26,House,"House Judiciary: Adopt amendment L.003 (Attachment L)",11,0,0,0,11
1947528,1532440,2025-02-26,House,"House Judiciary: Refer House Bill 25-1148, as amended, to the Committee of the Whole.",7,4,0,0,11
1947528,1537236,2025-04-04,Senate,"Senate: Third Reading Bill",22,12,0,1,35
1947537,1485403,2025-02-10,House,"House State, Civic, Military, & Veterans Affairs: Adopt amendment L.004 (Attachment D).",11,0,0,0,11
1947537,1488961,2025-02-10,House,"House State, Civic, Military, & Veterans Affairs: Adopt amendment L.005 (Attachment E).",11,0,0,0,11
1947537,1488962,2025-02-10,House,"House State, Civic, Military, & Veterans Affairs: Refer House Bill 25-1155, as amended, to the Committee of the Whole.",11,0,0,0,11
1947537,1488963,2025-02-13,House,"House: Third Reading Bill",65,0,0,0,65
1947537,1507849,2025-03-06,Senate,"Senate State, Veterans, & Military Affairs: Refer House Bill 25-1155 to the Committee of the Whole and with a recommendation that it be placed on the consent calendar.",5,0,0,0,5
1947537,1516466,2025-03-12,Senate,"Senate: Third Reading Bill",34,0,0,0,34
1947548,1483810,2025-02-06,House,"House Finance: Refer House Bill 25-1157 to the Committee on Appropriations.",10,3,0,0,13
1947548,1560675,2025-04-29,House,"House Appropriations: Refer House Bill 25-1157 to the Committee of the Whole.",9,2,0,0,11
1947548,1562096,2025-04-30,House,"House: Third Reading Bill",57,8,0,0,65
1947548,1564053,2025-05-01,Senate,"Senate Finance: Refer House Bill 25-1157 to the Committee on Appropriations.",8,0,0,1,9
1947548,1564496,2025-05-02,Senate,"Senate Appropriations: Refer House Bill 25-1157 to the Committee of the Whole and with a recommendation that it be placed on the consent calendar.",7,0,0,0,7
1947548,1564822,2025-05-05,Senate,"Senate: Third Reading Bill",35,0,0,0,35
1947558,1493687,2025-02-19,House,"House Health & Human Services: Adopt amendment L.002 (Attachment C).",13,0,0,0,13
1947558,1507572,2025-02-19,House,"House Health & Human Services: Refer House Bill 25-1154, as amended, to the Committee on Appropriations.",8,4,0,1,13
1947558,1508439,2025-03-07,House,"House Appropriations: Adopt amendment L.003",11,0,0,0,11
1947558,1509115,2025-03-07,House,"House Appropriations: Adopt amendment J.002",11,0,0,0,11
1947558,1509116,2025-03-07,House,"House Appropriations: Refer House Bill 25-1154, as amended, to the Committee of the Whole.",7,3,0,1,11
1947558,1512597,2025-03-11,House,"House: Third Reading Bill",38,21,0,6,65
1947558,1528952,2025-03-27,Senate,"Senate Business, Labor, & Technology: Adopt amendment L.005",7,0,0,0,7
1947558,1539878,2025-03-27,Senate,"Senate Business, Labor, & Technology: Adopt amendment L.006",7,0,0,0,7
1947558,1539879,2025-03-27,Senate,"Senate Business, Labor, & Technology: Adopt amendment L.007",7,0,0,0,7
1947558,1539880,2025-03-27,Senate,"Senate Business, Labor, & Technology: Adopt amendment L.008",7,0,0,0,7
1947558,1539881,2025-03-27,Senate,"Senate Business, Labor, & Technology: Adopt amendment L.009",7,0,0,0,7
1947558,1539882,2025-03-27,Senate,"Senate Business, Labor, & Technology: Refer House Bill 25-1154, as amended, to the Committee on Appropriations.",4,3,0,0,7
1947558,1545780,2025-04-11,Senate,"Senate Appropriations: Adopt amendment J.004",7,0,0,0,7
1947558,1545781,2025-04-11,Senate,"Senate Appropriations: Adopt amendment L.011",7,0,0,0,7
1947558,1545782,2025-04-11,Senate,"Senate Appropriations: Refer House Bill 25-1154, as amended, to the Committee of the Whole.",4,3,0,0,7
1947558,1551073,2025-04-17,Senate,"Senate: Third Reading Bill",24,11,0,0,35
1947558,1555173,2025-04-23,House,"House: Senate Amendments Not Cncr",43,20,0,2,65
1947558,1560519,2025-04-29,Senate,"Senate: Conference Committee Report Adopt Ccr",32,0,0,3,35
1947558,1560520,2025-04-29,Senate,"Senate: Conference Committee Report Repass",20,12,0,3,35
1947558,1564039,2025-05-01,House,"House: Conference Committee Report Adopt",43,22,0,0,65
1947558,1564040,2025-05-01,House,"House: Conference Committee Report Repass",43,22,0,0,65
1947567,1485450,2025-02-10,House,"House Agriculture, Water & Natural Resources: Adopt amendment L.002",13,0,0,0,13
1947567,1500237,2025-02-10,House,"House Agriculture, Water & Natural Resources: Postpone House Bill 25-1134 indefinitely using a reversal of the previous roll call. There was no objection to the use of the reverse roll call, therefore, the bill was postponed indefinitely.",10,3,0,0,13
1947567,1500238,2025-02-10,House,"House Agriculture, Water & Natural Resources: Refer House Bill 25-1134, as amended, to the Committee of the Whole.",3,10,0,0,13
1947578,1485034,2025-02-10,House,"House Agriculture, Water & Natural Resources: Adopt amendment L.002",13,0,0,0,13
1947578,1491928,2025-02-18,House,"House: Third Reading Bill",39,25,0,1,65
1947578,1500087,2025-02-10,House,"House Agriculture, Water & Natural Resources: Refer House Bill 25-1137, as amended, to the Committee of the Whole.",8,4,0,1,13
1947578,1523065,2025-03-20,Senate,"Senate Agriculture & Natural Resources: Adopt amendment L.007 (Attachment B).",7,0,0,0,7
1947578,1527449,2025-03-26,Senate,"Senate: Third Reading Bill",25,9,0,1,35
1947578,1530156,2025-03-28,House,"House: Senate Amendments Concur",44,19,0,2,65
1947578,1530157,2025-03-28,House,"House: Senate Amendments Repass",41,22,0,2,65
1947578,1530817,2025-03-20,Senate,"Senate Agriculture & Natural Resources: Adopt amendment L.008 (Attachment C).",7,0,0,0,7
1947578,1530818,2025-03-20,Senate,"Senate Agriculture & Natural Resources: Refer House Bill 25-1137, as amended, to the Committee of the Whole.",5,2,0,0,7
1947587,1487043,2025-02-11,House,"House Judiciary: Refer House Bill 25-1145 to the Committee on Appropriations.",4,7,0,0,11
1947587,1518613,2025-02-11,House,"House Judiciary: Postpone House Bill 25-1145 indefinitely using a reversal of the previous roll call. There was no objection to the use of the reverse roll call, therefore, the bill was postponed indefinitely.",7,4,0,0,11
1947597,1540136,2025-04-08,House,"House Health & Human Services: Adopt amendment L.013 (Attachment C).",13,0,0,0,13
1947597,1551240,2025-04-17,House,"House Appropriations: Adopt amendment J.002",11,0,0,0,11
1947597,1553414,2025-04-17,House,"House Appropriations: Refer House Bill 25-1146, as amended, to the Committee of the Whole.",9,2,0,0,11
1947597,1555207,2025-04-08,House,"House Health & Human Services: Adopt amendment L.005 (Attachment B).",13,0,0,0,13
1947597,1555208,2025-04-08,House,"House Health & Human Services: Refer House Bill 25-1146, as amended, to the Committee on Appropriations.",12,1,0,0,13
1947597,1555209,2025-04-23,House,"House: Third Reading Amd (l.016)",57,8,0,0,65
1947597,1555210,2025-04-23,House,"House: Third Reading Bill",56,9,0,0,65
1947597,1555211,2025-04-23,House,"House: Third Reading Perm",55,10,0,0,65
1947597,1562289,2025-04-30,Senate,"Senate Health & Human Services: Refer House Bill 25-1146 to the Committee on Appropriations.",8,1,0,0,9
1947597,1563529,2025-05-01,Senate,"Senate Appropriations: Adopt amendment J.003",7,0,0,0,7
1947597,1563530,2025-05-01,Senate,"Senate Appropriations: Refer House Bill 25-1146, as amended, to the Committee of the Whole and with a recommendation that it be placed on the consent calendar.",7,0,0,0,7
1947597,1564465,2025-05-02,Senate,"Senate: Third Reading Bill",31,3,0,1,35
1947597,1565083,2025-05-05,House,"House: Senate Amendments Concur",58,6,0,1,65
1947597,1565084,2025-05-05,House,"House: Senate Amendments Repass",55,9,0,1,65
1947608,1494187,2025-02-19,House,"House Health & Human Services: Adopt amendment L.001 (Attachment K).",13,0,0,0,13
1947608,1502271,2025-02-28,House,"House: Third Reading Bill",40,21,0,4,65
1947608,1507195,2025-02-19,House,"House Health & Human Services: Adopt amendment L.002 (Attachment L).",13,0,0,0,13
1947608,1507196,2025-02-19,House,"House Health & Human Services: Adopt amendment L.003 (Attachment M).",13,0,0,0,13
1947608,1507197,2025-02-19,House,"House Health & Human Services: Adopt amendment L.006 (Attachment N).",13,0,0,0,13
1947608,1507198,2025-02-19,House,"House Health & Human Services: Refer House Bill 25-1151, as amended, to the Committee of the Whole.",11,2,0,0,13
1947608,1544657,2025-04-10,Senate,"Senate Health & Human Services: Refer House Bill 25-1151 to the Committee of the Whole.",4,5,0,0,9
1947608,1560165,2025-04-10,Senate,"Senate Health & Human Services: Postpone House Bill 25-1151 indefinitely using a reversal of the previous roll call. There was no objection to the use of the reverse roll call, therefore, the bill was postponed indefinitely.",5,4,0,0,9
1947617,1500931,2025-02-26,House,"House Judiciary: Adopt amendment L.001 (Attachment C).",11,0,0,0,11
1947617,1506004,2025-03-05,House,"House: Committee of the Whole Amd (h.001)",23,39,0,3,65
1947617,1508778,2025-03-07,House,"House: Third Reading Bill",37,27,0,1,65
1947617,1531715,2025-03-31,Senate,"Senate Judiciary: Adopt amendment L.013 (Attachment H)",7,0,0,0,7
1947617,1532416,2025-02-26,House,"House Judiciary: Adopt amendment L.002 (Attachment D)",11,0,0,0,11
1947617,1532417,2025-02-26,House,"House Judiciary: Adopt amendment L.003 (Attachment E)",11,0,0,0,11
1947617,1532418,2025-02-26,House,"House Judiciary: Adopt amendment L.005 (Attachment F)",11,0,0,0,11
1947617,1532419,2025-02-26,House,"House Judiciary: Adopt amendment L.006 (Attachment G)",11,0,0,0,11
1947617,1532420,2025-02-26,House,"House Judiciary: Adopt amendment L.007 (Attachment H)",11,0,0,0,11
1947617,1532421,2025-02-26,House,"House Judiciary: Refer House Bill 25-1147, as amended, to the Committee of the Whole.",6,5,0,0,11
1947617,1537033,2025-04-04,Senate,"Senate: Third Reading Bill",24,10,0,1,35
1947617,1537260,2025-04-04,Senate,"Senate: Third Reading Bill",24,11,0,0,35
1947617,1538435,2025-03-31,Senate,"Senate Judiciary: Adopt amendment L.015 (Attachment I)",7,0,0,0,7
1947617,1538436,2025-03-31,Senate,"Senate Judiciary: Refer House Bill 25-1147, as amended, to the Committee of the Whole.",5,2,0,0,7
1947617,1555159,2025-04-23,House,"House: Senate Amendments Concur",44,19,0,2,65
1947617,1555160,2025-04-23,House,"House: Senate Amendments Repass",41,22,0,2,65
1947627,1482161,2025-02-05,House,"House Education: Refer House Bill 25-1152 to the Committee of the Whole.",12,0,0,1,13
1947627,1484778,2025-02-10,House,"House: Third Reading Bill",57,6,0,2,65
1947627,1528157,2025-03-26,Senate,"Senate Education: Adopt amendment L.001",7,0,0,0,7
1947627,1534709,2025-03-26,Senate,"Senate Education: Refer House Bill 25-1152, as amended, to the Committee of the Whole.",5,2,0,0,7
1947627,1537083,2025-04-04,Senate,"Senate: Third Reading Bill",31,3,0,1,35
1947627,1546203,2025-04-11,House,"House: Senate Amendments Concur",55,7,0,3,65
1947627,1546204,2025-04-11,House,"House: Senate Amendments Repass",54,8,0,3,65
1947638,1485758,2025-02-10,House,"House State, Civic, Military, & Veterans Affairs: Adopt amendment L.001 (Attachment H).",11,0,0,0,11
1947638,1488865,2025-02-10,House,"House State, Civic, Military, & Veterans Affairs: Refer House Bill 25-1153, as amended, to the Committee on Appropriations.",8,3,0,0,11
1947638,1553764,2025-04-22,House,"House Appropriations: Adopt amendment L.002",11,0,0,0,11
1947638,1555641,2025-04-23,House,"House: Third Reading Bill",42,22,0,1,65
1947638,1560098,2025-04-22,House,"House Appropriations: Adopt amendment J.001",11,0,0,0,11
1947638,1560099,2025-04-22,House,"House Appropriations: Refer House Bill 25-1153, as amended, to the Committee of the Whole.",7,4,0,0,11
1947638,1561424,2025-04-29,Senate,"Senate State, Veterans, & Military Affairs: Refer House Bill 25-1153 to the Committee on Appropriations.",3,1,0,1,5
1947638,1564046,2025-05-01,Senate,"Senate Appropriations: Refer House Bill 25-1153 to the Committee of the Whole.",6,1,0,0,7
1947638,1564310,2025-05-01,Senate,"Senate: Committee of the Whole Adopt Report",34,0,0,1,35
1947638,1564501,2025-05-02,Senate,"Senate: Third Reading Bill",25,9,0,1,35
1947647,1480279,2025-02-04,House,"House Judiciary: Adopt amendment L.001",11,0,0,0,11
1947647,1484025,2025-02-07,House,"House: Third Reading Bill",60,2,0,3,65
1947647,1503609,2025-03-03,Senate,"Senate Judiciary: Refer House Bill 25-1138 to the Committee of the Whole and with a recommendation that it be placed on the consent calendar.",7,0,0,0,7
1947647,1508835,2025-03-07,Senate,"Senate: Third Reading Bill",31,0,0,3,34
1947647,1517627,2025-02-04,House,"House Judiciary: Refer House Bill 25-1138, as amended, to the Committee of the Whole.",11,0,0,0,11
1947657,1496098,2025-02-20,House,"House Education: Adopt amendment L.001",13,0,0,0,13
1947657,1516951,2025-02-20,House,"House Education: Refer House Bill 25-1158, as amended, to the Committee of the Whole.",8,5,0,0,13
1947657,1547497,2025-04-14,House,"House: Third Reading Bill",31,33,0,1,65
1947668,1495819,2025-02-20,House,"House Education: Adopt amendment L.001",13,0,0,0,13
1947668,1517272,2025-02-20,House,"House Education: Adopt amendment L.002",13,0,0,0,13
1947668,1517273,2025-02-20,House,"House Education: Adopt amendment L.003",13,0,0,0,13
1947668,1517274,2025-02-20,House,"House Education: Refer House Bill 25-1149, as amended, to the Committee on Appropriations.",8,5,0,0,13
1947668,1548083,2025-04-15,House,"House Appropriations: Adopt amendment J.001",11,0,0,0,11
1947668,1549868,2025-04-16,House,"House: Third Reading Bill",45,20,0,0,65
1947668,1555510,2025-04-23,Senate,"Senate Education: Refer House Bill 25-1149, as amended, to the Committee on Appropriations.",4,3,0,0,7
1947668,1559779,2025-04-29,Senate,"Senate Appropriations: Refer House Bill 25-1149 to the Committee of the Whole.",5,2,0,0,7
1947668,1560428,2025-04-15,House,"House Appropriations: Refer House Bill 25-1149, as amended, to the Committee of the Whole.",7,4,0,0,11
1947668,1561764,2025-04-30,Senate,"Senate: Third Reading Bill",24,11,0,0,35
1947668,1563882,2025-05-01,House,"House: Senate Amendments Concur",44,21,0,0,65
1947668,1563883,2025-05-01,House,"House: Senate Amendments Repass",45,20,0,0,65
1947676,1519951,2025-03-18,House,"House Judiciary: Adopt amendment L.001 (Attachment A)",11,0,0,0,11
1947676,1527501,2025-03-18,House,"House Judiciary: Adopt amendment L.004 (Attachment B)",11,0,0,0,11
1947676,1527502,2025-03-18,House,"House Judiciary: Adopt amendment L.005 (Attachment C)",11,0,0,0,11
1947676,1527503,2025-03-18,House,"House Judiciary: Refer House Bill 25-1136, as amended, to the Committee of the Whole.",6,4,0,1,11
1947676,1534097,2025-04-02,House,"House: Third Reading Bill",42,21,0,2,65
1947676,1550079,2025-04-16,Senate,"Senate Judiciary: Adopt amendment L.011 (Attachment A)",7,0,0,0,7
1947676,1555107,2025-04-23,Senate,"Senate: Third Reading Bill",28,7,0,0,35
1947676,1555517,2025-04-16,Senate,"Senate Judiciary: Refer House Bill 25-1136, as amended, to the Committee of the Whole.",6,0,0,1,7
1947676,1563933,2025-05-01,House,"House: Senate Amendments Concur",42,21,0,2,65
1947676,1563934,2025-05-01,House,"House: Senate Amendments Repass",42,21,0,2,65
1947686,1499605,2025-02-25,House,"House Judiciary: Refer House Bill 25-1141 to the Committee on Appropriations.",3,6,0,2,11
1947686,1526781,2025-02-25,House,"House Judiciary: Postpone House Bill 25-1141 indefinitely using a reversal of the previous roll call. There was no objection to the use of the reverse roll call, therefore, the bill was postponed indefinitely.",6,3,0,2,11
1948270,1487773,2025-02-12,House,"House Health & Human Services: Refer House Bill 25-1159, as amended, to the Committee on Appropriations.",12,1,0,0,13
1948270,1551155,2025-04-17,House,"House Appropriations: Adopt amendment J.001",11,0,0,0,11
1948270,1553388,2025-04-17,House,"House Appropriations: Refer House Bill 25-1159, as amended, to the Committee of the Whole.",9,2,0,0,11
1948270,1559089,2025-04-28,House,"House: Third Reading Bill",51,14,0,0,65
1948270,1563953,2025-05-01,Senate,"Senate Health & Human Services: Refer House Bill 25-1159 to the Committee on Appropriations.",7,0,0,2,9
1948270,1564651,2025-05-02,Senate,"Senate Appropriations: Refer House Bill 25-1159 to the Committee of the Whole and with a recommendation that it be placed on the consent calendar.",7,0,0,0,7
1948270,1564831,2025-05-05,Senate,"Senate: Third Reading Bill",32,3,0,0,35
1949149,1491853,2025-02-18,House,"House Health & Human Services: Postpone House Bill 25-1160 indefinitely.",11,0,0,2,13
1951236,1478708,2025-02-03,Senate,"Senate: Consideration of Resolutions Amend (l.001)",35,0,0,0,35
1951236,1478709,2025-02-03,Senate,"Senate: Consideration of Resolutions Resolution",35,0,0,0,35
1951236,1479523,2025-02-04,House,"House: RESOLUTIONS Res",62,0,0,3,65
1951261,1478675,2025-02-03,House,"House: RESOLUTIONS Res",64,0,0,1,65
1951261,1482448,2025-02-05,Senate,"Senate: Consideration of Resolutions Resolution",34,0,0,1,35
1951788,1480043,2025-02-04,Senate,"Senate Appropriations: Refer Senate Bill 25-115 to the Committee of the Whole and with a recommendation that it be placed on the consent calendar.",7,0,0,0,7
1951788,1483574,2025-02-06,Senate,"Senate: Third Reading Bill",31,0,0,4,35
1951788,1486245,2025-02-11,House,"House Appropriations: Refer Senate Bill 25-115 to the Committee of the Whole.",9,2,0,0,11
1951788,1489358,2025-02-13,House,"House: Third Reading Bill",49,16,0,0,65
1951944,1480037,2025-02-04,Senate,"Senate Appropriations: Refer Senate Bill 25-113 to the Committee of the Whole and with a recommendation that it be placed on the consent calendar.",7,0,0,0,7
1951944,1483408,2025-02-06,Senate,"Senate: Third Reading Bill",31,0,0,4,35
1951944,1486369,2025-02-11,House,"House Appropriations: Refer Senate Bill 25-113 to the Committee of the Whole.",10,1,0,0,11
1951944,1489480,2025-02-13,House,"House: Third Reading Bill",63,2,0,0,65
1952095,1480042,2025-02-04,Senate,"Senate Appropriations: Refer Senate Bill 25-114 to the Committee of the Whole and with a recommendation that it be placed on the consent calendar.",7,0,0,0,7
1952095,1483225,2025-02-06,Senate,"Senate: Third Reading Bill",31,0,0,4,35
1952095,1486263,2025-02-11,House,"House Appropriations: Refer Senate Bill 25-114 to the Committee of the Whole.",11,0,0,0,11
1952095,1489215,2025-02-13,House,"House: Third Reading Bill",65,0,0,0,65
1952264,1501712,2025-02-27,House,"House Energy & Environment: Adopt amendment L.002",13,0,0,0,13
1952264,1517425,2025-02-27,House,"House Energy & Environment: Adopt amendment L.003",13,0,0,0,13
1952264,1517426,2025-02-27,House,"House Energy & Environment: Adopt amendment L.007",13,0,0,0,13
1952264,1517427,2025-02-27,House,"House Energy & Environment: Adopt amendment L.008",11,2,0,0,13
1952264,1517428,2025-02-27,House,"House Energy & Environment: Adopt amendment L.009",13,0,0,0,13
1952264,1517429,2025-02-27,House,"House Energy & Environment: Refer House Bill 25-1165, as amended, to the Committee of the Whole.",8,5,0,0,13
1952264,1517949,2025-03-14,House,"House: Third Reading Bill",42,22,0,1,65
1952264,1531609,2025-03-31,Senate,"Senate Transportation & Energy: Adopt amendment L.015",9,0,0,0,9
1952264,1533083,2025-03-31,Senate,"Senate Transportation & Energy: Adopt amendment L.016",9,0,0,0,9
1952264,1533084,2025-03-31,Senate,"Senate Transportation & Energy: Adopt amendment L.017",9,0,0,0,9
1952264,1533085,2025-03-31,Senate,"Senate Transportation & Energy: Refer House Bill 25-1165, as amended, to the Committee of the Whole.",8,1,0,0,9
1952264,1537201,2025-04-04,Senate,"Senate: Third Reading Bill",28,6,0,1,35
1952264,1545934,2025-04-11,House,"House: Senate Amendments Concur",44,18,0,3,65
1952264,1545935,2025-04-11,House,"House: Senate Amendments Repass",41,21,0,3,65
1952332,1479405,2025-02-04,Senate,"Senate Appropriations: Refer Senate Bill 25-092 to the Committee of the Whole and with a recommendation that it be placed on the consent calendar.",6,0,0,1,7
1952332,1483571,2025-02-06,Senate,"Senate: Third Reading Bill",31,0,0,4,35
1952332,1485831,2025-02-11,House,"House Appropriations: Refer Senate Bill 25-092 to the Committee of the Whole.",9,1,0,1,11
1952332,1489481,2025-02-13,House,"House: Third Reading Bill",48,17,0,0,65
1952400,1492804,2025-02-18,House,"House Health & Human Services: Adopt amendment L.003 (Attachment N).",13,0,0,0,13
1952400,1498946,2025-02-25,House,"House: Third Reading Bill",56,4,0,5,65
1952400,1508086,2025-02-18,House,"House Health & Human Services: Adopt amendment L.001 (Attachment M).",13,0,0,0,13
1952400,1508087,2025-02-18,House,"House Health & Human Services: Refer House Bill 25-1162, as amended, to the Committee of the Whole.",12,1,0,0,13
1952400,1541399,2025-04-09,Senate,"Senate Health & Human Services: Refer House Bill 25-1162 to the Committee of the Whole and with a recommendation that it be placed on the consent calendar.",9,0,0,0,9
1952400,1546908,2025-04-14,Senate,"Senate: Third Reading Bill",32,1,0,2,35
1952476,1497998,2025-02-24,House,"House Agriculture, Water & Natural Resources: Refer House Bill 25-1163 to the Committee on Appropriations.",13,0,0,0,13
1952476,1537178,2025-04-04,House,"House Appropriations: Adopt amendment L.002",11,0,0,0,11
1952476,1537889,2025-04-04,House,"House Appropriations: Refer House Bill 25-1163, as amended, to the Committee of the Whole.",11,0,0,0,11
1952476,1547380,2025-04-14,House,"House: Third Reading Bill",63,1,0,1,65
1952476,1557597,2025-04-24,Senate,"Senate Agriculture & Natural Resources: Refer House Bill 25-1163 to the Committee on Appropriations.",6,1,0,0,7
1952476,1561693,2025-04-30,Senate,"Senate Appropriations: Refer House Bill 25-1163 to the Committee of the Whole.",6,1,0,0,7
1952476,1565913,2025-05-06,Senate,"Senate: Third Reading Bill",31,4,0,0,35
1952546,1498363,2025-02-24,House,"House State, Civic, Military, & Veterans Affairs: Refer House Bill 25-1164 to the Committee on Finance.",3,8,0,0,11
1952546,1502573,2025-02-24,House,"House State, Civic, Military, & Veterans Affairs: Postpone House Bill 25-1164 indefinitely using a reversal of the previous roll call. There was no objection to the use of the reverse roll call, therefore, the bill was postponed indefinitely.",8,3,0,0,11
1952625,1495185,2025-02-20,House,"House Business Affairs & Labor: Refer House Bill 25-1166 to the Committee of the Whole.",12,0,0,1,13
1952625,1501337,2025-02-27,House,"House: Third Reading Bill",57,6,0,2,65
1952625,1529326,2025-03-27,Senate,"Senate Health & Human Services: Refer House Bill 25-1166 to the Committee of the Whole and with a recommendation that it be placed on the consent calendar.",9,0,0,0,9
1952625,1532220,2025-04-01,Senate,"Senate: Third Reading Bill",34,1,0,0,35
1952696,1506841,2025-03-05,House,"House Education: Adopt amendment L.002",13,0,0,0,13
1952696,1522423,2025-03-05,House,"House Education: Adopt amendment L.003",13,0,0,0,13
1952696,1522424,2025-03-05,House,"House Education: Refer House Bill 25-1167, as amended, to the Committee on Appropriations.",12,1,0,0,13
1952696,1548032,2025-04-15,House,"House Appropriations: Adopt amendment J.001",11,0,0,0,11
1952696,1550073,2025-04-16,House,"House: Third Reading Bill",64,0,0,1,65
1952696,1555629,2025-04-23,Senate,"Senate Education: Refer House Bill 25-1167 to the Committee on Appropriations.",6,0,0,1,7
1952696,1560645,2025-04-15,House,"House Appropriations: Refer House Bill 25-1167, as amended, to the Committee of the Whole.",9,2,0,0,11
1952696,1560646,2025-04-29,Senate,"Senate Appropriations: Refer House Bill 25-1167 to the Committee of the Whole.",5,2,0,0,7
1952696,1562558,2025-04-30,Senate,"Senate: Third Reading Bill",35,0,0,0,35
1952772,1500347,2025-02-26,House,"House Transportation, Housing & Local Government: Adopt amendment L.001 (Attachment E)",13,0,0,0,13
1952772,1501694,2025-02-26,House,"House Transportation, Housing & Local Government: Adopt amendment L.004 (Attachment F)",13,0,0,0,13
1952772,1501695,2025-02-26,House,"House Transportation, Housing & Local Government: Refer House Bill 25-1168, as amended, to the Committee of the Whole.",9,4,0,0,13
1952772,1506114,2025-03-05,House,"House: Third Reading Bill",40,22,0,3,65
1952772,1531726,2025-03-31,Senate,"Senate Judiciary: Adopt amendment L.008 (Attachment B)",7,0,0,0,7
1952772,1537175,2025-04-04,Senate,"Senate: Third Reading Bill",23,11,0,1,35
1952772,1538534,2025-03-31,Senate,"Senate Judiciary: Adopt amendment L.009 (Attachment C)",7,0,0,0,7
1952772,1538535,2025-03-31,Senate,"Senate Judiciary: Adopt amendment L.010 (Attachment D)",7,0,0,0,7
1952772,1538536,2025-03-31,Senate,"Senate Judiciary: Refer House Bill 25-1168, as amended, to the Committee of the Whole.",5,2,0,0,7
1952772,1546412,2025-04-11,House,"House: Senate Amendments Concur",42,20,0,3,65
1952772,1546413,2025-04-11,House,"House: Senate Amendments Repass",41,21,0,3,65
1952859,1479424,2025-02-04,Senate,"Senate Appropriations: Refer Senate Bill 25-094 to the Committee of the Whole and with a recommendation that it be placed on the consent calendar.",6,0,0,1,7
1952859,1483042,2025-02-06,Senate,"Senate: Third Reading Bill",31,0,0,4,35
1952859,1486038,2025-02-11,House,"House Appropriations: Refer Senate Bill 25-094 to the Committee of the Whole.",9,2,0,0,11
1952859,1488975,2025-02-13,House,"House: Third Reading Bill",50,15,0,0,65
1952867,1479957,2025-02-04,Senate,"Senate Appropriations: Refer Senate Bill 25-099 to the Committee of the Whole and with a recommendation that it be placed on the consent calendar.",7,0,0,0,7
1952867,1483302,2025-02-06,Senate,"Senate: Third Reading Bill",31,0,0,4,35
1952867,1486571,2025-02-11,House,"House Appropriations: Refer Senate Bill 25-099 to the Committee of the Whole.",8,3,0,0,11
1952867,1488955,2025-02-13,House,"House: Third Reading Bill",45,20,0,0,65
1952875,1479803,2025-02-04,Senate,"Senate Appropriations: Refer Senate Bill 25-110 to the Committee of the Whole and with a recommendation that it be placed on the consent calendar.",7,0,0,0,7
1952875,1483173,2025-02-06,Senate,"Senate: Third Reading Bill",31,0,0,4,35
1952875,1485880,2025-02-11,House,"House Appropriations: Refer Senate Bill 25-110 to the Committee of the Whole.",10,1,0,0,11
1952875,1488774,2025-02-13,House,"House: Third Reading Bill",47,18,0,0,65
1952884,1479970,2025-02-04,Senate,"Senate Appropriations: Refer Senate Bill 25-106 to the Committee of the Whole and with a recommendation that it be placed on the consent calendar.",7,0,0,0,7
1952884,1483593,2025-02-06,Senate,"Senate: Third Reading Bill",31,0,0,4,35
1952884,1486774,2025-02-11,House,"House Appropriations: Refer Senate Bill 25-106 to the Committee of the Whole.",9,2,0,0,11
1952884,1489212,2025-02-13,House,"House: Third Reading Bill",45,20,0,0,65
1952892,1479775,2025-02-04,Senate,"Senate Appropriations: Refer Senate Bill 25-089 to the Committee of the Whole and with a recommendation that it be placed on the consent calendar.",6,0,0,1,7
1952892,1483350,2025-02-06,Senate,"Senate: Third Reading Bill",31,0,0,4,35
1952892,1486418,2025-02-11,House,"House Appropriations: Refer Senate Bill 25-089 to the Committee of the Whole.",10,0,0,1,11
1952892,1488856,2025-02-13,House,"House: Third Reading Bill",52,13,0,0,65
1952900,1479550,2025-02-04,Senate,"Senate Appropriations: Refer Senate Bill 25-095 to the Committee of the Whole and with a recommendation that it be placed on the consent calendar.",6,0,0,1,7
1952900,1483393,2025-02-06,Senate,"Senate: Third Reading Bill",26,5,0,4,35
1952900,1486140,2025-02-11,House,"House Appropriations: Refer Senate Bill 25-095 to the Committee of the Whole.",11,0,0,0,11
1952900,1489598,2025-02-13,House,"House: Third Reading Bill",47,18,0,0,65
1952909,1479935,2025-02-04,Senate,"Senate Appropriations: Refer Senate Bill 25-090 to the Committee of the Whole and with a recommendation that it be placed on the consent calendar.",6,0,0,1,7
1952909,1483498,2025-02-06,Senate,"Senate: Third Reading Bill",27,4,0,4,35
1952909,1485829,2025-02-11,House,"House Appropriations: Refer Senate Bill 25-090 to the Committee of the Whole.",8,2,0,1,11
1952909,1489213,2025-02-13,House,"House: Third Reading Bill",45,20,0,0,65
1952917,1479485,2025-02-04,Senate,"Senate Appropriations: Refer Senate Bill 25-088 to the Committee of the Whole.",4,2,0,1,7
1952917,1483552,2025-02-06,Senate,"Senate: Third Reading Bill",31,0,0,4,35
1952917,1485832,2025-02-11,House,"House Appropriations: Refer Senate Bill 25-088 to the Committee of the Whole.",7,3,0,1,11
1952917,1488764,2025-02-13,House,"House: Third Reading Bill",50,15,0,0,65
1952925,1479512,2025-02-04,Senate,"Senate Appropriations: Refer Senate Bill 25-091 to the Committee of the Whole and with a recommendation that it be placed on the consent calendar.",6,0,0,1,7
1952925,1483341,2025-02-06,Senate,"Senate: Third Reading Bill",31,0,0,4,35
1952925,1486280,2025-02-11,House,"House Appropriations: Refer Senate Bill 25-091 to the Committee of the Whole.",10,0,0,1,11
1952925,1489188,2025-02-13,House,"House: Third Reading Bill",55,10,0,0,65
1952933,1479519,2025-02-04,Senate,"Senate Appropriations: Refer Senate Bill 25-107 to the Committee of the Whole and with a recommendation that it be placed on the consent calendar.",7,0,0,0,7
1952933,1483217,2025-02-06,Senate,"Senate: Third Reading Bill",31,0,0,4,35
1952933,1486686,2025-02-11,House,"House Appropriations: Refer Senate Bill 25-107 to the Committee of the Whole.",11,0,0,0,11
1952933,1489504,2025-02-13,House,"House: Third Reading Bill",54,11,0,0,65
1952942,1479502,2025-02-04,Senate,"Senate Appropriations: Refer Senate Bill 25-109 to the Committee of the Whole and with a recommendation that it be placed on the consent calendar.",7,0,0,0,7
1952942,1483570,2025-02-06,Senate,"Senate: Third Reading Bill",31,0,0,4,35
1952942,1486504,2025-02-11,House,"House Appropriations: Refer Senate Bill 25-109 to the Committee of the Whole.",9,2,0,0,11
1952942,1489514,2025-02-13,House,"House: Third Reading Bill",43,22,0,0,65
1952950,1479981,2025-02-04,Senate,"Senate Appropriations: Refer Senate Bill 25-103 to the Committee of the Whole.",5,2,0,0,7
1952950,1483079,2025-02-06,Senate,"Senate: Third Reading Bill",25,6,0,4,35
1952950,1486192,2025-02-11,House,"House Appropriations: Refer Senate Bill 25-103 to the Committee of the Whole.",8,3,0,0,11
1952950,1489499,2025-02-13,House,"House: Third Reading Bill",44,21,0,0,65
1952958,1479516,2025-02-04,Senate,"Senate Appropriations: Refer Senate Bill 25-105 to the Committee of the Whole.",7,0,0,0,7
1952958,1483166,2025-02-06,Senate,"Senate: Third Reading Bill",29,2,0,4,35
1952958,1486424,2025-02-11,House,"House Appropriations: Adopt amendment J.002",9,2,0,0,11
1952958,1486787,2025-02-11,House,"House Appropriations: Refer Senate Bill 25-105, as amended, to the Committee of the Whole.",9,2,0,0,11
1952958,1489161,2025-02-13,House,"House: Third Reading Bill",59,6,0,0,65
1952958,1492725,2025-02-18,Senate,"Senate: House Amendments Concur",34,0,0,0,34
1952958,1492726,2025-02-18,Senate,"Senate: House Amendments Repass",32,2,0,0,34
1952967,1479503,2025-02-04,Senate,"Senate Appropriations: Refer Senate Bill 25-098 to the Committee of the Whole and with a recommendation that it be placed on the consent calendar.",7,0,0,0,7
1952967,1483612,2025-02-06,Senate,"Senate: Third Reading Bill",31,0,0,4,35
1952967,1486582,2025-02-11,House,"House Appropriations: Refer Senate Bill 25-098 to the Committee of the Whole.",11,0,0,0,11
1952967,1488937,2025-02-13,House,"House: Third Reading Bill",54,11,0,0,65
1952975,1479433,2025-02-04,Senate,"Senate Appropriations: Refer Senate Bill 25-104 to the Committee of the Whole and with a recommendation that it be placed on the consent calendar.",7,0,0,0,7
1952975,1483349,2025-02-06,Senate,"Senate: Third Reading Bill",24,7,0,4,35
1952975,1486671,2025-02-11,House,"House Appropriations: Refer Senate Bill 25-104 to the Committee of the Whole.",8,3,0,0,11
1952975,1489197,2025-02-13,House,"House: Third Reading Bill",44,21,0,0,65
1952983,1479500,2025-02-04,Senate,"Senate Appropriations: Refer Senate Bill 25-097 to the Committee of the Whole and with a recommendation that it be placed on the consent calendar.",7,0,0,0,7
1952983,1483591,2025-02-06,Senate,"Senate: Third Reading Bill",31,0,0,4,35
1952983,1485909,2025-02-11,House,"House Appropriations: Refer Senate Bill 25-097 to the Committee of the Whole.",11,0,0,0,11
1952983,1489479,2025-02-13,House,"House: Third Reading Bill",56,9,0,0,65
1952991,1479984,2025-02-04,Senate,"Senate Appropriations: Refer Senate Bill 25-096 to the Committee of the Whole and with a recommendation that it be placed on the consent calendar.",7,0,0,0,7
1952991,1483577,2025-02-06,Senate,"Senate: Third Reading Bill",31,0,0,4,35
1952991,1485955,2025-02-11,House,"House Appropriations: Refer Senate Bill 25-096 to the Committee of the Whole.",9,2,0,0,11
1952991,1489490,2025-02-13,House,"House: Third Reading Bill",47,18,0,0,65
1953000,1479964,2025-02-04,Senate,"Senate Appropriations: Refer Senate Bill 25-102 to the Committee of the Whole and with a recommendation that it be placed on the consent calendar.",7,0,0,0,7
1953000,1483154,2025-02-06,Senate,"Senate: Third Reading Bill",31,0,0,4,35
1953000,1486652,2025-02-11,House,"House Appropriations: Refer Senate Bill 25-102 to the Committee of the Whole.",8,3,0,0,11
1953000,1489489,2025-02-13,House,"House: Third Reading Bill",45,20,0,0,65
1953008,1479693,2025-02-04,Senate,"Senate Appropriations: Refer Senate Bill 25-093 to the Committee of the Whole.",4,2,0,1,7
1953008,1483406,2025-02-06,Senate,"Senate: Third Reading Bill",23,8,0,4,35
1953008,1485942,2025-02-11,House,"House Appropriations: Refer Senate Bill 25-093 to the Committee of the Whole.",8,3,0,0,11
1953008,1488782,2025-02-13,House,"House: Third Reading Bill",43,22,0,0,65
1953016,1479497,2025-02-04,Senate,"Senate Appropriations: Refer Senate Bill 25-101 to the Committee of the Whole and with a recommendation that it be placed on the consent calendar.",7,0,0,0,7
1953016,1483219,2025-02-06,Senate,"Senate: Third Reading Bill",31,0,0,4,35
1953016,1486760,2025-02-11,House,"House Appropriations: Refer Senate Bill 25-101 to the Committee of the Whole.",10,1,0,0,11
1953016,1488692,2025-02-13,House,"House: Third Reading Bill",61,4,0,0,65
1953026,1479833,2025-02-04,Senate,"Senate Appropriations: Refer Senate Bill 25-112 to the Committee of the Whole and with a recommendation that it be placed on the consent calendar.",7,0,0,0,7
1953026,1483340,2025-02-06,Senate,"Senate: Third Reading Bill",31,0,0,4,35
1953026,1486256,2025-02-11,House,"House Appropriations: Refer Senate Bill 25-112 to the Committee of the Whole.",8,3,0,0,11
1953026,1488897,2025-02-13,House,"House: Third Reading Bill",44,21,0,0,65
1953034,1479564,2025-02-04,Senate,"Senate Appropriations: Refer Senate Bill 25-111 to the Committee of the Whole and with a recommendation that it be placed on the consent calendar.",7,0,0,0,7
1953034,1483347,2025-02-06,Senate,"Senate: Third Reading Bill",31,0,0,4,35
1953034,1486738,2025-02-11,House,"House Appropriations: Refer Senate Bill 25-111 to the Committee of the Whole.",11,0,0,0,11
1953034,1489510,2025-02-13,House,"House: Third Reading Bill",52,13,0,0,65
1953042,1479847,2025-02-04,Senate,"Senate Appropriations: Refer Senate Bill 25-108 to the Committee of the Whole and with a recommendation that it be placed on the consent calendar.",7,0,0,0,7
1953042,1483579,2025-02-06,Senate,"Senate: Third Reading Bill",31,0,0,4,35
1953042,1486732,2025-02-11,House,"House Appropriations: Refer Senate Bill 25-108 to the Committee of the Whole.",10,1,0,0,11
1953042,1489146,2025-02-13,House,"House: Third Reading Bill",48,17,0,0,65
1953049,1479493,2025-02-04,Senate,"Senate Appropriations: Refer Senate Bill 25-100 to the Committee of the Whole and with a recommendation that it be placed on the consent calendar.",7,0,0,0,7
1953049,1483346,2025-02-06,Senate,"Senate: Third Reading Bill",31,0,0,4,35
1953049,1486658,2025-02-11,House,"House Appropriations: Refer Senate Bill 25-100 to the Committee of the Whole.",8,3,0,0,11
1953049,1489157,2025-02-13,House,"House: Third Reading Bill",44,21,0,0,65
1953626,1543561,2025-04-09,Senate,"Senate Judiciary: Adopt amendment L.006 (Attachment A)",7,0,0,0,7
1953626,1546129,2025-04-09,Senate,"Senate Judiciary: Refer Senate Bill 25-116, as amended, to the Committee of the Whole and with a recommendation that it be placed on the consent calendar.",7,0,0,0,7
1953626,1547663,2025-04-14,Senate,"Senate: Third Reading Bill",32,1,0,2,35
1953626,1554369,2025-04-22,House,"House Judiciary: Refer Senate Bill 25-116 to the Committee of the Whole.",10,0,0,1,11
1953626,1558173,2025-04-25,House,"House: Third Reading Bill",56,7,0,2,65
1953971,1492005,2025-02-18,Senate,"Senate State, Veterans, & Military Affairs: Adopt amendment L.001 (Attachment A).",5,0,0,0,5
1953971,1516052,2025-02-18,Senate,"Senate State, Veterans, & Military Affairs: Adopt amendment L.002 (Attachment B).",5,0,0,0,5
1953971,1516053,2025-02-18,Senate,"Senate State, Veterans, & Military Affairs: Postpone Senate Bill 25-117 indefinitely using a reversal of the previous roll call. There was no objection to the use of the reverse roll call, therefore, the bill was postponed indefinitely.",3,2,0,0,5
1953971,1516054,2025-02-18,Senate,"Senate State, Veterans, & Military Affairs: Refer Senate Bill 25-117, as amended, to the Committee on Appropriations.",2,3,0,0,5
1955032,1493235,2025-02-19,House,"House Energy & Environment: Refer House Bill 25-1161 to the Committee of the Whole.",9,4,0,0,13
1955032,1505248,2025-03-04,House,"House: Third Reading Bill",41,21,0,3,65
1955032,1527939,2025-03-26,Senate,"Senate Transportation & Energy: Adopt amendment L.011",6,3,0,0,9
1955032,1530103,2025-03-26,Senate,"Senate Transportation & Energy: Refer House Bill 25-1161, as amended, to the Committee of the Whole.",6,3,0,0,9
1955032,1538100,2025-04-07,Senate,"Senate: Third Reading Amend (l.015)",27,7,0,1,35
1955032,1538101,2025-04-07,Senate,"Senate: Third Reading Bill",19,15,0,1,35
1955032,1546330,2025-04-11,House,"House: Senate Amendments Concur",42,20,0,3,65
1955032,1546331,2025-04-11,House,"House: Senate Amendments Repass",40,22,0,3,65
1955090,1520879,2025-03-19,Senate,"Senate Health & Human Services: Adopt amendment L.008 (Attachment A).",7,2,0,0,9
1955090,1527521,2025-03-26,Senate,"Senate: Third Reading Bill",20,14,0,1,35
1955090,1529402,2025-03-13,Senate,"Senate Health & Human Services: Adopt amendment L.001 (Attachment M).",9,0,0,0,9
1955090,1529403,2025-03-13,Senate,"Senate Health & Human Services: Adopt amendment L.002 (Attachment N).",9,0,0,0,9
1955090,1529404,2025-03-13,Senate,"Senate Health & Human Services: Adopt amendment L.005 (Attachment O).",9,0,0,0,9
1955090,1529405,2025-03-13,Senate,"Senate Health & Human Services: Adopt amendment L.006 (Amendment P).",9,0,0,0,9
1955090,1531299,2025-03-19,Senate,"Senate Health & Human Services: Refer Senate Bill 25-124, as amended, to the Committee of the Whole.",6,3,0,0,9
1955090,1564780,2025-05-03,House,"House Health & Human Services: Refer Senate Bill 25-124, as amended, to the Committee of the Whole.",12,1,0,0,13
1955090,1565837,2025-05-06,House,"House: Third Reading Bill",42,23,0,0,65
1955090,1567112,2025-05-07,Senate,"Senate: House Amendments Adhere",24,11,0,0,35
1955090,1567642,2025-05-03,House,"House Health & Human Services: Adopt amendment L.020 (Attachment E).",2,11,0,0,13
1955090,1567643,2025-05-03,House,"House Health & Human Services: Refer Senate Bill 25-124, as amended, to the Committee of the Whole.",12,1,0,0,13
1955145,1496058,2025-02-20,Senate,"Senate Health & Human Services: Adopt amendment L.002 (Attachment C).",9,0,0,0,9
1955145,1502818,2025-02-20,Senate,"Senate Health & Human Services: Refer Senate Bill 25-121, as amended, to the Committee on Appropriations.",6,3,0,0,9
1955145,1554099,2025-04-22,Senate,"Senate Appropriations: Adopt amendment L.003",7,0,0,0,7
1955145,1554100,2025-04-22,Senate,"Senate Appropriations: Refer Senate Bill 25-121, as amended, to the Committee of the Whole and with a recommendation that it be placed on the consent calendar.",7,0,0,0,7
1955145,1555463,2025-04-23,Senate,"Senate: Third Reading Bill",29,6,0,0,35
1955145,1559455,2025-04-28,House,"House Health & Human Services: Postpone Senate Bill 25-121 indefinitely using a reversal of the previous roll call. There was no objection to the use of the reverse roll call, therefore, the bill was postponed indefinitely.",8,5,0,0,13
1955145,1567901,2025-04-28,House,"House Health & Human Services: Postpone Senate Bill 25-121 indefinitely using a reversal of the previous roll call. There was no objection to the use of the reverse roll call, therefore, the bill was postponed indefinitely.",8,5,0,0,13
1955145,1567902,2025-04-28,House,"House Health & Human Services: Refer Senate Bill 25-121, as amended, to the Committee on Appropriations.",5,8,0,0,13
1955200,1506101,2025-03-05,Senate,"Senate Education: Postpone Senate Bill 25-119 indefinitely.",7,0,0,0,7
1955200,1509143,2025-02-26,Senate,"Senate Education: Adopt amendment L.003",7,0,0,0,7
1955200,1509144,2025-02-26,Senate,"Senate Education: Adopt amendment L.005",7,0,0,0,7
1955200,1509145,2025-02-26,Senate,"Senate Education: Adopt amendment L.006",6,1,0,0,7
1955200,1509146,2025-02-26,Senate,"Senate Education: Adopt amendment L.007",7,0,0,0,7
1955253,1551672,2025-04-17,Senate,"Senate Health & Human Services: Adopt amendment L.002 (Attachment E).",9,0,0,0,9
1955253,1558026,2025-04-25,Senate,"Senate Appropriations: Refer Senate Bill 25-118 to the Committee of the Whole and with a recommendation that it be placed on the consent calendar.",7,0,0,0,7
1955253,1558842,2025-04-28,Senate,"Senate: Third Reading Bill",22,12,0,1,35
1955253,1562682,2025-04-30,House,"House Health & Human Services: Refer Senate Bill 25-118 to the Committee of the Whole.",11,1,0,1,13
1955253,1563722,2025-04-17,Senate,"Senate Health & Human Services: Refer Senate Bill 25-118, as amended, to the Committee on Appropriations.",6,3,0,0,9
1955253,1564550,2025-05-02,House,"House: Third Reading Bill",48,16,0,1,65
1955315,1559176,2025-04-28,Senate,"Senate Education: Postpone Senate Bill 25-123 indefinitely.",6,0,0,1,7
1955365,1500229,2025-02-26,Senate,"Senate Education: Refer Senate Bill 25-120 to the Senate Agriculture and Natural Resources Committee",7,0,0,0,7
1955365,1517699,2025-03-13,Senate,"Senate Agriculture & Natural Resources: Adopt amendment L.007 (Attachment B).",7,0,0,0,7
1955365,1521457,2025-03-13,Senate,"Senate Agriculture & Natural Resources: Refer Senate Bill 25-120, as amended, to the Committee on Appropriations.",6,0,0,1,7
1955365,1558023,2025-04-25,Senate,"Senate Appropriations: Adopt amendment L.008",7,0,0,0,7
1955365,1558843,2025-04-28,Senate,"Senate: Third Reading Bill",34,0,0,1,35
1955365,1559789,2025-04-25,Senate,"Senate Appropriations: Adopt amendment J.001",7,0,0,0,7
1955365,1559790,2025-04-25,Senate,"Senate Appropriations: Refer Senate Bill 25-120, as amended, to the Committee of the Whole and with a recommendation that it be placed on the consent calendar.",7,0,0,0,7
1955365,1561002,2025-04-29,House,"House Finance: Refer Senate Bill 25-120 to the Committee on Appropriations.",10,2,0,1,13
1955416,1484740,2025-02-10,Senate,"Senate: Consideration of Resolutions Resolution",21,12,0,2,35
1955416,1496343,2025-02-21,House,"House: RESOLUTIONS Amd (l.001)",22,37,0,6,65
1955416,1496344,2025-02-21,House,"House: RESOLUTIONS Amd (l.002)",22,37,0,6,65
1955416,1496345,2025-02-21,House,"House: RESOLUTIONS Amd (l.006)",22,33,0,10,65
1955416,1496346,2025-02-21,House,"House: RESOLUTIONS Amd (l.014)",22,40,0,3,65
1955416,1496347,2025-02-21,House,"House: RESOLUTIONS Amd (l.016)",21,40,0,4,65
1955416,1496348,2025-02-21,House,"House: RESOLUTIONS Amd (l.020)",22,40,0,3,65
1955416,1496797,2025-02-21,House,"House: RESOLUTIONS Amd (l.012)",22,38,0,5,65
1955416,1496798,2025-02-21,House,"House: RESOLUTIONS Res",41,23,0,1,65
1955471,1503217,2025-03-03,House,"House State, Civic, Military, & Veterans Affairs: Adopt amendment L.001 (Attachment A).",11,0,0,0,11
1955471,1513664,2025-03-03,House,"House State, Civic, Military, & Veterans Affairs: Adopt amendment L.003 (Attachment B).",11,0,0,0,11
1955471,1513665,2025-03-03,House,"House State, Civic, Military, & Veterans Affairs: Adopt amendment L.007 (Attachment C).",6,5,0,0,11
1955471,1513666,2025-03-03,House,"House State, Civic, Military, & Veterans Affairs: Refer House Bill 25-1170, as amended, to the Committee on Appropriations.",9,2,0,0,11
1955526,1493877,2025-02-19,House,"House Transportation, Housing & Local Government: Adopt amendment L.003 (Attachment L)",13,0,0,0,13
1955526,1518352,2025-03-17,House,"House: Third Reading Bill",40,23,0,2,65
1955526,1521490,2025-02-19,House,"House Transportation, Housing & Local Government: Adopt amendment L.001 (Attachment R)",4,8,0,1,13
1955526,1521491,2025-02-19,House,"House Transportation, Housing & Local Government: Adopt amendment L.002 (Attachment S)",4,8,0,1,13
1955526,1521492,2025-02-19,House,"House Transportation, Housing & Local Government: Adopt amendment L.004 (Attachment M)",13,0,0,0,13
1955526,1521493,2025-02-19,House,"House Transportation, Housing & Local Government: Adopt amendment L.005 (Attachment N)",13,0,0,0,13
1955526,1521494,2025-02-19,House,"House Transportation, Housing & Local Government: Adopt amendment L.006 (Attachment O)",13,0,0,0,13
1955526,1521495,2025-02-19,House,"House Transportation, Housing & Local Government: Adopt amendment L.007 (Attachment Q)",13,0,0,0,13
1955526,1521496,2025-02-19,House,"House Transportation, Housing & Local Government: Adopt amendment L.008 (Attachment P)",13,0,0,0,13
1955526,1521497,2025-02-19,House,"House Transportation, Housing & Local Government: Refer House Bill 25-1169, as amended, to the Committee of the Whole.",8,4,0,1,13
1955526,1529453,2025-03-27,Senate,"Senate Local Government & Housing: Adopt amendment L.021",7,0,0,0,7
1955526,1529963,2025-03-27,Senate,"Senate Local Government & Housing: Adopt amendment L.022",4,3,0,0,7
1955526,1529964,2025-03-27,Senate,"Senate Local Government & Housing: Adopt amendment L.023",7,0,0,0,7
1955526,1529965,2025-03-27,Senate,"Senate Local Government & Housing: Refer House Bill 25-1169, as amended, to the Committee of the Whole.",4,3,0,0,7
1955572,1506688,2025-03-05,Senate,"Senate Health & Human Services: Refer Senate Bill 25-122 to the Committee on Appropriations.",8,0,0,1,9
1955572,1548066,2025-04-15,Senate,"Senate Appropriations: Refer Senate Bill 25-122 to the Committee of the Whole.",6,1,0,0,7
1955572,1552496,2025-04-21,Senate,"Senate: Third Reading Bill",34,1,0,0,35
1955572,1553770,2025-04-22,House,"House Health & Human Services: Refer Senate Bill 25-122 to the Committee on Finance.",10,3,0,0,13
1955572,1557294,2025-04-24,House,"House Finance: Refer Senate Bill 25-122 to the Committee on Appropriations.",10,3,0,0,13
1955572,1559868,2025-04-29,House,"House Appropriations: Refer Senate Bill 25-122 to the Committee of the Whole.",8,3,0,0,11
1955572,1560627,2025-04-29,House,"House: Committee of the Whole Amd (h.001)",23,39,0,3,65
1955572,1562616,2025-04-30,House,"House: Third Reading Bill",46,19,0,0,65
1957521,1527806,2025-03-26,Senate,"Senate Transportation & Energy: Adopt amendment L.001",9,0,0,0,9
1957521,1530104,2025-03-26,Senate,"Senate Transportation & Energy: Adopt amendment L.002",9,0,0,0,9
1957521,1530105,2025-03-26,Senate,"Senate Transportation & Energy: Refer Senate Bill 25-127, as amended, to the Committee of the Whole.",8,1,0,0,9
1957545,1531559,2025-03-31,Senate,"Senate Judiciary: Adopt amendment L.001 (Attachment J)",7,0,0,0,7
1957545,1538370,2025-03-31,Senate,"Senate Judiciary: Adopt amendment L.002 (Attachment K)",7,0,0,0,7
1957545,1538371,2025-03-31,Senate,"Senate Judiciary: Refer Senate Bill 25-155, as amended, to the Committee on Appropriations.",5,2,0,0,7
1957545,1545686,2025-04-11,Senate,"Senate Appropriations: Refer Senate Bill 25-155 to the Committee of the Whole.",4,3,0,0,7
1957545,1552478,2025-04-21,Senate,"Senate: Third Reading Bill",22,13,0,0,35
1957545,1559085,2025-04-28,House,"House Judiciary: Refer Senate Bill 25-155 to the Committee on Appropriations.",7,4,0,0,11
1957545,1561773,2025-04-30,House,"House Appropriations: Refer Senate Bill 25-155 to the Committee of the Whole.",7,4,0,0,11
1957545,1562401,2025-04-30,House,"House: Committee of the Whole Amd (h.001)",23,40,0,2,65
1957545,1562402,2025-04-30,House,"House: Committee of the Whole Amd (h.002)",22,41,0,2,65
1957545,1563517,2025-05-01,House,"House: Third Reading Bill",41,22,0,2,65
1957545,1564730,2025-05-02,Senate,"Senate: House Amendments Not Concur Appt Cc",35,0,0,0,35
1957545,1567615,2025-05-06,Joint,"CC_SB25-155_2025A: Adopt draft conference committee report CLSB.001 (Attachment A)",6,0,0,0,6
1957545,1567616,2025-05-07,House,"House: Conference Committee Report Adopt",42,22,0,1,65
1957545,1567617,2025-05-07,House,"House: Conference Committee Report Repass",42,22,0,1,65
1957545,1567618,2025-05-07,Senate,"Senate: Conference Committee Report Adopt Ccr",35,0,0,0,35
1957545,1567619,2025-05-07,Senate,"Senate: Conference Committee Report Adopt Ccr",35,0,0,0,35
1957545,1567620,2025-05-07,Senate,"Senate: Conference Committee Report Repass",22,13,0,0,35
1957545,1567621,2025-05-07,Senate,"Senate: Conference Committee Report Repass",22,13,0,0,35
1957569,1499082,2025-02-25,Senate,"Senate Business, Labor, & Technology: Adopt amendment L.001",7,0,0,0,7
1957569,1502195,2025-02-28,Senate,"Senate: Committee of the Whole Adopt Report",29,0,0,5,34
1957569,1503139,2025-03-03,Senate,"Senate: Third Reading Bill",34,0,0,0,34
1957569,1504585,2025-02-25,Senate,"Senate Business, Labor, & Technology: Refer Senate Bill 25-146, as amended, to the Committee of the Whole.",5,1,0,1,7
1957569,1536714,2025-04-03,House,"House Business Affairs & Labor: Adopt amendment L.002",13,0,0,0,13
1957569,1544087,2025-04-03,House,"House Business Affairs & Labor: Refer Senate Bill 25-146, as amended, to the Committee of the Whole.",13,0,0,0,13
1957569,1548123,2025-04-15,House,"House: Third Reading Bill",59,3,0,3,65
1957569,1549931,2025-04-16,Senate,"Senate: House Amendments Concur",32,0,0,3,35
1957569,1549932,2025-04-16,Senate,"Senate: House Amendments Repass",32,0,0,3,35
1957590,1523208,2025-03-20,Senate,"Senate Health & Human Services: Adopt amendment L.002 (Attachment C).",9,0,0,0,9
1957590,1528768,2025-03-27,Senate,"Senate: Third Reading Bill",34,1,0,0,35
1957590,1540511,2025-04-08,House,"House Health & Human Services: Adopt amendment L.004 (Attachment G).",13,0,0,0,13
1957590,1548120,2025-04-15,House,"House: Third Reading Bill",51,10,0,4,65
1957590,1549938,2025-04-16,Senate,"Senate: House Amendments Concur",32,0,0,3,35
1957590,1549939,2025-04-16,Senate,"Senate: House Amendments Repass",32,0,0,3,35
1957590,1551708,2025-03-20,Senate,"Senate Health & Human Services: Refer Senate Bill 25-152, as amended, to the Committee of the Whole.",9,0,0,0,9
1957590,1555682,2025-04-08,House,"House Health & Human Services: Refer Senate Bill 25-152, as amended, to the Committee of the Whole.",12,1,0,0,13
1957616,1506901,2025-03-05,Senate,"Senate Education: Adopt amendment L.003",7,0,0,0,7
1957616,1512507,2025-03-11,Senate,"Senate: Third Reading Bill",25,9,0,0,34
1957616,1522192,2025-03-05,Senate,"Senate Education: Refer Senate Bill 25-154 to the Committee of the Whole.",5,2,0,0,7
1957616,1536985,2025-04-03,House,"House Education: Refer Senate Bill 25-154 to the Committee of the Whole.",8,5,0,0,13
1957616,1551710,2025-04-17,House,"House: Third Reading Bill",45,18,0,2,65
1957638,1506242,2025-03-05,Senate,"Senate Transportation & Energy: Postpone Senate Bill 25-137 indefinitely.",9,0,0,0,9
1957662,1499232,2025-02-25,Senate,"Senate Business, Labor, & Technology: Adopt amendment L.001",7,0,0,0,7
1957662,1504336,2025-02-25,Senate,"Senate Business, Labor, & Technology: Refer Senate Bill 25-144, as amended, to the Committee on Appropriations.",4,3,0,0,7
1957662,1517845,2025-03-14,Senate,"Senate Appropriations: Refer Senate Bill 25-144 to the Committee of the Whole.",4,3,0,0,7
1957662,1520839,2025-03-19,Senate,"Senate: Third Reading Bill",22,12,0,0,34
1957662,1550253,2025-04-16,House,"House Business Affairs & Labor: Adopt amendment L.006",13,0,0,0,13
1957662,1555531,2025-04-16,House,"House Business Affairs & Labor: Refer Senate Bill 25-144, as amended, to the Committee on Appropriations.",9,3,0,1,13
1957662,1555532,2025-04-16,House,"House Business Affairs & Labor: Refer Senate Bill 25-144, as amended, to the Committee on Health &amp; Human Services.",1,11,0,1,13
1957662,1556407,2025-04-24,House,"House Appropriations: Refer Senate Bill 25-144 to the Committee of the Whole.",9,2,0,0,11
1957662,1558162,2025-04-25,House,"House: Third Reading Bill",42,21,0,2,65
1957662,1558837,2025-04-28,Senate,"Senate: House Amendments Concur",29,4,0,2,35
1957662,1558838,2025-04-28,Senate,"Senate: House Amendments Repass",21,12,0,2,35
1957686,1515354,2025-03-11,Senate,"Senate Business, Labor, & Technology: Adopt amendment L.001",7,0,0,0,7
1957686,1519342,2025-03-11,Senate,"Senate Business, Labor, & Technology: Refer Senate Bill 25-157, as amended, to the Committee of the Whole.",4,3,0,0,7
1957686,1533292,2025-04-01,Senate,"Senate: Third Reading Amend (l.008)",35,0,0,0,35
1957686,1533293,2025-04-01,Senate,"Senate: Third Reading Bill",16,19,0,0,35
1957711,1505289,2025-03-04,Senate,"Senate State, Veterans, & Military Affairs: Adopt amendment L.001 (Attachment C).",5,0,0,0,5
1957711,1545750,2025-04-11,Senate,"Senate Appropriations: Refer Senate Bill 25-158 to the Committee of the Whole.",4,3,0,0,7
1957711,1547450,2025-03-04,Senate,"Senate State, Veterans, & Military Affairs: Adopt amendment L.002 (Attachment D).",5,0,0,0,5
1957711,1547451,2025-03-04,Senate,"Senate State, Veterans, & Military Affairs: Refer Senate Bill 25-158, as amended, to the Committee on Appropriations.",3,2,0,0,5
1957711,1551497,2025-04-17,Senate,"Senate: Third Reading Bill",22,13,0,0,35
1957711,1551498,2025-04-17,Senate,"Senate: Third Reading Bill",22,13,0,0,35
1957711,1560855,2025-04-29,House,"House State, Civic, Military, & Veterans Affairs: Refer Senate Bill 25-158, as amended, to the Committee of the Whole.",8,2,0,1,11
1957711,1563463,2025-05-01,House,"House: Third Reading Bill",39,24,0,2,65
1957711,1564731,2025-05-02,Senate,"Senate: House Amendments Concur",35,0,0,0,35
1957711,1564732,2025-05-02,Senate,"Senate: House Amendments Repass",22,13,0,0,35
1957711,1565541,2025-04-29,House,"House State, Civic, Military, & Veterans Affairs: Refer Senate Bill 25-158, as amended, to the Committee of the Whole.",8,2,0,1,11
1957732,1563699,2025-05-01,Senate,"Senate State, Veterans, & Military Affairs: Postpone Senate Bill 25-131 indefinitely using a reversal of the previous roll call. There was no objection to the use of the reverse roll call, therefore, the bill was postponed indefinitely.",3,2,0,0,5
1957732,1567330,2025-05-01,Senate,"Senate State, Veterans, & Military Affairs: Postpone Senate Bill 25-131 indefinitely using a reversal of the previous roll call. There was no objection to the use of the reverse roll call, therefore, the bill was postponed indefinitely.",3,2,0,0,5
1957757,1495674,2025-02-20,Senate,"Senate Agriculture & Natural Resources: Refer Senate Bill 25-140 to the Committee of the Whole and with a recommendation that it be placed on the consent calendar.",5,0,0,2,7
1957757,1500588,2025-02-26,Senate,"Senate: Third Reading Bill",30,2,0,2,34
1957757,1509756,2025-03-10,House,"House Agriculture, Water & Natural Resources: Refer Senate Bill 25-140 to the Committee of the Whole.",11,0,0,2,13
1957757,1521722,2025-03-19,House,"House: Third Reading Bill",58,6,0,1,65
1957782,1542259,2025-04-09,Senate,"Senate Judiciary: Postpone Senate Bill 25-134 indefinitely.",7,0,0,0,7
1957806,1503781,2025-03-03,Senate,"Senate Judiciary: Refer Senate Bill 25-126 to the Committee on Appropriations.",6,1,0,0,7
1957806,1548031,2025-04-15,Senate,"Senate Appropriations: Adopt amendment J.001",7,0,0,0,7
1957806,1551018,2025-04-15,Senate,"Senate Appropriations: Refer Senate Bill 25-126, as amended, to the Committee of the Whole.",4,3,0,0,7
1957806,1552482,2025-04-21,Senate,"Senate: Third Reading Bill",23,12,0,0,35
1957806,1559031,2025-04-28,House,"House Judiciary: Refer Senate Bill 25-126 to the Committee on Appropriations.",7,4,0,0,11
1957806,1561734,2025-04-30,House,"House Appropriations: Refer Senate Bill 25-126 to the Committee of the Whole.",6,5,0,0,11
1957806,1562340,2025-04-30,House,"House: Committee of the Whole Amd (h.001)",27,36,0,2,65
1957806,1563486,2025-05-01,House,"House: Third Reading Bill",40,23,0,2,65
1957830,1499865,2025-02-25,Senate,"Senate Finance: Adopt amendment L.002 (Attachment C)",9,0,0,0,9
1957830,1499866,2025-02-25,Senate,"Senate Finance: Refer Senate Bill 25-147, as amended, to the Committee on Appropriations.",9,0,0,0,9
1957830,1508620,2025-03-07,Senate,"Senate Appropriations: Refer Senate Bill 25-147 to the Committee of the Whole and with a recommendation that it be placed on the consent calendar.",7,0,0,0,7
1957830,1515818,2025-03-12,Senate,"Senate: Third Reading Bill",34,0,0,0,34
1957830,1527144,2025-03-24,House,"House Finance: Refer Senate Bill 25-147 to the Committee on Appropriations.",13,0,0,0,13
1957830,1546177,2025-04-11,House,"House Appropriations: Refer Senate Bill 25-147 to the Committee of the Whole.",11,0,0,0,11
1957830,1558280,2025-04-25,House,"House: Third Reading Bill",59,4,0,2,65
1957856,1517351,2025-03-13,Senate,"Senate Local Government & Housing: Adopt amendment L.004",7,0,0,0,7
1957856,1518736,2025-03-13,Senate,"Senate Local Government & Housing: Adopt amendment L.001",7,0,0,0,7
1957856,1518738,2025-03-13,Senate,"Senate Local Government & Housing: Adopt amendment L.005",7,0,0,0,7
1957856,1518739,2025-03-13,Senate,"Senate Local Government & Housing: Refer Senate Bill 25-149, as amended, to the Committee of the Whole.",6,1,0,0,7
1957856,1520808,2025-03-19,Senate,"Senate: Third Reading Bill",28,6,0,0,34
1957856,1532982,2025-04-01,House,"House Transportation, Housing & Local Government: Refer Senate Bill 25-149 to the Committee of the Whole.",9,3,0,1,13
1957856,1547428,2025-04-14,House,"House: Third Reading Bill",44,20,0,1,65
1957878,1501991,2025-02-27,Senate,"Senate Agriculture & Natural Resources: Adopt amendment L.002 (Attachment C).",5,2,0,0,7
1957878,1504163,2025-03-04,Senate,"Senate: Committee of the Whole Adopt Report",33,0,0,1,34
1957878,1508751,2025-03-07,Senate,"Senate: Third Reading Bill",25,6,0,3,34
1957878,1514747,2025-02-27,Senate,"Senate Agriculture & Natural Resources: Refer Senate Bill 25-128, as amended, to the Committee of the Whole.",5,2,0,0,7
1957878,1518998,2025-03-17,House,"House Agriculture, Water & Natural Resources: Refer Senate Bill 25-128 to the Committee of the Whole.",10,2,0,1,13
1957878,1552655,2025-04-21,House,"House: Third Reading Bill",53,11,0,1,65
1957905,1501359,2025-02-27,Senate,"Senate State, Veterans, & Military Affairs: Refer Senate Bill 25-136 to the Committee on Appropriations.",2,3,0,0,5
1957905,1509002,2025-02-27,Senate,"Senate State, Veterans, & Military Affairs: Postpone Senate Bill 25-136 indefinitely using a reversal of the previous roll call. There was no objection to the use of the reverse roll call, therefore, the bill was postponed indefinitely.",3,2,0,0,5
1957926,1499621,2025-02-25,Senate,"Senate State, Veterans, & Military Affairs: Refer Senate Bill 25-135 to the Committee of the Whole.",1,3,0,1,5
1957926,1517130,2025-02-25,Senate,"Senate State, Veterans, & Military Affairs: Postpone Senate Bill 25-135 indefinitely using a reversal of the previous roll call. There was no objection to the use of the reverse roll call, therefore, the bill was postponed indefinitely.",3,1,0,1,5
1957948,1488276,2025-02-12,Senate,"Senate Judiciary: Adopt amendment L.001 (Attachment B)",7,0,0,0,7
1957948,1493208,2025-02-12,Senate,"Senate Judiciary: Refer Senate Bill 25-129, as amended, to the Committee of the Whole.",5,2,0,0,7
1957948,1497517,2025-02-24,Senate,"Senate: Third Reading Bill",21,10,0,3,34
1957948,1521907,2025-03-19,House,"House Judiciary: Adopt amendment L.006 (Attachment B)",11,0,0,0,11
1957948,1537388,2025-04-04,House,"House: Committee of the Whole Amd (h.001)",19,38,0,8,65
1957948,1537389,2025-04-04,House,"House: Committee of the Whole Amd (h.002)",19,38,0,8,65
1957948,1537390,2025-04-04,House,"House: Committee of the Whole Amd (h.003)",20,37,0,8,65
1957948,1537391,2025-04-04,House,"House: Committee of the Whole Amd (h.004)",20,37,0,8,65
1957948,1537392,2025-04-04,House,"House: Committee of the Whole Amd (h.005)",19,38,0,8,65
1957948,1537393,2025-04-04,House,"House: Committee of the Whole Amd (h.006)",19,38,0,8,65
1957948,1537394,2025-04-04,House,"House: Committee of the Whole Amd (h.007)",19,38,0,8,65
1957948,1537920,2025-04-06,House,"House: Third Reading Bill",39,20,0,6,65
1957948,1537921,2025-04-06,House,"House: Third Reading Prev ?",36,22,0,7,65
1957948,1539496,2025-04-08,Senate,"Senate: House Amendments Concur",34,0,0,1,35
1957948,1539497,2025-04-08,Senate,"Senate: House Amendments Repass",23,11,0,1,35
1957948,1552187,2025-03-19,House,"House Judiciary: Adopt amendment L.009 (Attachment C)",11,0,0,0,11
1957948,1552188,2025-03-19,House,"House Judiciary: Refer Senate Bill 25-129, as amended, to the Committee of the Whole.",7,4,0,0,11
1957974,1496074,2025-02-20,Senate,"Senate Health & Human Services: Adopt amendment L.001 (Attachment F).",9,0,0,0,9
1957974,1502809,2025-02-20,Senate,"Senate Health & Human Services: Refer Senate Bill 25-150, as amended, to the Committee on Appropriations.",6,3,0,0,9
1957999,1520003,2025-03-18,Senate,"Senate Business, Labor, & Technology: Adopt amendment L.005",7,0,0,0,7
1957999,1539889,2025-03-18,Senate,"Senate Business, Labor, & Technology: Adopt amendment L.008",7,0,0,0,7
1957999,1539890,2025-03-18,Senate,"Senate Business, Labor, & Technology: Refer Senate Bill 25-132, as amended, to the Committee on Appropriations.",6,1,0,0,7
1957999,1551153,2025-04-17,Senate,"Senate Appropriations: Adopt amendment L.009",7,0,0,0,7
1957999,1551154,2025-04-17,Senate,"Senate Appropriations: Refer Senate Bill 25-132, as amended, to the Committee of the Whole.",6,1,0,0,7
1957999,1556597,2025-04-24,Senate,"Senate: Third Reading Bill",24,11,0,0,35
1957999,1564536,2025-05-01,House,"House Business Affairs & Labor: Postpone Senate Bill 25-132 indefinitely.",11,0,0,2,13
1958023,1505190,2025-03-04,Senate,"Senate State, Veterans, & Military Affairs: Refer Senate Bill 25-139 to the Committee on Appropriations.",2,3,0,0,5
1958023,1547328,2025-03-04,Senate,"Senate State, Veterans, & Military Affairs: Postpone Senate Bill 25-139 indefinitely using a reversal of the previous roll call. There was no objection to the use of the reverse roll call, therefore, the bill was postponed indefinitely.",3,2,0,0,5
1958049,1494388,2025-02-19,Senate,"Senate Health & Human Services: Adopt amendment L.001 (Attachment B).",9,0,0,0,9
1958049,1500444,2025-02-26,Senate,"Senate: Third Reading Bill",22,11,0,1,34
1958049,1502461,2025-02-19,Senate,"Senate Health & Human Services: Adopt amendment L.002 (Attachment C).",9,0,0,0,9
1958049,1502462,2025-02-19,Senate,"Senate Health & Human Services: Refer Senate Bill 25-151, as amended, to the Committee of the Whole.",7,1,0,1,9
1958049,1526667,2025-03-25,House,"House Health & Human Services: Refer Senate Bill 25-151 to the Committee of the Whole.",13,0,0,0,13
1958049,1531329,2025-03-31,House,"House: Third Reading Bill",44,20,0,1,65
1958073,1529554,2025-03-27,Senate,"Senate State, Veterans, & Military Affairs: Adopt amendment L.001 (Attachment B).",5,0,0,0,5
1958073,1533627,2025-03-27,Senate,"Senate State, Veterans, & Military Affairs: Adopt amendment L.002 (Attachment C).",5,0,0,0,5
1958073,1533628,2025-03-27,Senate,"Senate State, Veterans, & Military Affairs: Postpone Senate Bill 25-148 indefinitely using a reversal of the previous roll call. There was no objection to the use of the reverse roll call, therefore, the bill was postponed indefinitely.",3,2,0,0,5
1958073,1533629,2025-03-27,Senate,"Senate State, Veterans, & Military Affairs: Refer Senate Bill 25-148, as amended, to the Committee of the Whole.",2,3,0,0,5
1958094,1517138,2025-03-13,Senate,"Senate Business, Labor, & Technology: Adopt amendment L.001",7,0,0,0,7
1958094,1521668,2025-03-13,Senate,"Senate Business, Labor, & Technology: Refer Senate Bill 25-145, as amended, to the Committee of the Whole.",6,1,0,0,7
1958094,1524523,2025-03-21,Senate,"Senate: Third Reading Bill",29,5,0,1,35
1958094,1550179,2025-04-16,House,"House Business Affairs & Labor: Adopt amendment L.003",13,0,0,0,13
1958094,1555575,2025-04-16,House,"House Business Affairs & Labor: Refer Senate Bill 25-145, as amended, to the Committee of the Whole.",7,5,0,1,13
1958094,1555576,2025-04-23,House,"House: Third Reading Bill",41,22,0,2,65
1958094,1558203,2025-04-25,Senate,"Senate: House Amendments Concur",35,0,0,0,35
1958094,1558204,2025-04-25,Senate,"Senate: House Amendments Repass",30,5,0,0,35
1958119,1547183,2025-04-14,Senate,"Senate Judiciary: Adopt amendment L.006 (Attachment B)",7,0,0,0,7
1958119,1551191,2025-04-17,Senate,"Senate Appropriations: Adopt amendment J.002",7,0,0,0,7
1958119,1551192,2025-04-17,Senate,"Senate Appropriations: Refer Senate Bill 25-130, as amended, to the Committee of the Whole.",4,3,0,0,7
1958119,1555133,2025-04-14,Senate,"Senate Judiciary: Adopt amendment L.007 (Attachment C)",7,0,0,0,7
1958119,1555134,2025-04-14,Senate,"Senate Judiciary: Adopt amendment L.008 (Attachment D)",7,0,0,0,7
1958119,1555135,2025-04-14,Senate,"Senate Judiciary: Refer Senate Bill 25-130, as amended, to the Committee on Appropriations.",5,2,0,0,7
1958119,1555136,2025-04-23,Senate,"Senate: Third Reading Bill",23,12,0,0,35
1958119,1559326,2025-04-28,House,"House Health & Human Services: Refer Senate Bill 25-130 to the Committee on Appropriations.",9,4,0,0,13
1958119,1561785,2025-04-30,House,"House Appropriations: Refer Senate Bill 25-130 to the Committee of the Whole.",7,4,0,0,11
1958119,1564723,2025-05-02,House,"House: Committee of the Whole Amd (h.001)",20,42,0,3,65
1958119,1564724,2025-05-02,House,"House: Committee of the Whole Amd (h.002)",20,42,0,3,65
1958119,1564725,2025-05-02,House,"House: Committee of the Whole Amd (h.003)",20,41,0,4,65
1958119,1564726,2025-05-02,House,"House: Committee of the Whole Amd (h.004)",21,40,0,4,65
1958119,1564727,2025-05-02,House,"House: Committee of the Whole Amd (h.005)",19,42,0,4,65
1958119,1564728,2025-05-02,House,"House: Committee of the Whole Amd (h.007)",20,42,0,3,65
1958119,1564729,2025-05-02,House,"House: Committee of the Whole Amd (h.008)",20,42,0,3,65
1958119,1564754,2025-05-03,House,"House: Third Reading Bill",42,21,0,2,65
1958119,1566495,2025-05-06,Senate,"Senate: House Amendments Concur",35,0,0,0,35
1958119,1566496,2025-05-06,Senate,"Senate: House Amendments Repass",23,12,0,0,35
1958143,1549503,2025-04-15,Senate,"Senate State, Veterans, & Military Affairs: Adopt amendment L.001 (Attachment C).",5,0,0,0,5
1958143,1558269,2025-04-15,Senate,"Senate State, Veterans, & Military Affairs: Adopt amendment L.002 (Attachment D).",5,0,0,0,5
1958143,1558270,2025-04-15,Senate,"Senate State, Veterans, & Military Affairs: Refer Senate Bill 25-142, as amended, to the Committee on Appropriations.",3,2,0,0,5
1958143,1558271,2025-04-25,Senate,"Senate Appropriations: Refer Senate Bill 25-142 to the Committee of the Whole.",6,1,0,0,7
1958143,1558811,2025-04-28,Senate,"Senate: Third Reading Bill",30,4,0,1,35
1958143,1564010,2025-05-01,House,"House Energy & Environment: Refer Senate Bill 25-142 to the Committee of the Whole.",7,4,0,2,13
1958143,1564758,2025-05-03,House,"House: Third Reading Bill",42,21,0,2,65
1958167,1494142,2025-02-19,Senate,"Senate Transportation & Energy: Refer Senate Bill 25-141 to the Committee of the Whole.",5,4,0,0,9
1958167,1507054,2025-03-06,Senate,"Senate: Third Reading Bill",19,13,0,2,34
1958167,1526063,2025-03-25,House,"House Transportation, Housing & Local Government: Refer Senate Bill 25-141 to the Committee of the Whole.",5,7,0,1,13
1958167,1530772,2025-03-25,House,"House Transportation, Housing & Local Government: Postpone Senate Bill 25-141 indefinitely using a reversal of the previous roll call. There was no objection to the use of the reverse roll call, therefore, the bill was postponed indefinitely.",7,5,0,1,13
1958190,1499437,2025-02-25,Senate,"Senate Finance: Adopt amendment L.001 (Attachment A)",9,0,0,0,9
1958190,1500560,2025-02-25,Senate,"Senate Finance: Refer Senate Bill 25-133, as amended, to the Committee of the Whole and with a recommendation that it be placed on the consent calendar.",9,0,0,0,9
1958190,1503888,2025-03-03,Senate,"Senate: Third Reading Bill",33,1,0,0,34
1958190,1509196,2025-03-10,House,"House Finance: Adopt amendment L.002 (Attachment B).",13,0,0,0,13
1958190,1517449,2025-03-13,House,"House: Third Reading Bill",48,13,0,4,65
1958190,1519060,2025-03-10,House,"House Finance: Refer Senate Bill 25-133, as amended, to the Committee of the Whole.",10,3,0,0,13
1958190,1519062,2025-03-17,Senate,"Senate: House Amendments Concur",34,0,0,0,34
1958190,1519063,2025-03-17,Senate,"Senate: House Amendments Repass",33,1,0,0,34
1958215,1506846,2025-03-05,Senate,"Senate Education: Adopt amendment L.002",7,0,0,0,7
1958215,1517867,2025-03-14,Senate,"Senate: Third Reading Bill",33,1,0,0,34
1958215,1521419,2025-03-05,Senate,"Senate Education: Adopt amendment L.008",7,0,0,0,7
1958215,1521420,2025-03-05,Senate,"Senate Education: Adopt amendment L.009",7,0,0,0,7
1958215,1521421,2025-03-05,Senate,"Senate Education: Refer Senate Bill 25-143, as amended, to the Committee of the Whole.",4,3,0,0,7
1958215,1527621,2025-03-26,House,"House Education: Refer Senate Bill 25-143 to the Committee of the Whole.",13,0,0,0,13
1958215,1535931,2025-04-03,House,"House: Third Reading Bill",63,2,0,0,65
1958215,1537204,2025-04-04,Senate,"Senate: House Amendments Concur",35,0,0,0,35
1958215,1537205,2025-04-04,Senate,"Senate: House Amendments Repass",35,0,0,0,35
1958236,1504470,2025-03-04,Senate,"Senate State, Veterans, & Military Affairs: Refer Senate Bill 25-156 to the Committee on Finance.",2,3,0,0,5
1958236,1547613,2025-03-04,Senate,"Senate State, Veterans, & Military Affairs: Postpone Senate Bill 25-156 indefinitely using a reversal of the previous roll call. There was no objection to the use of the reverse roll call, therefore, the bill was postponed indefinitely.",3,2,0,0,5
1958260,1501183,2025-02-27,Senate,"Senate State, Veterans, & Military Affairs: Refer Senate Bill 25-138 to the Committee on Appropriations.",2,3,0,0,5
1958260,1508747,2025-02-27,Senate,"Senate State, Veterans, & Military Affairs: Postpone Senate Bill 25-138 indefinitely using a reversal of the previous roll call. There was no objection to the use of the reverse roll call, therefore, the bill was postponed indefinitely.",3,2,0,0,5
1958284,1520723,2025-03-19,Joint,"Committee on Legal Services: Adopt amendment L.001",10,0,0,0,10
1958284,1524582,2025-03-19,Joint,"Committee on Legal Services: Adopt amendment L.002",10,0,0,0,10
1958284,1524583,2025-03-19,Joint,"Committee on Legal Services: Refer Senate Bill 25-125, as amended, to the Committee of the Whole and with a recommendation that it be placed on the consent calendar.",7,0,0,3,10
1958284,1524584,2025-03-24,Senate,"Senate: Third Reading Bill",32,1,0,2,35
1958284,1549947,2025-04-16,Joint,"Committee on Legal Services: Refer Senate Bill 25-125 to the Committee of the Whole.",7,1,0,2,10
1958284,1552545,2025-04-21,House,"House: Third Reading Bill",47,16,0,2,65
1958302,1497993,2025-02-24,Senate,"Senate Education: Adopt amendment L.001",7,0,0,0,7
1958302,1504736,2025-02-24,Senate,"Senate Education: Refer Senate Bill 25-153, as amended, to the Committee on Appropriations.",4,3,0,0,7
1958302,1558020,2025-04-25,Senate,"Senate Appropriations: Adopt amendment J.001",3,4,0,0,7
1958302,1559845,2025-04-25,Senate,"Senate Appropriations: Refer Senate Bill 25-153 to the Committee of the Whole.",4,3,0,0,7
1960302,1523216,2025-03-20,Senate,"Senate Agriculture & Natural Resources: Refer Senate Bill 25-159 to the Committee of the Whole.",3,4,0,0,7
1960302,1530899,2025-03-20,Senate,"Senate Agriculture & Natural Resources: Postpone Senate Bill 25-159 indefinitely using a reversal of the previous roll call. There was no objection to the use of the reverse roll call, therefore, the bill was postponed indefinitely.",4,3,0,0,7
1960399,1484307,2025-02-07,House,"House: RESOLUTIONS Res",61,0,0,4,65
1960399,1486996,2025-02-11,Senate,"Senate: Consideration of Resolutions Resolution",32,0,0,3,35
1960495,1500448,2025-02-26,House,"House Health & Human Services: Refer House Bill 25-1172 to the Committee of the Whole.",13,0,0,0,13
1960495,1502279,2025-02-28,House,"House: Third Reading Bill",38,22,0,5,65
1960495,1531790,2025-03-31,Senate,"Senate Judiciary: Refer House Bill 25-1172 to the Committee of the Whole and with a recommendation that it be placed on the consent calendar.",7,0,0,0,7
1960495,1537364,2025-04-04,Senate,"Senate: Third Reading Bill",32,2,0,1,35
1960592,1500544,2025-02-26,House,"House Education: Adopt amendment L.001",13,0,0,0,13
1960592,1505353,2025-03-04,House,"House: Third Reading Bill",54,8,0,3,65
1960592,1517564,2025-02-26,House,"House Education: Refer House Bill 25-1173, as amended, to the Committee of the Whole.",12,0,0,1,13
1960592,1519150,2025-03-17,Senate,"Senate Education: Refer House Bill 25-1173 to the Committee of the Whole.",4,2,0,1,7
1960592,1524521,2025-03-21,Senate,"Senate: Third Reading Bill",22,12,0,1,35
1960687,1484030,2025-02-07,House,"House: RESOLUTIONS Res",61,0,0,4,65
1960687,1486592,2025-02-11,Senate,"Senate: Consideration of Resolutions Resolution",32,0,0,3,35
1960784,1484227,2025-02-07,House,"House: RESOLUTIONS Res",61,0,0,4,65
1960784,1486663,2025-02-11,Senate,"Senate: Consideration of Resolutions Resolution",32,0,0,3,35
1960880,1484226,2025-02-07,House,"House: RESOLUTIONS Res",61,0,0,4,65
1960880,1486699,2025-02-11,Senate,"Senate: Consideration of Resolutions Resolution",32,0,0,3,35
1960967,1540549,2025-04-08,House,"House Judiciary: Refer House Bill 25-1171, as amended, to the Committee on Appropriations.",6,5,0,0,11
1960967,1548079,2025-04-15,House,"House Appropriations: Refer House Bill 25-1171 to the Committee of the Whole.",6,5,0,0,11
1960967,1551947,2025-04-17,House,"House: Committee of the Whole Amd (h.001)",22,39,0,4,65
1960967,1552510,2025-04-21,House,"House: Third Reading Bill",36,27,0,2,65
1960967,1562197,2025-04-30,Senate,"Senate Judiciary: Adopt amendment L.004 (Attachment B)",5,2,0,0,7
1960967,1565094,2025-04-30,Senate,"Senate Judiciary: Refer House Bill 25-1171, as amended, to the Committee of the Whole.",6,1,0,0,7
1960967,1565949,2025-05-06,Senate,"Senate: Third Reading Bill",30,5,0,0,35
1960967,1567101,2025-05-07,House,"House: Senate Amendments Adhere",34,31,0,0,65
1960967,1567599,2025-05-07,Senate,"Senate: House Amendments Concur",28,7,0,0,35
1960967,1567600,2025-05-07,Senate,"Senate: House Amendments Repass",26,9,0,0,35
1961465,1483900,2025-02-07,House,"House: RESOLUTIONS Res",61,0,0,4,65
1961465,1486911,2025-02-11,Senate,"Senate: Consideration of Resolutions Resolution",32,0,0,3,35
1961512,1483901,2025-02-07,House,"House: RESOLUTIONS Res",61,0,0,4,65
1961512,1486103,2025-02-11,Senate,"Senate: Consideration of Resolutions Resolution",32,0,0,3,35
1961564,1483902,2025-02-07,House,"House: RESOLUTIONS Res",60,0,0,5,65
1961564,1486584,2025-02-11,Senate,"Senate: Consideration of Resolutions Resolution",32,0,0,3,35
1961619,1483903,2025-02-07,House,"House: RESOLUTIONS Res",61,0,0,4,65
1961619,1486178,2025-02-11,Senate,"Senate: Consideration of Resolutions Resolution",32,0,0,3,35
1961671,1484321,2025-02-07,House,"House: RESOLUTIONS Res",61,0,0,4,65
1961671,1486958,2025-02-11,Senate,"Senate: Consideration of Resolutions Resolution",33,0,0,2,35
1961725,1483905,2025-02-07,House,"House: RESOLUTIONS Res",61,0,0,4,65
1961725,1486362,2025-02-11,Senate,"Senate: Consideration of Resolutions Resolution",33,0,0,2,35
1961779,1483906,2025-02-07,House,"House: RESOLUTIONS Res",61,0,0,4,65
1961779,1486969,2025-02-11,Senate,"Senate: Consideration of Resolutions Resolution",33,0,0,2,35
1964114,1498874,2025-02-25,House,"House Health & Human Services: Refer House Bill 25-1176 to the Committee of the Whole.",12,1,0,0,13
1964114,1504648,2025-03-04,House,"House: Third Reading Bill",55,7,0,3,65
1964114,1551670,2025-04-17,Senate,"Senate Health & Human Services: Adopt amendment L.001 (Attachment G).",9,0,0,0,9
1964114,1555185,2025-04-23,Senate,"Senate: Third Reading Bill",35,0,0,0,35
1964114,1563900,2025-04-17,Senate,"Senate Health & Human Services: Refer House Bill 25-1176, as amended, to the Committee of the Whole and with a recommendation that it be placed on the consent calendar.",9,0,0,0,9
1964114,1563901,2025-05-01,House,"House: Senate Amendments Concur",58,5,0,2,65
1964114,1563902,2025-05-01,House,"House: Senate Amendments Repass",57,6,0,2,65
1964120,1503351,2025-03-03,House,"House State, Civic, Military, & Veterans Affairs: Postpone House Bill 25-1193 indefinitely.",7,3,0,1,11
1964130,1500145,2025-02-26,House,"House Judiciary: Refer House Bill 25-1181 to the Committee of the Whole.",10,0,0,1,11
1964130,1505025,2025-03-04,House,"House: Third Reading Bill",62,0,0,3,65
1964130,1516523,2025-03-12,Senate,"Senate Judiciary: Refer House Bill 25-1181 to the Committee of the Whole and with a recommendation that it be placed on the consent calendar.",6,0,0,1,7
1964130,1520055,2025-03-18,Senate,"Senate: Third Reading Bill",33,0,0,1,34
1964140,1504939,2025-03-04,House,"House Transportation, Housing & Local Government: Adopt amendment L.001 (Attachment C)",13,0,0,0,13
1964140,1507328,2025-03-04,House,"House Transportation, Housing & Local Government: Adopt amendment L.002 (Attachment D)",13,0,0,0,13
1964140,1507329,2025-03-04,House,"House Transportation, Housing & Local Government: Adopt amendment L.003 (Attachment E)",4,9,0,0,13
1964140,1507330,2025-03-04,House,"House Transportation, Housing & Local Government: Refer House Bill 25-1207, as amended, to the Committee of the Whole.",8,4,0,1,13
1964140,1532261,2025-04-01,House,"House: Third Reading Bill",39,24,0,2,65
1964140,1551682,2025-04-17,Senate,"Senate Local Government & Housing: Adopt amendment L.006",7,0,0,0,7
1964140,1552519,2025-04-17,Senate,"Senate Local Government & Housing: Refer House Bill 25-1207, as amended, to the Committee of the Whole.",4,2,0,1,7
1964140,1555167,2025-04-23,Senate,"Senate: Committee of the Whole Adopt Report",24,11,0,0,35
1964140,1556576,2025-04-24,Senate,"Senate: Third Reading Bill",22,13,0,0,35
1964140,1564011,2025-05-01,House,"House: Senate Amendments Concur",42,21,0,2,65
1964140,1564012,2025-05-01,House,"House: Senate Amendments Repass",40,23,0,2,65
1964151,1538556,2025-04-07,House,"House State, Civic, Military, & Veterans Affairs: Postpone House Bill 25-1191 indefinitely.",10,0,0,1,11
1964161,1509520,2025-03-10,House,"House Finance: Adopt amendment L.001 (Attachment E).",13,0,0,0,13
1964161,1518373,2025-03-10,House,"House Finance: Adopt amendment L.002 (Attachment F).",13,0,0,0,13
1964161,1518374,2025-03-10,House,"House Finance: Adopt amendment L.004 (Attachment G).",13,0,0,0,13
1964161,1518375,2025-03-10,House,"House Finance: Postpone House Bill 25-1199 indefinitely using a reversal of the previous roll call. There was no objection to the use of the reverse roll call, therefore, the bill was postponed indefinitely.",8,5,0,0,13
1964161,1518376,2025-03-10,House,"House Finance: Refer House Bill 25-1199, as amended, to the Committee of the Whole.",5,8,0,0,13
1964172,1523301,2025-03-20,House,"House Energy & Environment: Adopt amendment L.002",13,0,0,0,13
1964172,1524255,2025-03-20,House,"House Energy & Environment: Refer House Bill 25-1177, as amended, to the Committee of the Whole.",11,1,0,1,13
1964172,1535831,2025-04-03,House,"House: Third Reading Bill",62,3,0,0,65
1964172,1555683,2025-04-23,Senate,"Senate Transportation & Energy: Refer House Bill 25-1177 to the Committee of the Whole and with a recommendation that it be placed on the consent calendar.",9,0,0,0,9
1964172,1558809,2025-04-28,Senate,"Senate: Third Reading Bill",30,4,0,1,35
1964180,1506740,2025-03-05,House,"House Business Affairs & Labor: Adopt amendment L.001",13,0,0,0,13
1964180,1511395,2025-03-05,House,"House Business Affairs & Labor: Adopt amendment L.002",13,0,0,0,13
1964180,1511396,2025-03-05,House,"House Business Affairs & Labor: Refer House Bill 25-1180, as amended, to the Committee of the Whole.",10,3,0,0,13
1964180,1512571,2025-03-11,House,"House: Third Reading Bill",44,15,0,6,65
1964180,1544298,2025-04-10,Senate,"Senate Agriculture & Natural Resources: Refer House Bill 25-1180 to the Committee of the Whole and with a recommendation that it be placed on the consent calendar.",6,0,0,1,7
1964180,1546921,2025-04-14,Senate,"Senate: Third Reading Bill",32,1,0,2,35
1964194,1516748,2025-03-12,House,"House Judiciary: Adopt amendment L.001 (Attachment E)",11,0,0,0,11
1964194,1525901,2025-03-25,House,"House: Third Reading Bill",32,28,0,5,65
1964194,1537072,2025-03-12,House,"House Judiciary: Refer House Bill 25-1187, as amended, to the Committee of the Whole.",6,5,0,0,11
1964204,1508382,2025-03-06,House,"House Education: Adopt amendment L.001",13,0,0,0,13
1964204,1522417,2025-03-06,House,"House Education: Adopt amendment L.002",13,0,0,0,13
1964204,1522418,2025-03-06,House,"House Education: Adopt amendment L.006",13,0,0,0,13
1964204,1522419,2025-03-06,House,"House Education: Adopt amendment L.007",13,0,0,0,13
1964204,1522420,2025-03-06,House,"House Education: Adopt amendment L.010",13,0,0,0,13
1964204,1522421,2025-03-06,House,"House Education: Refer House Bill 25-1192, as amended, to the Committee on Appropriations.",8,5,0,0,13
1964204,1557968,2025-04-25,House,"House Appropriations: Adopt amendment L.018",11,0,0,0,11
1964204,1559015,2025-04-28,House,"House: Third Reading Bill",45,19,0,1,65
1964204,1560188,2025-04-25,House,"House Appropriations: Adopt amendment J.002",11,0,0,0,11
1964204,1560189,2025-04-25,House,"House Appropriations: Refer House Bill 25-1192, as amended, to the Committee of the Whole.",8,3,0,0,11
1964204,1564980,2025-05-05,Senate,"Senate Appropriations: Refer House Bill 25-1192 to the Committee of the Whole.",5,2,0,0,7
1964204,1564981,2025-05-05,Senate,"Senate Education: Refer House Bill 25-1192, as amended, to the Committee on Appropriations.",5,2,0,0,7
1964204,1566530,2025-05-06,Senate,"Senate: Third Reading Bill",26,9,0,0,35
1964204,1567090,2025-05-07,House,"House: Senate Amendments Concur",60,4,0,1,65
1964204,1567091,2025-05-07,House,"House: Senate Amendments Repass",55,10,0,0,65
1964213,1516337,2025-03-12,House,"House Judiciary: Adopt amendment L.001 (Attachment D)",11,0,0,0,11
1964213,1522811,2025-03-20,House,"House Finance: Refer House Bill 25-1194 to the Committee on Appropriations.",11,2,0,0,13
1964213,1537660,2025-03-12,House,"House Judiciary: Refer House Bill 25-1194, as amended, to the Committee on Finance.",11,0,0,0,11
1964221,1507535,2025-03-06,House,"House State, Civic, Military, & Veterans Affairs: Adopt amendment L.001 (Attachment H).",11,0,0,0,11
1964221,1508669,2025-03-06,House,"House State, Civic, Military, & Veterans Affairs: Adopt amendment L.003 (Attachment I).",11,0,0,0,11
1964221,1508670,2025-03-06,House,"House State, Civic, Military, & Veterans Affairs: Refer House Bill 25-1195, as amended, to the Committee on Appropriations.",7,4,0,0,11
1964221,1537017,2025-04-04,House,"House Appropriations: Adopt amendment L.004",11,0,0,0,11
1964221,1537890,2025-04-04,House,"House Appropriations: Refer House Bill 25-1195, as amended, to the Committee of the Whole.",10,1,0,0,11
1964221,1545924,2025-04-11,House,"House: Third Reading Bill",57,5,0,3,65
1964221,1554077,2025-04-22,Senate,"Senate State, Veterans, & Military Affairs: Refer House Bill 25-1195, as amended, to the Committee of the Whole.",4,1,0,0,5
1964221,1558861,2025-04-28,Senate,"Senate: Third Reading Bill",33,1,0,1,35
1964221,1563944,2025-05-01,House,"House: Senate Amendments Concur",63,0,0,2,65
1964221,1563945,2025-05-01,House,"House: Senate Amendments Repass",55,8,0,2,65
1964221,1567086,2025-04-22,Senate,"Senate State, Veterans, & Military Affairs: Refer House Bill 25-1195, as amended, to the Committee of the Whole.",4,1,0,0,5
1964239,1526776,2025-03-25,House,"House Transportation, Housing & Local Government: Adopt amendment L.001 (Attachment L)",13,0,0,0,13
1964239,1529995,2025-03-25,House,"House Transportation, Housing & Local Government: Adopt amendment L.007 (Attachment M)",13,0,0,0,13
1964239,1529996,2025-03-25,House,"House Transportation, Housing & Local Government: Refer House Bill 25-1198, as amended, to the Committee on Appropriations.",9,4,0,0,13
1964239,1548111,2025-04-15,House,"House Appropriations: Refer House Bill 25-1198 to the Committee of the Whole.",7,4,0,0,11
1964239,1552507,2025-04-21,House,"House: Third Reading Amd (l.010)",40,23,0,2,65
1964239,1552508,2025-04-21,House,"House: Third Reading Bill",38,25,0,2,65
1964239,1552509,2025-04-21,House,"House: Third Reading Perm",42,21,0,2,65
1964239,1557121,2025-04-24,Senate,"Senate Local Government & Housing: Refer House Bill 25-1198 to the Committee on Appropriations.",4,3,0,0,7
1964239,1561689,2025-04-30,Senate,"Senate Appropriations: Refer House Bill 25-1198 to the Committee of the Whole.",4,3,0,0,7
1964239,1564466,2025-05-02,Senate,"Senate: Third Reading Bill",21,13,0,1,35
1964249,1503853,2025-03-03,House,"House Agriculture, Water & Natural Resources: Refer House Bill 25-1203 to the Committee of the Whole.",12,0,0,1,13
1964249,1509140,2025-03-10,House,"House: Third Reading Bill",62,0,0,3,65
1964249,1523351,2025-03-20,Senate,"Senate Agriculture & Natural Resources: Refer House Bill 25-1203 to the Committee of the Whole and with a recommendation that it be placed on the consent calendar.",7,0,0,0,7
1964249,1527409,2025-03-26,Senate,"Senate: Third Reading Bill",34,0,0,1,35
1964256,1505081,2025-03-04,House,"House Judiciary: Refer House Bill 25-1185 to the Committee of the Whole.",10,1,0,0,11
1964256,1509301,2025-03-10,House,"House: Third Reading Bill",62,0,0,3,65
1964256,1531822,2025-03-31,Senate,"Senate Judiciary: Refer House Bill 25-1185 to the Committee of the Whole and with a recommendation that it be placed on the consent calendar.",7,0,0,0,7
1964256,1537372,2025-04-04,Senate,"Senate: Third Reading Bill",34,0,0,1,35
1964256,1537373,2025-04-04,Senate,"Senate: Third Reading Bill",35,0,0,0,35
1964270,1504435,2025-03-04,House,"House Health & Human Services: Adopt amendment L.002 (Attachment C).",13,0,0,0,13
1964270,1517912,2025-03-14,House,"House Appropriations: Refer House Bill 25-1204 to the Committee of the Whole.",9,2,0,0,11
1964270,1520865,2025-03-19,House,"House: Third Reading Bill",62,2,0,1,65
1964270,1526389,2025-03-04,House,"House Health & Human Services: Adopt amendment L.001 (Attachment B).",13,0,0,0,13
1964270,1526390,2025-03-04,House,"House Health & Human Services: Refer House Bill 25-1204, as amended, to the Committee on Appropriations.",13,0,0,0,13
1964270,1555277,2025-04-23,Senate,"Senate Health & Human Services: Adopt amendment L.003 (Attachment A).",9,0,0,0,9
1964270,1558813,2025-04-28,Senate,"Senate: Third Reading Bill",33,1,0,1,35
1964270,1563969,2025-04-23,Senate,"Senate Health & Human Services: Adopt amendment L.004 (Attachment B).",9,0,0,0,9
1964270,1563970,2025-04-23,Senate,"Senate Health & Human Services: Adopt amendment L.005 (Attachment C).",9,0,0,0,9
1964270,1563971,2025-04-23,Senate,"Senate Health & Human Services: Adopt amendment L.006 (Attachment D).",9,0,0,0,9
1964270,1563972,2025-04-23,Senate,"Senate Health & Human Services: Refer House Bill 25-1204, as amended, to the Committee of the Whole and with a recommendation that it be placed on the consent calendar.",9,0,0,0,9
1964270,1563973,2025-05-01,House,"House: Senate Amendments Concur",57,7,0,1,65
1964270,1563974,2025-05-01,House,"House: Senate Amendments Repass",55,10,0,0,65
1964277,1500794,2025-02-26,House,"House Health & Human Services: Adopt amendment L.003 (Attachment E).",13,0,0,0,13
1964277,1508555,2025-03-07,House,"House Appropriations: Adopt amendment J.001",11,0,0,0,11
1964277,1509169,2025-03-07,House,"House Appropriations: Refer House Bill 25-1174, as amended, to the Committee of the Whole.",6,5,0,0,11
1964277,1516178,2025-02-26,House,"House Health & Human Services: Refer House Bill 25-1174, as amended, to the Committee on Appropriations.",8,4,0,1,13
1964293,1517496,2025-03-13,House,"House Energy & Environment: Adopt amendment L.001",13,0,0,0,13
1964293,1518786,2025-03-13,House,"House Energy & Environment: Refer House Bill 25-1175, as amended, to the Committee of the Whole.",11,2,0,0,13
1964293,1520886,2025-03-19,House,"House: Third Reading Bill",54,10,0,1,65
1964293,1541836,2025-04-09,Senate,"Senate Transportation & Energy: Adopt amendment L.005",9,0,0,0,9
1964293,1546033,2025-04-09,Senate,"Senate Transportation & Energy: Refer House Bill 25-1175, as amended, to the Committee of the Whole and with a recommendation that it be placed on the consent calendar.",9,0,0,0,9
1964293,1546892,2025-04-14,Senate,"Senate: Third Reading Bill",32,1,0,2,35
1964293,1549425,2025-04-15,House,"House: Senate Amendments Concur",59,5,0,1,65
1964293,1549426,2025-04-15,House,"House: Senate Amendments Repass",56,8,0,1,65
1964302,1506979,2025-03-05,House,"House Education: Adopt amendment L.002 to L.001",13,0,0,0,13
1964302,1522683,2025-03-05,House,"House Education: Adopt amendment L.001 as amended",13,0,0,0,13
1964302,1522684,2025-03-05,House,"House Education: Adopt amendment L.003 to L.001",13,0,0,0,13
1964302,1522685,2025-03-05,House,"House Education: Refer House Bill 25-1186, as amended, to the Committee on Appropriations.",12,1,0,0,13
1964302,1560669,2025-04-29,House,"House Appropriations: Adopt amendment L.007",11,0,0,0,11
1964302,1562153,2025-04-29,House,"House Appropriations: Refer House Bill 25-1186, as amended, to the Committee of the Whole.",7,4,0,0,11
1964302,1562154,2025-04-30,House,"House: Third Reading Bill",51,14,0,0,65
1964302,1563288,2025-04-30,Senate,"Senate Education: Refer House Bill 25-1186 to the Committee on Appropriations.",7,0,0,0,7
1964302,1564510,2025-05-02,Senate,"Senate Appropriations: Refer House Bill 25-1186 to the Committee of the Whole and with a recommendation that it be placed on the consent calendar.",7,0,0,0,7
1964302,1565199,2025-05-05,Senate,"Senate: Third Reading Bill",33,2,0,0,35
1964315,1499105,2025-02-25,House,"House Health & Human Services: Refer House Bill 25-1184 to the Committee of the Whole.",11,2,0,0,13
1964315,1504561,2025-03-04,House,"House: Third Reading Bill",50,12,0,3,65
1964315,1541972,2025-04-09,Senate,"Senate Health & Human Services: Adopt amendment L.001 (Attachment B).",9,0,0,0,9
1964315,1546906,2025-04-14,Senate,"Senate: Third Reading Bill",33,0,0,2,35
1964315,1549385,2025-04-15,House,"House: Senate Amendments Concur",61,3,0,1,65
1964315,1549386,2025-04-15,House,"House: Senate Amendments Repass",56,8,0,1,65
1964315,1560337,2025-04-09,Senate,"Senate Health & Human Services: Refer House Bill 25-1184, as amended, to the Committee of the Whole and with a recommendation that it be placed on the consent calendar.",9,0,0,0,9
1964322,1498875,2025-02-25,House,"House Health & Human Services: Refer House Bill 25-1200 to the Committee of the Whole.",13,0,0,0,13
1964322,1505917,2025-03-05,House,"House: Third Reading Bill",55,6,0,4,65
1964322,1542324,2025-04-09,Senate,"Senate Health & Human Services: Adopt amendment L.004 (Attachment F).",9,0,0,0,9
1964322,1547513,2025-04-14,Senate,"Senate: Third Reading Bill",32,1,0,2,35
1964322,1548929,2025-04-15,House,"House: Senate Amendments Concur",61,3,0,1,65
1964322,1548930,2025-04-15,House,"House: Senate Amendments Repass",56,8,0,1,65
1964322,1560956,2025-04-09,Senate,"Senate Health & Human Services: Adopt amendment L.005 (Attachment G).",9,0,0,0,9
1964322,1560957,2025-04-09,Senate,"Senate Health & Human Services: Refer House Bill 25-1200, as amended, to the Committee of the Whole and with a recommendation that it be placed on the consent calendar.",8,0,0,1,9
1964333,1499515,2025-02-25,House,"House Transportation, Housing & Local Government: Adopt amendment L.001 (Attachment B)",13,0,0,0,13
1964333,1499896,2025-02-25,House,"House Transportation, Housing & Local Government: Adopt amendment L.007 (Attachment C)",13,0,0,0,13
1964333,1499897,2025-02-25,House,"House Transportation, Housing & Local Government: Adopt amendment L.008 (Attachment D)",13,0,0,0,13
1964333,1499898,2025-02-25,House,"House Transportation, Housing & Local Government: Adopt amendment L.009 (Attachment E)",13,0,0,0,13
1964333,1499899,2025-02-25,House,"House Transportation, Housing & Local Government: Refer House Bill 25-1189, as amended, to the Committee on Appropriations.",12,0,0,1,13
1964333,1556432,2025-04-24,House,"House Appropriations: Adopt amendment L.012",11,0,0,0,11
1964333,1557984,2025-04-25,House,"House: Third Reading Bill",53,10,0,2,65
1964333,1560306,2025-04-24,House,"House Appropriations: Refer House Bill 25-1189, as amended, to the Committee of the Whole.",8,2,0,1,11
1964333,1562336,2025-04-30,Senate,"Senate Transportation & Energy: Refer House Bill 25-1189 to the Committee on Appropriations.",7,0,0,2,9
1964333,1564476,2025-05-02,Senate,"Senate Appropriations: Refer House Bill 25-1189 to the Committee of the Whole and with a recommendation that it be placed on the consent calendar.",7,0,0,0,7
1964333,1564830,2025-05-05,Senate,"Senate: Third Reading Bill",32,3,0,0,35
1964350,1517484,2025-03-13,House,"House Business Affairs & Labor: Adopt amendment L.001",13,0,0,0,13
1964350,1521593,2025-03-13,House,"House Business Affairs & Labor: Adopt amendment L.002",13,0,0,0,13
1964350,1521594,2025-03-13,House,"House Business Affairs & Labor: Adopt amendment L.003",13,0,0,0,13
1964350,1521595,2025-03-13,House,"House Business Affairs & Labor: Adopt amendment L.004",13,0,0,0,13
1964350,1521596,2025-03-13,House,"House Business Affairs & Labor: Refer House Bill 25-1182, as amended, to the Committee of the Whole.",8,4,0,1,13
1964350,1522702,2025-03-20,House,"House: Third Reading Bill",45,18,0,2,65
1964350,1532837,2025-04-01,Senate,"Senate Business, Labor, & Technology: Refer House Bill 25-1182, as amended, to the Committee of the Whole and with a recommendation that it be placed on the consent calendar.",6,0,0,1,7
1964350,1537191,2025-04-04,Senate,"Senate: Third Reading Bill",33,1,0,1,35
1964350,1545961,2025-04-11,House,"House: Senate Amendments Concur",44,18,0,3,65
1964350,1545962,2025-04-11,House,"House: Senate Amendments Repass",42,20,0,3,65
1964357,1500565,2025-02-26,House,"House Business Affairs & Labor: Adopt amendment L.001",13,0,0,0,13
1964357,1504637,2025-03-04,House,"House: Third Reading Bill",46,16,0,3,65
1964357,1520228,2025-02-26,House,"House Business Affairs & Labor: Refer House Bill 25-1205, as amended, to the Committee of the Whole.",10,1,0,2,13
1964357,1522820,2025-03-20,Senate,"Senate Business, Labor, & Technology: Adopt amendment L.003",7,0,0,0,7
1964357,1525982,2025-03-25,Senate,"Senate: Third Reading Bill",28,7,0,0,35
1964357,1530285,2025-03-28,House,"House: Senate Amendments Concur",47,16,0,2,65
1964357,1530286,2025-03-28,House,"House: Senate Amendments Repass",48,15,0,2,65
1964357,1537512,2025-03-20,Senate,"Senate Business, Labor, & Technology: Refer House Bill 25-1205, as amended, to the Committee of the Whole and with a recommendation that it be placed on the consent calendar.",7,0,0,0,7
1964368,1517461,2025-03-13,House,"House Energy & Environment: Adopt amendment L.001",13,0,0,0,13
1964368,1518473,2025-03-13,House,"House Energy & Environment: Adopt amendment L.002",13,0,0,0,13
1964368,1518474,2025-03-13,House,"House Energy & Environment: Adopt amendment L.003",13,0,0,0,13
1964368,1518475,2025-03-13,House,"House Energy & Environment: Refer House Bill 25-1202, as amended, to the Committee on Appropriations.",8,4,0,1,13
1964379,1502079,2025-02-27,House,"House Business Affairs & Labor: Adopt amendment L.001",8,5,0,0,13
1964379,1504373,2025-02-27,House,"House Business Affairs & Labor: Refer House Bill 25-1179, as amended, to the Committee of the Whole.",8,5,0,0,13
1964379,1505736,2025-03-05,House,"House: Third Reading Bill",40,22,0,3,65
1964379,1522814,2025-03-20,Senate,"Senate Business, Labor, & Technology: Refer House Bill 25-1179 to the Committee of the Whole.",4,3,0,0,7
1964379,1526810,2025-03-25,Senate,"Senate: Third Reading Bill",24,11,0,0,35
1964392,1563678,2025-04-30,House,"House Judiciary: Postpone House Bill 25-1206 indefinitely.",11,0,0,0,11
1964399,1506900,2025-03-05,House,"House Energy & Environment: Adopt amendment L.002 (Attachment B).",13,0,0,0,13
1964399,1509027,2025-03-10,House,"House: Third Reading Bill",46,16,0,3,65
1964399,1521870,2025-03-05,House,"House Energy & Environment: Adopt amendment L.001 (Attachment A).",13,0,0,0,13
1964399,1521871,2025-03-05,House,"House Energy & Environment: Refer House Bill 25-1197, as amended, to the Committee of the Whole.",12,0,0,1,13
1964399,1542421,2025-04-09,Senate,"Senate Transportation & Energy: Refer House Bill 25-1197 to the Committee of the Whole.",6,3,0,0,9
1964399,1548927,2025-04-15,Senate,"Senate: Third Reading Bill",23,11,0,1,35
1964411,1550318,2025-04-16,House,"House Education: Postpone House Bill 25-1178 indefinitely using a reversal of the previous roll call. There was no objection to the use of the reverse roll call, therefore, the bill was postponed indefinitely.",11,2,0,0,13
1964411,1566102,2025-04-16,House,"House Education: Adopt amendment L.005 as amended",13,0,0,0,13
1964411,1566103,2025-04-16,House,"House Education: Adopt amendment L.007 to L.005",13,0,0,0,13
1964411,1566104,2025-04-16,House,"House Education: Postpone House Bill 25-1178 indefinitely using a reversal of the previous roll call. There was no objection to the use of the reverse roll call, therefore, the bill was postponed indefinitely.",11,2,0,0,13
1964411,1566105,2025-04-16,House,"House Education: Refer House Bill 25-1178, as amended, to the Committee of the Whole.",2,11,0,0,13
1964421,1503999,2025-03-03,House,"House Finance: Adopt amendment L.001 (Attachment G).",13,0,0,0,13
1964421,1508840,2025-03-07,House,"House: Third Reading Bill",63,1,0,1,65
1964421,1518417,2025-03-03,House,"House Finance: Adopt amendment L.002 (Attachment H).",13,0,0,0,13
1964421,1518418,2025-03-03,House,"House Finance: Adopt amendment L.003 (Attachment I).",13,0,0,0,13
1964421,1518419,2025-03-03,House,"House Finance: Refer House Bill 25-1201, as amended, to the Committee of the Whole.",13,0,0,0,13
1964421,1520253,2025-03-18,Senate,"Senate Finance: Refer House Bill 25-1201 to the Committee of the Whole and with a recommendation that it be placed on the consent calendar.",9,0,0,0,9
1964421,1524572,2025-03-24,Senate,"Senate: Third Reading Bill",33,0,0,2,35
1964432,1499354,2025-02-25,House,"House Health & Human Services: Refer House Bill 25-1188 to the Committee on Appropriations.",9,4,0,0,13
1964432,1548034,2025-04-15,House,"House Appropriations: Adopt amendment J.001",11,0,0,0,11
1964432,1551668,2025-04-17,House,"House: Third Reading Bill",43,19,0,3,65
1964432,1560335,2025-04-15,House,"House Appropriations: Refer House Bill 25-1188, as amended, to the Committee of the Whole.",8,3,0,0,11
1964432,1562562,2025-04-30,Senate,"Senate Health & Human Services: Refer House Bill 25-1188 to the Committee on Appropriations.",6,3,0,0,9
1964432,1564492,2025-05-02,Senate,"Senate Appropriations: Refer House Bill 25-1188 to the Committee of the Whole and with a recommendation that it be placed on the consent calendar.",7,0,0,0,7
1964432,1565158,2025-05-05,Senate,"Senate: Third Reading Bill",27,8,0,0,35
1964442,1503285,2025-03-03,House,"House Agriculture, Water & Natural Resources: Adopt amendment L.001 (Attachment B)",13,0,0,0,13
1964442,1521365,2025-03-03,House,"House Agriculture, Water & Natural Resources: Adopt amendment L.002 (Attachment C)",13,0,0,0,13
1964442,1521366,2025-03-03,House,"House Agriculture, Water & Natural Resources: Postpone House Bill 25-1190 indefinitely using a reversal of the previous roll call. There was no objection to the use of the reverse roll call, therefore, the bill was postponed indefinitely.",7,6,0,0,13
1964442,1521367,2025-03-03,House,"House Agriculture, Water & Natural Resources: Refer House Bill 25-1190, as amended, to the Committee on Appropriations.",6,7,0,0,13
1964452,1500672,2025-02-26,House,"House Judiciary: Adopt amendment L.001 (Attachment A)",11,0,0,0,11
1964452,1532295,2025-02-26,House,"House Judiciary: Refer House Bill 25-1183, as amended, to the Committee on Appropriations.",6,4,0,1,11
1964452,1537015,2025-04-04,House,"House Appropriations: Adopt amendment L.004",11,0,0,0,11
1964452,1537882,2025-04-04,House,"House Appropriations: Adopt amendment J.002",11,0,0,0,11
1964452,1537883,2025-04-04,House,"House Appropriations: Refer House Bill 25-1183, as amended, to the Committee of the Whole.",8,3,0,0,11
1964452,1549241,2025-04-15,House,"House: Committee of the Whole Amd (h.001)",25,39,0,1,65
1964452,1550024,2025-04-16,House,"House: Third Reading Bill",40,25,0,0,65
1964452,1555618,2025-04-23,Senate,"Senate Judiciary: Adopt amendment L.008 (Attachment E)",7,0,0,0,7
1964452,1560656,2025-04-29,Senate,"Senate: Third Reading Bill",23,9,0,3,35
1964452,1562009,2025-04-23,Senate,"Senate Judiciary: Refer House Bill 25-1183, as amended, to the Committee of the Whole and with a recommendation that it be placed on the consent calendar.",6,0,0,1,7
1964452,1563976,2025-05-01,House,"House: Senate Amendments Concur",43,22,0,0,65
1964452,1563977,2025-05-01,House,"House: Senate Amendments Repass",42,23,0,0,65
1965487,1506051,2025-03-05,Senate,"Senate Transportation & Energy: Adopt amendment L.002",9,0,0,0,9
1965487,1516152,2025-03-05,Senate,"Senate Transportation & Energy: Adopt amendment L.003",9,0,0,0,9
1965487,1516153,2025-03-05,Senate,"Senate Transportation & Energy: Refer Senate Bill 25-162, as amended, to the Committee on Appropriations.",6,3,0,0,9
1965487,1550995,2025-04-17,Senate,"Senate Appropriations: Adopt amendment L.013",7,0,0,0,7
1965487,1550996,2025-04-17,Senate,"Senate Appropriations: Adopt amendment L.014",7,0,0,0,7
1965487,1550997,2025-04-17,Senate,"Senate Appropriations: Adopt amendment L.015",7,0,0,0,7
1965487,1550998,2025-04-17,Senate,"Senate Appropriations: Refer Senate Bill 25-162, as amended, to the Committee of the Whole.",4,3,0,0,7
1965487,1555256,2025-04-23,Senate,"Senate: Third Reading Bill",23,12,0,0,35
1965487,1561332,2025-04-29,House,"House Finance: Adopt amendment L.023 (Attachment A).",13,0,0,0,13
1965487,1563556,2025-05-01,House,"House Appropriations: Refer Senate Bill 25-162 to the Committee of the Whole.",7,4,0,0,11
1965487,1564679,2025-04-29,House,"House Finance: Adopt amendment L.025 (Attachment B).",13,0,0,0,13
1965487,1564680,2025-04-29,House,"House Finance: Refer Senate Bill 25-162, as amended, to the Committee on Appropriations.",8,5,0,0,13
1965487,1564681,2025-05-02,House,"House: Third Reading Bill",44,19,0,2,65
1965487,1566773,2025-05-06,Senate,"Senate: House Amendments Concur",35,0,0,0,35
1965487,1566774,2025-05-06,Senate,"Senate: House Amendments Repass",23,12,0,0,35
1965550,1500276,2025-02-26,Senate,"Senate Health & Human Services: Adopt amendment L.001 (Attachment D).",9,0,0,0,9
1965550,1502250,2025-02-26,Senate,"Senate Health & Human Services: Adopt amendment L.002 (Attachment E).",9,0,0,0,9
1965550,1502251,2025-02-26,Senate,"Senate Health & Human Services: Adopt amendment L.003 (Attachment F).",9,0,0,0,9
1965550,1502252,2025-02-26,Senate,"Senate Health & Human Services: Refer Senate Bill 25-163, as amended, to the Committee on Appropriations.",7,2,0,0,9
1965550,1558010,2025-04-25,Senate,"Senate Appropriations: Adopt amendment L.009",7,0,0,0,7
1965550,1559769,2025-04-25,Senate,"Senate Appropriations: Adopt amendment L.013",7,0,0,0,7
1965550,1559770,2025-04-25,Senate,"Senate Appropriations: Refer Senate Bill 25-163, as amended, to the Committee of the Whole.",4,3,0,0,7
1965550,1559771,2025-04-29,Senate,"Senate: Third Reading Bill",21,11,0,3,35
1965550,1563928,2025-05-01,House,"House Finance: Adopt amendment L.014 (Attachment D).",13,0,0,0,13
1965550,1564654,2025-05-01,House,"House Finance: Refer Senate Bill 25-163, as amended, to the Committee on Appropriations.",9,2,0,2,13
1965550,1564834,2025-05-05,House,"House Appropriations: Refer Senate Bill 25-163 to the Committee of the Whole.",6,4,0,1,11
1965550,1565756,2025-05-06,House,"House: Third Reading Bill",44,21,0,0,65
1965550,1566679,2025-05-06,Senate,"Senate: House Amendments Concur",32,3,0,0,35
1965550,1566680,2025-05-06,Senate,"Senate: House Amendments Repass",23,12,0,0,35
1965618,1508196,2025-03-06,Senate,"Senate Business, Labor, & Technology: Adopt amendment L.001",7,0,0,0,7
1965618,1519123,2025-03-17,Senate,"Senate: Third Reading Bill",22,12,0,0,34
1965618,1520141,2025-03-06,Senate,"Senate Business, Labor, & Technology: Adopt amendment L.002",7,0,0,0,7
1965618,1520142,2025-03-06,Senate,"Senate Business, Labor, & Technology: Adopt amendment L.003",7,0,0,0,7
1965618,1520143,2025-03-06,Senate,"Senate Business, Labor, & Technology: Adopt amendment L.005",7,0,0,0,7
1965618,1520144,2025-03-06,Senate,"Senate Business, Labor, & Technology: Refer Senate Bill 25-160, as amended, to the Committee of the Whole.",5,2,0,0,7
1965618,1555846,2025-04-16,House,"House Business Affairs & Labor: Adopt amendment L.011",13,0,0,0,13
1965618,1557001,2025-04-24,House,"House Business Affairs & Labor: Layover until May 10",10,0,0,3,13
1965683,1490568,2025-02-14,Senate,"Senate: Consideration of Resolutions Resolution",30,0,0,5,35
1965683,1492718,2025-02-18,House,"House: RESOLUTIONS Res",64,0,0,1,65
1965741,1506868,2025-03-05,Senate,"Senate Transportation & Energy: Adopt amendment L.001",9,0,0,0,9
1965741,1516506,2025-03-05,Senate,"Senate Transportation & Energy: Adopt amendment L.002",9,0,0,0,9
1965741,1516507,2025-03-05,Senate,"Senate Transportation & Energy: Adopt amendment L.005",9,0,0,0,9
1965741,1516508,2025-03-05,Senate,"Senate Transportation & Energy: Refer Senate Bill 25-161, as amended, to the Committee on Appropriations.",6,3,0,0,9
1965741,1548039,2025-04-15,Senate,"Senate Appropriations: Adopt amendment J.001",4,3,0,0,7
1965741,1551051,2025-04-15,Senate,"Senate Appropriations: Refer Senate Bill 25-161, as amended, to the Committee of the Whole.",4,3,0,0,7
1965741,1553404,2025-04-22,Senate,"Senate: Third Reading Bill",23,12,0,0,35
1965741,1559049,2025-04-28,House,"House Transportation, Housing & Local Government: Adopt amendment L.021 (Attachment A)",13,0,0,0,13
1965741,1561717,2025-04-28,House,"House Transportation, Housing & Local Government: Adopt amendment L.022 (Attachment B)",13,0,0,0,13
1965741,1561718,2025-04-28,House,"House Transportation, Housing & Local Government: Adopt amendment L.023 (Attachment C)",13,0,0,0,13
1965741,1561719,2025-04-28,House,"House Transportation, Housing & Local Government: Refer Senate Bill 25-161, as amended, to the Committee on Appropriations.",9,4,0,0,13
1965741,1563361,2025-05-01,House,"House Appropriations: Refer Senate Bill 25-161 to the Committee of the Whole.",7,4,0,0,11
1965741,1564547,2025-05-02,House,"House: Third Reading Bill",40,23,0,2,65
1965741,1565115,2025-05-05,Senate,"Senate: House Amendments Not Concur Appt Cc",35,0,0,0,35
1965741,1565377,2025-05-05,House,"House: Conference Committee Report Byd Scp",44,19,0,2,65
1965741,1567146,2025-05-07,Joint,"CC_SB25-161_2025A: Adopt the draft conference committee report CLSB 161.002",6,0,0,0,6
1965741,1567671,2025-05-07,House,"House: Conference Committee Report Adopt",42,23,0,0,65
1965741,1567672,2025-05-07,House,"House: Conference Committee Report Byd Scp",41,20,0,4,65
1965741,1567673,2025-05-07,House,"House: Conference Committee Report Reject",44,21,0,0,65
1965741,1567674,2025-05-07,House,"House: Conference Committee Report Repass",43,22,0,0,65
1965741,1567675,2025-05-07,Senate,"Senate: Conference Committee Report 2nd Committee",35,0,0,0,35
1965741,1567981,2025-05-07,Senate,"Senate: Conference Committee Report Adopt Ccr",35,0,0,0,35
1965741,1567982,2025-05-07,Senate,"Senate: Conference Committee Report Repass",23,12,0,0,35
1965754,1516042,2025-03-12,House,"House Health & Human Services: Adopt amendment L.002 (Attachment C).",13,0,0,0,13
1965754,1525182,2025-03-12,House,"House Health & Human Services: Adopt amendment L.003 (Attachment D).",13,0,0,0,13
1965754,1525183,2025-03-12,House,"House Health & Human Services: Adopt amendment L.006 (Attachment E).",13,0,0,0,13
1965754,1525184,2025-03-12,House,"House Health & Human Services: Adopt amendment L.009 (Attachment F).",13,0,0,0,13
1965754,1525185,2025-03-12,House,"House Health & Human Services: Reconsider L.006 (Attachment E).",12,0,0,1,13
1965754,1525186,2025-03-12,House,"House Health & Human Services: Refer House Bill 25-1222, as amended, to the Committee of the Whole.",12,0,0,1,13
1965754,1526093,2025-03-25,House,"House: Third Reading Bill",61,1,0,3,65
1965754,1551676,2025-04-17,Senate,"Senate Health & Human Services: Adopt amendment L.016 (Attachment I).",9,0,0,0,9
1965754,1555103,2025-04-23,Senate,"Senate: Third Reading Bill",35,0,0,0,35
1965754,1563963,2025-04-17,Senate,"Senate Health & Human Services: Adopt amendment L.017 (Attachment J).",9,0,0,0,9
1965754,1563964,2025-04-17,Senate,"Senate Health & Human Services: Refer House Bill 25-1222, as amended, to the Committee of the Whole and with a recommendation that it be placed on the consent calendar.",9,0,0,0,9
1965754,1563965,2025-05-01,House,"House: Senate Amendments Concur",60,3,0,2,65
1965754,1563966,2025-05-01,House,"House: Senate Amendments Repass",60,3,0,2,65
1965758,1501140,2025-02-27,House,"House Finance: Adopt amendment L.001 (Attachment B).",11,2,0,0,13
1965758,1501652,2025-02-27,House,"House Finance: Adopt amendment L.002 (Attachment C).",13,0,0,0,13
1965758,1501653,2025-02-27,House,"House Finance: Refer House Bill 25-1224, as amended, to the Committee of the Whole.",11,2,0,0,13
1965758,1522634,2025-03-20,House,"House: Third Reading Bill",50,13,0,2,65
1965758,1532771,2025-04-01,Senate,"Senate Finance: Adopt amendment L.005 (Attachment B)",9,0,0,0,9
1965758,1537212,2025-04-01,Senate,"Senate Finance: Refer House Bill 25-1224, as amended, to the Committee of the Whole.",8,1,0,0,9
1965758,1537213,2025-04-04,Senate,"Senate: Third Reading Bill",25,10,0,0,35
1965758,1546072,2025-04-11,House,"House: Senate Amendments Concur",46,16,0,3,65
1965758,1546073,2025-04-11,House,"House: Senate Amendments Repass",46,16,0,3,65
1965761,1509023,2025-03-05,House,"House Business Affairs & Labor: Adopt amendment L.001",13,0,0,0,13
1965761,1509024,2025-03-10,House,"House: Third Reading Bill",46,15,0,4,65
1965761,1509602,2025-03-05,House,"House Business Affairs & Labor: Refer House Bill 25-1217, as amended, to the Committee of the Whole.",10,2,0,1,13
1965761,1528973,2025-03-27,Senate,"Senate Business, Labor, & Technology: Refer House Bill 25-1217 to the Committee of the Whole and with a recommendation that it be placed on the consent calendar.",6,0,0,1,7
1965761,1533196,2025-04-01,Senate,"Senate: Third Reading Bill",34,1,0,0,35
1965765,1516495,2025-03-12,House,"House Transportation, Housing & Local Government: Adopt amendment L.001 (Attachment G)",13,0,0,0,13
1965765,1518356,2025-03-17,House,"House: Third Reading Bill",58,5,0,2,65
1965765,1518969,2025-03-12,House,"House Transportation, Housing & Local Government: Adopt amendment L.004 (Attachment H)",13,0,0,0,13
1965765,1518970,2025-03-12,House,"House Transportation, Housing & Local Government: Refer House Bill 25-1230, as amended, to the Committee of the Whole.",11,0,0,2,13
1965765,1527586,2025-03-26,Senate,"Senate Transportation & Energy: Adopt amendment L.005",9,0,0,0,9
1965765,1530249,2025-03-26,Senate,"Senate Transportation & Energy: Refer House Bill 25-1230, as amended, to the Committee of the Whole and with a recommendation that it be placed on the consent calendar.",9,0,0,0,9
1965765,1533179,2025-04-01,Senate,"Senate: Third Reading Bill",34,1,0,0,35
1965765,1546199,2025-04-11,House,"House: Senate Amendments Concur",57,5,0,3,65
1965765,1546200,2025-04-11,House,"House: Senate Amendments Repass",54,8,0,3,65
1965769,1502208,2025-02-28,House,"House Appropriations: Postpone House Bill 25-1216 indefinitely.",10,0,0,1,11
1965772,1496119,2025-02-20,House,"House Business Affairs & Labor: Refer House Bill 25-1208 to the Committee on Finance.",11,2,0,0,13
1965772,1518077,2025-03-14,House,"House Finance: Adopt amendment L.018 (Attachment I).",11,2,0,0,13
1965772,1520882,2025-03-19,House,"House: Third Reading Bill",44,20,0,1,65
1965772,1521615,2025-03-14,House,"House Finance: Refer House Bill 25-1208, as amended, to the Committee of the Whole.",11,2,0,0,13
1965772,1544876,2025-04-10,Senate,"Senate Local Government & Housing: Refer House Bill 25-1208 to the Committee of the Whole.",5,2,0,0,7
1965772,1548670,2025-04-15,Senate,"Senate: Third Reading Bill",21,13,0,1,35
1965776,1504051,2025-03-03,House,"House Finance: Refer House Bill 25-1209, as amended, to the Committee on Appropriations.",9,4,0,0,13
1965776,1517840,2025-03-14,House,"House Appropriations: Adopt amendment J.001",11,0,0,0,11
1965776,1521189,2025-03-19,House,"House: Committee of the Whole Amd (h.001)",35,29,0,1,65
1965776,1522553,2025-03-20,House,"House: Third Reading Bill",45,18,0,2,65
1965776,1537352,2025-03-14,House,"House Appropriations: Refer House Bill 25-1209, as amended, to the Committee of the Whole.",7,4,0,0,11
1965776,1549361,2025-04-15,Senate,"Senate Finance: Adopt amendment L.018 (Attachment C)",9,0,0,0,9
1965776,1550033,2025-04-15,Senate,"Senate Finance: Adopt amendment L.019 (Attachment E)",9,0,0,0,9
1965776,1550034,2025-04-15,Senate,"Senate Finance: Adopt amendment L.021 (Attachment F)",9,0,0,0,9
1965776,1550035,2025-04-15,Senate,"Senate Finance: Adopt amendment L.022 (Attachment D)",9,0,0,0,9
1965776,1550036,2025-04-15,Senate,"Senate Finance: Adopt amendment L.023 (Attachment G)",9,0,0,0,9
1965776,1550037,2025-04-15,Senate,"Senate Finance: Adopt amendment L.024 (Amendment H)",9,0,0,0,9
1965776,1550038,2025-04-15,Senate,"Senate Finance: Refer House Bill 25-1209, as amended, to the Committee on Appropriations.",6,3,0,0,9
1965776,1553257,2025-04-22,Senate,"Senate Appropriations: Adopt amendment J.002",7,0,0,0,7
1965776,1553258,2025-04-22,Senate,"Senate Appropriations: Refer House Bill 25-1209, as amended, to the Committee of the Whole.",7,0,0,0,7
1965776,1558129,2025-04-25,Senate,"Senate: Third Reading Bill",25,10,0,0,35
1965776,1564719,2025-05-02,House,"House: Senate Amendments Not Cncr",41,20,0,4,65
1965776,1566732,2025-05-06,Joint,"CC_HB25-1209_2025A: Adopt the first report of the first conference committee (Attachment A).",4,1,0,1,6
1965776,1566733,2025-05-06,Senate,"Senate: Conference Committee Report Adopt Ccr",18,16,0,1,35
1965776,1566734,2025-05-06,Senate,"Senate: Conference Committee Report Repass",18,16,0,1,35
1965776,1568243,2025-05-07,House,"House: Conference Committee Report Adopt",43,22,0,0,65
1965776,1568244,2025-05-07,House,"House: Conference Committee Report Repass",42,23,0,0,65
1965779,1528213,2025-03-26,House,"House Judiciary: Refer House Bill 25-1214, as amended, to the Committee on Finance.",7,4,0,0,11
1965779,1539276,2025-04-07,House,"House Finance: Adopt amendment L.005 (Attachment W).",13,0,0,0,13
1965779,1547710,2025-04-07,House,"House Finance: Adopt amendment L.006 (Attachment Y).",13,0,0,0,13
1965779,1547711,2025-04-07,House,"House Finance: Refer House Bill 25-1214, as amended, to the Committee on Appropriations.",7,6,0,0,13
1965779,1550994,2025-04-17,House,"House Appropriations: Adopt amendment L.008",11,0,0,0,11
1965779,1554088,2025-04-17,House,"House Appropriations: Adopt amendment J.003",11,0,0,0,11
1965779,1554089,2025-04-17,House,"House Appropriations: Refer House Bill 25-1214, as amended, to the Committee of the Whole.",6,5,0,0,11
1965783,1499846,2025-02-26,House,"House Education: Adopt amendment L.001",13,0,0,0,13
1965783,1516940,2025-02-26,House,"House Education: Adopt amendment L.002",13,0,0,0,13
1965783,1516941,2025-02-26,House,"House Education: Adopt amendment L.003",13,0,0,0,13
1965783,1516942,2025-02-26,House,"House Education: Refer House Bill 25-1210, as amended, to the Committee on Appropriations.",12,0,0,1,13
1965783,1517934,2025-03-14,House,"House Appropriations: Refer House Bill 25-1210 to the Committee of the Whole.",11,0,0,0,11
1965783,1520880,2025-03-19,House,"House: Third Reading Bill",64,0,0,1,65
1965783,1538587,2025-04-07,Senate,"Senate Education: Refer House Bill 25-1210 to the Committee of the Whole and with a recommendation that it be placed on the consent calendar.",5,0,0,2,7
1965783,1543986,2025-04-10,Senate,"Senate: Third Reading Bill",33,0,0,2,35
1965787,1519430,2025-03-18,House,"House Judiciary: Postpone House Bill 25-1227 indefinitely.",8,0,0,3,11
1965790,1499470,2025-02-25,House,"House Transportation, Housing & Local Government: Adopt amendment L.001 (Attachment A)",13,0,0,0,13
1965790,1500562,2025-02-25,House,"House Transportation, Housing & Local Government: Refer House Bill 25-1228, as amended, to the Committee of the Whole.",11,0,0,2,13
1965790,1503111,2025-03-03,House,"House: Third Reading Bill",57,6,0,2,65
1965790,1542102,2025-04-09,Senate,"Senate Transportation & Energy: Refer House Bill 25-1228 to the Committee of the Whole.",8,1,0,0,9
1965790,1548518,2025-04-15,Senate,"Senate: Third Reading Bill",32,2,0,1,35
1965794,1516330,2025-03-12,House,"House Transportation, Housing & Local Government: Adopt amendment L.001 (Attachment I)",13,0,0,0,13
1965794,1518902,2025-03-12,House,"House Transportation, Housing & Local Government: Adopt amendment L.002 (Attachment J)",13,0,0,0,13
1965794,1518903,2025-03-12,House,"House Transportation, Housing & Local Government: Refer House Bill 25-1219, as amended, to the Committee of the Whole.",11,0,0,2,13
1965794,1520896,2025-03-19,House,"House: Third Reading Bill",53,11,0,1,65
1965794,1544143,2025-04-10,Senate,"Senate Local Government & Housing: Adopt amendment L.003 (Attachment M).",7,0,0,0,7
1965794,1545755,2025-04-10,Senate,"Senate Local Government & Housing: Refer House Bill 25-1219, as amended, to the Committee of the Whole.",6,1,0,0,7
1965794,1551415,2025-04-17,Senate,"Senate: Third Reading Bill",31,4,0,0,35
1965794,1555080,2025-04-23,House,"House: Senate Amendments Concur",62,2,0,1,65
1965794,1555081,2025-04-23,House,"House: Senate Amendments Repass",53,11,0,1,65
1965797,1500440,2025-02-26,House,"House Education: Refer House Bill 25-1221 to the Committee of the Whole.",13,0,0,0,13
1965797,1505027,2025-03-04,House,"House: Third Reading Bill",60,1,0,4,65
1965797,1527745,2025-03-26,Senate,"Senate Education: Refer House Bill 25-1221 to the Committee of the Whole and with a recommendation that it be placed on the consent calendar.",6,0,0,1,7
1965797,1532287,2025-04-01,Senate,"Senate: Third Reading Bill",35,0,0,0,35
1965801,1505032,2025-03-04,House,"House Health & Human Services: Adopt amendment L.001 (Attachment K).",13,0,0,0,13
1965801,1518666,2025-03-17,House,"House Finance: Adopt amendment L.004 (Attachment E).",13,0,0,0,13
1965801,1522467,2025-03-17,House,"House Finance: Refer House Bill 25-1223, as amended, to the Committee on Appropriations.",10,3,0,0,13
1965801,1526047,2025-03-04,House,"House Health & Human Services: Adopt amendment L.002 (Attachment L).",13,0,0,0,13
1965801,1526048,2025-03-04,House,"House Health & Human Services: Adopt amendment L.003 (Attachment M).",13,0,0,0,13
1965801,1526049,2025-03-04,House,"House Health & Human Services: Refer House Bill 25-1223, as amended, to the Committee on Finance.",11,1,0,1,13
1965801,1545724,2025-04-11,House,"House Appropriations: Refer House Bill 25-1223 to the Committee of the Whole.",10,1,0,0,11
1965801,1561713,2025-04-30,House,"House: Third Reading Bill",56,9,0,0,65
1965801,1564328,2025-05-01,Senate,"Senate Health & Human Services: Refer House Bill 25-1223 to the Committee on Appropriations.",9,0,0,0,9
1965801,1564648,2025-05-02,Senate,"Senate Appropriations: Refer House Bill 25-1223 to the Committee of the Whole and with a recommendation that it be placed on the consent calendar.",7,0,0,0,7
1965801,1564856,2025-05-05,Senate,"Senate: Third Reading Bill",34,1,0,0,35
1965805,1509694,2025-03-10,House,"House State, Civic, Military, & Veterans Affairs: Adopt amendment L.001 (Attachment A).",11,0,0,0,11
1965805,1524085,2025-03-10,House,"House State, Civic, Military, & Veterans Affairs: Postpone House Bill 25-1233 indefinitely using a reversal of the previous roll call. There was no objection to the use of the reverse roll call, therefore, the bill was postponed indefinitely.",6,4,0,1,11
1965805,1524086,2025-03-10,House,"House State, Civic, Military, & Veterans Affairs: Refer House Bill 25-1233, as amended, to the Committee of the Whole.",4,6,0,1,11
1965808,1498086,2025-02-24,House,"House State, Civic, Military, & Veterans Affairs: Postpone House Bill 25-1231 indefinitely.",10,0,0,1,11
1965812,1545759,2025-04-11,House,"House Appropriations: Adopt amendment L.002",11,0,0,0,11
1965812,1545760,2025-04-11,House,"House Appropriations: Refer House Bill 25-1215, as amended, to the Committee of the Whole.",8,3,0,0,11
1965812,1552644,2025-04-21,House,"House: Third Reading Bill",48,16,0,1,65
1965812,1559885,2025-04-29,Senate,"Senate Appropriations: Adopt amendment L.003",7,0,0,0,7
1965812,1559886,2025-04-29,Senate,"Senate Appropriations: Refer House Bill 25-1215, as amended, to the Committee of the Whole and with a recommendation that it be placed on the consent calendar.",6,0,0,1,7
1965812,1561824,2025-04-30,Senate,"Senate: Third Reading Bill",32,3,0,0,35
1965812,1563989,2025-05-01,House,"House: Senate Amendments Concur",51,14,0,0,65
1965812,1563990,2025-05-01,House,"House: Senate Amendments Repass",48,17,0,0,65
1965815,1505128,2025-03-04,House,"House Judiciary: Adopt amendment L.003",0,0,11,0,11
1965815,1527465,2025-03-04,House,"House Judiciary: Adopt amendment L.002",5,4,0,2,11
1965815,1527466,2025-03-04,House,"House Judiciary: Adopt amendment L.007",11,0,0,0,11
1965815,1527467,2025-03-04,House,"House Judiciary: Refer House Bill 25-1212, as amended, to the Committee of the Whole.",7,3,0,1,11
1965819,1519019,2025-03-17,House,"House State, Civic, Military, & Veterans Affairs: Adopt amendment L.001 (Attachment C).",7,3,0,1,11
1965819,1521566,2025-03-17,House,"House State, Civic, Military, & Veterans Affairs: Adopt amendment L.002 (Attachment D).",11,0,0,0,11
1965819,1521567,2025-03-17,House,"House State, Civic, Military, & Veterans Affairs: Refer House Bill 25-1225, as amended, to the Committee of the Whole.",8,3,0,0,11
1965819,1530190,2025-03-28,House,"House: Committee of the Whole Amd (h.001)",22,41,0,2,65
1965819,1532197,2025-04-01,House,"House: Third Reading Bill",37,25,0,3,65
1965819,1549349,2025-04-15,Senate,"Senate State, Veterans, & Military Affairs: Refer House Bill 25-1225 to the Committee of the Whole.",3,2,0,0,5
1965819,1558839,2025-04-28,Senate,"Senate: Third Reading Bill",22,12,0,1,35
1965819,1563888,2025-05-01,House,"House: Senate Amendments Concur",42,22,0,1,65
1965819,1563889,2025-05-01,House,"House: Senate Amendments Repass",41,24,0,0,65
1965823,1501690,2025-02-27,House,"House Education: Postpone House Bill 25-1218 indefinitely.",13,0,0,0,13
1965826,1507854,2025-03-06,House,"House State, Civic, Military, & Veterans Affairs: Adopt amendment L.001 (Attachment F).",11,0,0,0,11
1965826,1508808,2025-03-06,House,"House State, Civic, Military, & Veterans Affairs: Refer House Bill 25-1229, as amended, to the Committee of the Whole.",6,3,0,2,11
1965830,1506917,2025-03-05,House,"House Judiciary: Postpone House Bill 25-1232 indefinitely using a reversal of the previous roll call. There was no objection to the use of the reverse roll call, therefore, the bill was postponed indefinitely.",7,4,0,0,11
1965833,1499225,2025-02-25,House,"House Health & Human Services: Adopt amendment L.001 (Attachment H).",13,0,0,0,13
1965833,1502542,2025-02-28,House,"House: Third Reading Bill",49,11,0,5,65
1965833,1516494,2025-02-25,House,"House Health & Human Services: Refer House Bill 25-1226, as amended, to the Committee of the Whole.",8,4,0,1,13
1965833,1551650,2025-04-17,Senate,"Senate Health & Human Services: Refer House Bill 25-1226 to the Committee of the Whole.",6,1,0,2,9
1965837,1500783,2025-02-26,House,"House Health & Human Services: Adopt amendment L.003 (Attachment B).",13,0,0,0,13
1965837,1516428,2025-02-26,House,"House Health & Human Services: Adopt amendment L.005 (Attachment C).",13,0,0,0,13
1965837,1516429,2025-02-26,House,"House Health & Human Services: Refer House Bill 25-1220, as amended, to the Committee on Finance.",10,3,0,0,13
1965837,1519102,2025-03-17,House,"House Finance: Adopt amendment L.006 (Attachment F).",13,0,0,0,13
1965837,1523048,2025-03-17,House,"House Finance: Refer House Bill 25-1220, as amended, to the Committee on Appropriations.",10,3,0,0,13
1965837,1561698,2025-04-30,House,"House Appropriations: Adopt amendment J.002",11,0,0,0,11
1965837,1562279,2025-04-30,House,"House Appropriations: Adopt amendment L.007",11,0,0,0,11
1965837,1562280,2025-04-30,House,"House Appropriations: Refer House Bill 25-1220, as amended, to the Committee of the Whole.",9,1,0,1,11
1965837,1563464,2025-05-01,House,"House: Third Reading Bill",47,16,0,2,65
1965837,1564647,2025-05-02,Senate,"Senate Appropriations: Refer House Bill 25-1220 to the Committee of the Whole.",6,1,0,0,7
1965837,1565820,2025-05-06,Senate,"Senate: Third Reading Bill",32,3,0,0,35
1965837,1567601,2025-05-07,House,"House: Senate Amendments Concur",57,7,0,1,65
1965837,1567602,2025-05-07,House,"House: Senate Amendments Repass",48,16,0,1,65
1965840,1500373,2025-02-26,House,"House Transportation, Housing & Local Government: Adopt amendment L.001 (Attachment B)",13,0,0,0,13
1965840,1501738,2025-02-26,House,"House Transportation, Housing & Local Government: Adopt amendment L.002 (Attachment C)",13,0,0,0,13
1965840,1501739,2025-02-26,House,"House Transportation, Housing & Local Government: Refer House Bill 25-1211, as amended, to the Committee of the Whole.",9,4,0,0,13
1965840,1518367,2025-03-17,House,"House: Third Reading Bill",36,27,0,2,65
1965840,1541770,2025-04-09,Senate,"Senate Local Government & Housing: Adopt amendment L.008",6,1,0,0,7
1965840,1541771,2025-04-09,Senate,"Senate Local Government & Housing: Adopt amendment L.009",7,0,0,0,7
1965840,1541772,2025-04-09,Senate,"Senate Local Government & Housing: Adopt amendment L.012",7,0,0,0,7
1965840,1541773,2025-04-09,Senate,"Senate Local Government & Housing: Refer House Bill 25-1211, as amended, to the Committee of the Whole.",5,2,0,0,7
1965840,1546942,2025-04-14,Senate,"Senate: Third Reading Bill",27,6,0,2,35
1965840,1549387,2025-04-15,House,"House: Senate Amendments Concur",49,14,0,2,65
1965840,1549388,2025-04-15,House,"House: Senate Amendments Repass",44,20,0,1,65
1967588,1508019,2025-03-06,House,"House Energy & Environment: Adopt amendment L.008",13,0,0,0,13
1967588,1518984,2025-03-17,House,"House: Third Reading Bill",43,20,0,2,65
1967588,1522238,2025-03-06,House,"House Energy & Environment: Adopt amendment L.006",13,0,0,0,13
1967588,1522239,2025-03-06,House,"House Energy & Environment: Adopt amendment L.007",13,0,0,0,13
1967588,1522240,2025-03-06,House,"House Energy & Environment: Refer House Bill 25-1234, as amended, to the Committee of the Whole.",10,3,0,0,13
1967588,1527867,2025-03-26,Senate,"Senate Transportation & Energy: Adopt amendment L.013",9,0,0,0,9
1967588,1530150,2025-03-26,Senate,"Senate Transportation & Energy: Adopt amendment L.014",9,0,0,0,9
1967588,1530151,2025-03-26,Senate,"Senate Transportation & Energy: Refer House Bill 25-1234, as amended, to the Committee of the Whole.",6,3,0,0,9
1967588,1537220,2025-04-04,Senate,"Senate: Third Reading Bill",23,11,0,1,35
1967588,1545952,2025-04-11,House,"House: Senate Amendments Concur",41,21,0,3,65
1967588,1545953,2025-04-11,House,"House: Senate Amendments Repass",41,21,0,3,65
1967606,1505012,2025-03-04,House,"House Health & Human Services: Refer House Bill 25-1256 to the Committee of the Whole.",6,7,0,0,13
1967606,1526241,2025-03-04,House,"House Health & Human Services: Postpone House Bill 25-1256 indefinitely using a reversal of the previous roll call. There was no objection to the use of the reverse roll call, therefore, the bill was postponed indefinitely.",7,6,0,0,13
1967625,1508154,2025-03-06,House,"House Business Affairs & Labor: Adopt amendment L.002",13,0,0,0,13
1967625,1518905,2025-03-17,House,"House Finance: Refer House Bill 25-1245 to the Committee of the Whole.",13,0,0,0,13
1967625,1527498,2025-03-26,House,"House: Third Reading Bill",43,22,0,0,65
1967625,1551305,2025-04-17,Senate,"Senate Business, Labor, & Technology: Refer House Bill 25-1245 to the Committee of the Whole.",4,3,0,0,7
1967625,1554082,2025-03-06,House,"House Business Affairs & Labor: Adopt amendment L.001 as amended.",8,5,0,0,13
1967625,1554083,2025-03-06,House,"House Business Affairs & Labor: Refer House Bill 25-1245, as amended, to the Committee on Finance.",8,5,0,0,13
1967625,1555071,2025-04-23,Senate,"Senate: Third Reading Bill",23,12,0,0,35
1967638,1498360,2025-02-24,House,"House State, Civic, Military, & Veterans Affairs: Refer House Bill 25-1238 to the Committee of the Whole.",8,3,0,0,11
1967638,1508788,2025-03-07,House,"House: Committee of the Whole (h.001)",22,38,0,5,65
1967638,1508789,2025-03-07,House,"House: Committee of the Whole Amd (h.002)",20,40,0,5,65
1967638,1508790,2025-03-07,House,"House: Committee of the Whole Amd (h.003)",22,38,0,5,65
1967638,1517953,2025-03-14,House,"House: Third Reading Bill",34,30,0,1,65
1967638,1520169,2025-03-18,Senate,"Senate State, Veterans, & Military Affairs: Refer House Bill 25-1238 to the Committee of the Whole.",3,2,0,0,5
1967638,1525516,2025-03-24,Senate,"Senate: Committee of the Whole Cow * (s.001)",12,19,0,4,35
1967638,1525517,2025-03-24,Senate,"Senate: Committee of the Whole Cow * (s.002)",12,19,0,4,35
1967638,1525518,2025-03-24,Senate,"Senate: Committee of the Whole Cow * (s.003)",12,19,0,4,35
1967638,1525519,2025-03-24,Senate,"Senate: Committee of the Whole Cow * (s.004)",12,19,0,4,35
1967638,1525950,2025-03-25,Senate,"Senate: Third Reading Bill",22,13,0,0,35
1967638,1530218,2025-03-28,House,"House: Senate Amendments Concur",41,22,0,2,65
1967638,1530219,2025-03-28,House,"House: Senate Amendments Repass",35,28,0,2,65
1967658,1506874,2025-03-05,House,"House Business Affairs & Labor: Adopt amendment L.001",13,0,0,0,13
1967658,1511450,2025-03-05,House,"House Business Affairs & Labor: Adopt amendment L.002",13,0,0,0,13
1967658,1511451,2025-03-05,House,"House Business Affairs & Labor: Adopt amendment L.003",13,0,0,0,13
1967658,1511452,2025-03-05,House,"House Business Affairs & Labor: Refer House Bill 25-1240, as amended, to the Committee of the Whole.",7,0,0,6,13
1967658,1512590,2025-03-11,House,"House: Third Reading Bill",37,22,0,6,65
1967658,1533503,2025-04-01,Senate,"Senate Business, Labor, & Technology: Refer House Bill 25-1240 to the Committee of the Whole.",4,3,0,0,7
1967658,1539635,2025-04-08,Senate,"Senate: Third Reading Amend (l.011)",24,10,0,1,35
1967658,1539636,2025-04-08,Senate,"Senate: Third Reading Bill",22,12,0,1,35
1967658,1545976,2025-04-11,House,"House: Senate Amendments Concur",41,20,0,4,65
1967658,1545977,2025-04-11,House,"House: Senate Amendments Repass",39,22,0,4,65
1967676,1506864,2025-03-05,House,"House Judiciary: Refer House Bill 25-1235, as amended, to the Committee on Appropriations.",7,3,0,1,11
1967676,1557951,2025-04-25,House,"House Appropriations: Adopt amendment L.008",11,0,0,0,11
1967676,1559832,2025-04-25,House,"House Appropriations: Adopt amendment J.002",11,0,0,0,11
1967676,1559833,2025-04-25,House,"House Appropriations: Adopt amendment L.009",11,0,0,0,11
1967676,1559834,2025-04-25,House,"House Appropriations: Refer House Bill 25-1235, as amended, to the Committee of the Whole.",6,5,0,0,11
1967676,1561761,2025-04-30,House,"House: Third Reading Amd (l.010)",64,0,0,1,65
1967676,1561762,2025-04-30,House,"House: Third Reading Bill",33,32,0,0,65
1967676,1561763,2025-04-30,House,"House: Third Reading Perm",60,3,0,2,65
1967676,1564978,2025-05-05,Senate,"Senate Judiciary: Postpone House Bill 25-1235 indefinitely.",7,0,0,0,7
1967676,1567455,2025-05-05,Senate,"Senate Judiciary: Adopt amendment L.011 (Attachment A)",7,0,0,0,7
1967676,1567456,2025-05-05,Senate,"Senate Judiciary: Postpone House Bill 25-1235 indefinitely.",6,1,0,0,7
1967676,1567457,2025-05-05,Senate,"Senate Judiciary: Postpone House Bill 25-1235 indefinitely.",7,0,0,0,7
1967700,1529552,2025-03-27,House,"House Business Affairs & Labor: Adopt amendment L.002",13,0,0,0,13
1967700,1537102,2025-03-27,House,"House Business Affairs & Labor: Refer House Bill 25-1249, as amended, to the Committee of the Whole.",8,5,0,0,13
1967700,1537103,2025-03-27,House,"House Business Affairs & Labor: Refer House Bill 25-1249, as amended, to the Committee on Transportation, Housing &amp; Local Government.",6,7,0,0,13
1967700,1558985,2025-04-28,House,"House: Third Reading Bill",34,31,0,0,65
1967700,1563572,2025-05-01,Senate,"Senate Business, Labor, & Technology: Refer House Bill 25-1249, as amended, to the Committee of the Whole.",4,3,0,0,7
1967700,1565802,2025-05-06,Senate,"Senate: Third Reading Amend (l.035)",35,0,0,0,35
1967700,1565803,2025-05-06,Senate,"Senate: Third Reading Bill",19,16,0,0,35
1967700,1567102,2025-05-07,House,"House: Senate Amendments Concur",43,22,0,0,65
1967700,1567103,2025-05-07,House,"House: Senate Amendments Repass",34,31,0,0,65
1967713,1507633,2025-03-06,House,"House Agriculture, Water & Natural Resources: Adopt amendment L.001",9,4,0,0,13
1967713,1518387,2025-03-06,House,"House Agriculture, Water & Natural Resources: Postpone House Bill 25-1258 indefinitely using a reversal of the previous roll call. There was no objection to the use of the reverse roll call, therefore, the bill was postponed indefinitely.",10,3,0,0,13
1967713,1518388,2025-03-06,House,"House Agriculture, Water & Natural Resources: Refer House Bill 25-1258, as amended, to the Committee of the Whole.",3,10,0,0,13
1967737,1502435,2025-02-27,House,"House Education: Adopt amendment L.001",13,0,0,0,13
1967737,1517125,2025-02-27,House,"House Education: Adopt amendment L.002",13,0,0,0,13
1967737,1517126,2025-02-27,House,"House Education: Adopt amendment L.003",13,0,0,0,13
1967737,1517127,2025-02-27,House,"House Education: Refer House Bill 25-1248, as amended, to the Committee on Appropriations.",11,2,0,0,13
1967737,1526006,2025-03-25,House,"House Appropriations: Adopt amendment L.004",11,0,0,0,11
1967737,1531363,2025-03-31,House,"House: Third Reading Bill",43,21,0,1,65
1967737,1537283,2025-03-25,House,"House Appropriations: Refer House Bill 25-1248, as amended, to the Committee of the Whole.",7,3,0,1,11
1967737,1542173,2025-04-09,Senate,"Senate Education: Adopt amendment L.016",7,0,0,0,7
1967737,1544340,2025-04-09,Senate,"Senate Education: Refer House Bill 25-1248, as amended, to the Committee of the Whole.",5,2,0,0,7
1967737,1546930,2025-04-14,Senate,"Senate: Third Reading Bill",23,10,0,2,35
1967737,1549463,2025-04-15,House,"House: Senate Amendments Concur",43,21,0,1,65
1967737,1549464,2025-04-15,House,"House: Senate Amendments Repass",41,23,0,1,65
1967752,1505087,2025-03-04,House,"House Judiciary: Refer House Bill 25-1255 to the Committee on Finance.",4,7,0,0,11
1967752,1527332,2025-03-04,House,"House Judiciary: Postpone House Bill 25-1255 indefinitely using a reversal of the previous roll call. There was no objection to the use of the reverse roll call, therefore, the bill was postponed indefinitely.",7,4,0,0,11
1967773,1509746,2025-03-10,House,"House State, Civic, Military, & Veterans Affairs: Adopt amendment L.001 (Attachment E).",11,0,0,0,11
1967773,1524124,2025-03-10,House,"House State, Civic, Military, & Veterans Affairs: Adopt amendment L.002 (Attachment F).",11,0,0,0,11
1967773,1524125,2025-03-10,House,"House State, Civic, Military, & Veterans Affairs: Postpone House Bill 25-1242 indefinitely using a reversal of the previous roll call. There was no objection to the use of the reverse roll call, therefore, the bill was postponed indefinitely.",8,3,0,0,11
1967773,1524126,2025-03-10,House,"House State, Civic, Military, & Veterans Affairs: Refer House Bill 25-1242, as amended, to the Committee on Appropriations.",3,8,0,0,11
1967787,1503689,2025-03-03,House,"House State, Civic, Military, & Veterans Affairs: Refer House Bill 25-1246 to the Committee of the Whole.",5,6,0,0,11
1967787,1517455,2025-03-03,House,"House State, Civic, Military, & Veterans Affairs: Postpone House Bill 25-1246 indefinitely using a reversal of the previous roll call. There was no objection to the use of the reverse roll call, therefore, the bill was postponed indefinitely.",6,5,0,0,11
1967808,1507275,2025-03-05,House,"House Energy & Environment: Adopt amendment L.001 (Attachment G).",13,0,0,0,13
1967808,1521276,2025-03-05,House,"House Energy & Environment: Adopt amendment L.002 (Attachment H).",13,0,0,0,13
1967808,1521277,2025-03-05,House,"House Energy & Environment: Adopt amendment L.003",0,0,12,1,13
1967808,1521278,2025-03-05,House,"House Energy & Environment: Refer House Bill 25-1241, as amended, to the Committee on Appropriations.",9,4,0,0,13
1967830,1519591,2025-03-18,House,"House Health & Human Services: Adopt amendment L.001 (Attachment A).",13,0,0,0,13
1967830,1524995,2025-03-18,House,"House Health & Human Services: Adopt amendment L.008 (Attachment B).",13,0,0,0,13
1967830,1524996,2025-03-18,House,"House Health & Human Services: Adopt amendment L.009 (Attachment C).",13,0,0,0,13
1967830,1524997,2025-03-18,House,"House Health & Human Services: Adopt amendment L.010 (Attachment D).",13,0,0,0,13
1967830,1524998,2025-03-18,House,"House Health & Human Services: Refer House Bill 25-1259, as amended, to the Committee on Appropriations.",9,4,0,0,13
1967830,1548154,2025-04-15,House,"House Appropriations: Refer House Bill 25-1259 to the Committee of the Whole.",7,4,0,0,11
1967830,1552690,2025-04-21,House,"House: Third Reading Bill",40,23,0,2,65
1967830,1564142,2025-05-01,Senate,"Senate Health & Human Services: Refer House Bill 25-1259, as amended, to the Committee of the Whole.",6,3,0,0,9
1967830,1564644,2025-05-02,Senate,"Senate: Committee of the Whole Cow * (s.001)",22,13,0,0,35
1967830,1565866,2025-05-06,Senate,"Senate: Third Reading Bill",28,7,0,0,35
1967830,1567104,2025-05-07,House,"House: Senate Amendments Concur",42,22,0,1,65
1967830,1567105,2025-05-07,House,"House: Senate Amendments Repass",42,22,0,1,65
1967830,1567623,2025-05-01,Senate,"Senate Health & Human Services: Adopt amendment L.032 (Attachment H).",9,0,0,0,9
1967830,1567624,2025-05-01,Senate,"Senate Health & Human Services: Adopt amendment L.036 (Attachment I).",9,0,0,0,9
1967830,1567625,2025-05-01,Senate,"Senate Health & Human Services: Adopt amendment L.037 (Attachment J).",9,0,0,0,9
1967830,1567626,2025-05-01,Senate,"Senate Health & Human Services: Refer House Bill 25-1259, as amended, to the Committee of the Whole.",6,3,0,0,9
1967852,1507724,2025-03-06,House,"House Business Affairs & Labor: Postpone House Bill 25-1237 indefinitely.",13,0,0,0,13
1967864,1506896,2025-03-05,House,"House Health & Human Services: Refer House Bill 25-1251 to the Committee of the Whole.",4,9,0,0,13
1967864,1525241,2025-03-05,House,"House Health & Human Services: Postpone House Bill 25-1251 indefinitely.",9,4,0,0,13
1967885,1492802,2025-02-18,House,"House Judiciary: Refer House Bill 25-1254 to the Committee of the Whole.",4,7,0,0,11
1967885,1518999,2025-02-18,House,"House Judiciary: Postpone House Bill 25-1254 indefinitely using a reversal of the previous roll call. There was no objection to the use of the reverse roll call, therefore, the bill was postponed indefinitely.",7,4,0,0,11
1967900,1515070,2025-03-11,House,"House Health & Human Services: Refer House Bill 25-1252 to the Committee on Finance.",4,8,0,1,13
1967900,1528225,2025-03-11,House,"House Health & Human Services: Postpone House Bill 25-1252 indefinitely.",8,4,0,1,13
1967925,1534910,2025-04-02,House,"House Judiciary: Adopt amendment L.001 (Attachment B)",0,11,0,0,11
1967925,1552756,2025-04-02,House,"House Judiciary: Postpone House Bill 25-1243 indefinitely using a reversal of the previous roll call. There was no objection to the use of the reverse roll call, therefore, the bill was postponed indefinitely.",8,3,0,0,11
1967925,1552757,2025-04-02,House,"House Judiciary: Refer House Bill 25-1243 to the Committee of the Whole.",3,8,0,0,11
1967939,1516497,2025-03-12,House,"House Transportation, Housing & Local Government: Refer House Bill 25-1236 to the Committee of the Whole.",8,4,0,1,13
1967939,1527600,2025-03-26,House,"House: Third Reading Bill",36,29,0,0,65
1967939,1527601,2025-03-26,House,"House: Third Reading Rerefer (2nd)",22,43,0,0,65
1967939,1551612,2025-04-17,Senate,"Senate Local Government & Housing: Adopt amendment L.013",7,0,0,0,7
1967939,1552505,2025-04-17,Senate,"Senate Local Government & Housing: Refer House Bill 25-1236, as amended, to the Committee of the Whole.",4,2,0,1,7
1967939,1555218,2025-04-23,Senate,"Senate: Third Reading Bill",19,16,0,0,35
1967939,1555219,2025-04-23,Senate,"Senate: Third Reading Bill",20,15,0,0,35
1967939,1563936,2025-05-01,House,"House: Senate Amendments Concur",40,23,0,2,65
1967939,1563937,2025-05-01,House,"House: Senate Amendments Repass",35,28,0,2,65
1967962,1501064,2025-02-27,House,"House State, Civic, Military, & Veterans Affairs: Refer House Bill 25-1244 to the Committee of the Whole.",8,3,0,0,11
1967962,1530272,2025-03-28,House,"House: Committee of the Whole Amd (h.001)",23,40,0,2,65
1967962,1530273,2025-03-28,House,"House: Committee of the Whole Amd (h.002)",22,42,0,1,65
1967962,1531317,2025-03-31,House,"House: Third Reading Bill",41,23,0,1,65
1967962,1551654,2025-04-17,Senate,"Senate State, Veterans, & Military Affairs: Refer House Bill 25-1244 to the Committee of the Whole.",3,1,0,1,5
1967962,1555632,2025-04-23,Senate,"Senate: Third Reading Bill",23,12,0,0,35
1967980,1514932,2025-03-11,House,"House Health & Human Services: Refer House Bill 25-1253 to the Committee on Finance.",5,8,0,0,13
1967980,1525119,2025-03-11,House,"House Health & Human Services: Postpone House Bill 25-1253 indefinitely.",9,4,0,0,13
1967999,1506929,2025-03-05,House,"House Health & Human Services: Adopt amendment L.001 (Attachment D).",13,0,0,0,13
1967999,1527171,2025-03-05,House,"House Health & Human Services: Postpone House Bill 25-1257 indefinitely.",9,4,0,0,13
1967999,1527172,2025-03-05,House,"House Health & Human Services: Refer House Bill 25-1257, as amended, to the Committee of the Whole.",5,8,0,0,13
1968013,1505041,2025-03-04,House,"House Transportation, Housing & Local Government: Refer House Bill 25-1247 to the Committee of the Whole.",10,3,0,0,13
1968013,1509139,2025-03-10,House,"House: Third Reading Bill",42,20,0,3,65
1968013,1527672,2025-03-26,Senate,"Senate Local Government & Housing: Adopt amendment L.006",7,0,0,0,7
1968013,1528922,2025-03-26,Senate,"Senate Local Government & Housing: Refer House Bill 25-1247, as amended, to the Committee of the Whole.",5,1,0,1,7
1968013,1537207,2025-04-04,Senate,"Senate: Third Reading Bill",25,9,0,1,35
1968013,1545993,2025-04-11,House,"House: Senate Amendments Concur",44,18,0,3,65
1968013,1545994,2025-04-11,House,"House: Senate Amendments Repass",41,21,0,3,65
1968035,1499324,2025-02-25,House,"House Judiciary: Adopt amendment L.001 (Attachment F)",11,0,0,0,11
1968035,1525772,2025-03-25,House,"House Appropriations: Adopt amendment L.002",11,0,0,0,11
1968035,1526721,2025-02-25,House,"House Judiciary: Refer House Bill 25-1239, as amended, to the Committee on Appropriations.",7,4,0,0,11
1968035,1529307,2025-03-27,House,"House: Committee of the Whole Amd (h.001)",19,40,0,6,65
1968035,1529308,2025-03-27,House,"House: Committee of the Whole Amd (h.002)",28,31,0,6,65
1968035,1529309,2025-03-27,House,"House: Committee of the Whole Amd (h.003)",21,39,0,5,65
1968035,1529310,2025-03-27,House,"House: Committee of the Whole Amd (h.004)",20,40,0,5,65
1968035,1531318,2025-03-31,House,"House: Third Reading Amd (l.014)",42,22,0,1,65
1968035,1531319,2025-03-31,House,"House: Third Reading Bill",40,24,0,1,65
1968035,1531320,2025-03-31,House,"House: Third Reading Perm",41,22,0,2,65
1968035,1537266,2025-03-25,House,"House Appropriations: Adopt amendment J.002",11,0,0,0,11
1968035,1537267,2025-03-25,House,"House Appropriations: Refer House Bill 25-1239, as amended, to the Committee of the Whole.",7,3,0,1,11
1968035,1547386,2025-04-14,Senate,"Senate Judiciary: Adopt amendment L.015 (Attachment F)",7,0,0,0,7
1968035,1553313,2025-04-22,Senate,"Senate Appropriations: Refer House Bill 25-1239 to the Committee of the Whole.",4,3,0,0,7
1968035,1555117,2025-04-14,Senate,"Senate Judiciary: Refer House Bill 25-1239, as amended, to the Committee on Appropriations.",5,2,0,0,7
1968035,1557197,2025-04-24,Senate,"Senate: Committee of the Whole Cow * (s.002)",13,17,0,5,35
1968035,1558154,2025-04-25,Senate,"Senate: Third Reading Bill",23,12,0,0,35
1968035,1564030,2025-05-01,House,"House: Senate Amendments Concur",44,19,0,2,65
1968035,1564031,2025-05-01,House,"House: Senate Amendments Repass",40,23,0,2,65
1968049,1500220,2025-02-26,House,"House Transportation, Housing & Local Government: Refer House Bill 25-1196 to the Committee of the Whole.",4,9,0,0,13
1968049,1501623,2025-02-26,House,"House Transportation, Housing & Local Government: Postpone House Bill 25-1196 indefinitely using a reversal of the previous roll call. There was no objection to the use of the reverse roll call, therefore, the bill was postponed indefinitely.",9,4,0,0,13
1968063,1508412,2025-03-06,House,"House Education: Adopt amendment L.001",9,3,0,1,13
1968063,1520969,2025-03-19,House,"House: Third Reading Amd (l.003)",64,0,0,1,65
1968063,1520970,2025-03-19,House,"House: Third Reading Bill",43,21,0,1,65
1968063,1520971,2025-03-19,House,"House: Third Reading Perm",55,9,0,1,65
1968063,1522792,2025-03-06,House,"House Education: Refer House Bill 25-1250, as amended, to the Committee of the Whole.",7,5,0,1,13
1968063,1557869,2025-04-24,Senate,"Senate Health & Human Services: Refer House Bill 25-1250 to the Committee of the Whole.",6,3,0,0,9
1968063,1560158,2025-04-29,Senate,"Senate: Third Reading Amend (l.004)",15,17,0,3,35
1968063,1560159,2025-04-29,Senate,"Senate: Third Reading Bill",21,11,0,3,35
1968872,1506996,2025-03-05,House,"House Energy & Environment: Adopt amendment L.001 (Attachment D).",13,0,0,0,13
1968872,1521466,2025-03-05,House,"House Energy & Environment: Adopt amendment L.003 (Attachment E).",13,0,0,0,13
1968872,1521467,2025-03-05,House,"House Energy & Environment: Refer House Bill 25-1260, as amended, to the Committee on Finance.",10,2,0,1,13
1968872,1531360,2025-03-31,House,"House Finance: Adopt amendment L.005 (Attachment B).",13,0,0,0,13
1968872,1544501,2025-03-31,House,"House Finance: Refer House Bill 25-1260, as amended, to the Committee of the Whole.",8,5,0,0,13
1968872,1547628,2025-04-14,House,"House: Third Reading Bill",56,8,0,1,65
1968872,1555376,2025-04-23,Senate,"Senate Transportation & Energy: Refer House Bill 25-1260 to the Committee of the Whole.",1,7,0,1,9
1968872,1564778,2025-04-23,Senate,"Senate Transportation & Energy: Postpone House Bill 25-1260 indefinitely using a reversal of the previous roll call. There was no objection to the use of the reverse roll call, therefore, the bill was postponed indefinitely.",7,1,0,1,9
1970307,1504883,2025-03-04,House,"House Health & Human Services: Adopt amendment L.004 (Attachment I).",13,0,0,0,13
1970307,1526009,2025-03-04,House,"House Health & Human Services: Adopt amendment L.001 (Attachment H).",13,0,0,0,13
1970307,1526010,2025-03-04,House,"House Health & Human Services: Adopt amendment L.002 (Attachment J).",13,0,0,0,13
1970307,1526011,2025-03-04,House,"House Health & Human Services: Refer House Bill 25-1213, as amended, to the Committee on Appropriations.",12,0,0,1,13
1970307,1526012,2025-03-25,House,"House Appropriations: Adopt amendment L.005",11,0,0,0,11
1970307,1527475,2025-03-26,House,"House: Third Reading Bill",62,3,0,0,65
1970307,1537264,2025-03-25,House,"House Appropriations: Refer House Bill 25-1213, as amended, to the Committee of the Whole.",10,0,0,1,11
1970307,1557612,2025-04-24,Senate,"Senate Health & Human Services: Adopt amendment L.006 (Attachment F).",9,0,0,0,9
1970307,1562261,2025-04-30,Senate,"Senate: Third Reading Amend (l.013)",35,0,0,0,35
1970307,1562262,2025-04-30,Senate,"Senate: Third Reading Bill",35,0,0,0,35
1970307,1563915,2025-04-24,Senate,"Senate Health & Human Services: Adopt amendment L.008 (Attachment G).",9,0,0,0,9
1970307,1563916,2025-04-24,Senate,"Senate Health & Human Services: Refer House Bill 25-1213, as amended, to the Committee of the Whole.",9,0,0,0,9
1970307,1563917,2025-05-01,House,"House: Senate Amendments Concur",58,7,0,0,65
1970307,1563918,2025-05-01,House,"House: Senate Amendments Repass",58,7,0,0,65
1971542,1517310,2025-03-13,Senate,"Senate Health & Human Services: Adopt amendment L.001 (Attachment C).",9,0,0,0,9
1971542,1520779,2025-03-19,Senate,"Senate: Third Reading Bill",32,2,0,0,34
1971542,1529472,2025-03-13,Senate,"Senate Health & Human Services: Adopt amendment L.002 (Attachment D).",9,0,0,0,9
1971542,1529473,2025-03-13,Senate,"Senate Health & Human Services: Adopt amendment L.003 (Attachment E).",9,0,0,0,9
1971542,1529474,2025-03-13,Senate,"Senate Health & Human Services: Refer Senate Bill 25-164, as amended, to the Committee of the Whole.",8,0,0,1,9
1971542,1540246,2025-04-08,House,"House Health & Human Services: Refer Senate Bill 25-164 to the Committee of the Whole.",12,1,0,0,13
1971542,1548176,2025-04-15,House,"House: Third Reading Bill",61,1,0,3,65
1973883,1494134,2025-02-19,Senate,"Senate: Consideration of Resolutions Amend (l.001)",34,0,0,0,34
1973883,1494135,2025-02-19,Senate,"Senate: Consideration of Resolutions Resolution",22,12,0,0,34
1973900,1554664,2025-04-22,House,"House Judiciary: Postpone House Bill 25-1264 indefinitely.",7,4,0,0,11
1973908,1551199,2025-04-17,Senate,"Senate Business, Labor, & Technology: Refer Senate Bill 25-165, as amended, to the Committee on Appropriations.",7,0,0,0,7
1973908,1559944,2025-04-29,Senate,"Senate Appropriations: Refer Senate Bill 25-165 to the Committee of the Whole.",5,2,0,0,7
1973908,1561742,2025-04-30,Senate,"Senate: Third Reading Bill",35,0,0,0,35
1973908,1563884,2025-05-01,House,"House Finance: Adopt amendment L.007 (Attachment C).",13,0,0,0,13
1973908,1564652,2025-05-01,House,"House Finance: Refer Senate Bill 25-165, as amended, to the Committee on Appropriations.",11,0,0,2,13
1973908,1564839,2025-05-05,House,"House Appropriations: Refer Senate Bill 25-165 to the Committee of the Whole.",9,1,0,1,11
1973908,1567654,2025-05-07,House,"House: Third Reading Bill",59,6,0,0,65
1973908,1567655,2025-05-07,Senate,"Senate: House Amendments Concur",35,0,0,0,35
1973908,1567656,2025-05-07,Senate,"Senate: House Amendments Repass",35,0,0,0,35
1973923,1519806,2025-03-18,House,"House Transportation, Housing & Local Government: Postpone House Bill 25-1261 indefinitely.",13,0,0,0,13
1973935,1529702,2025-03-27,House,"House Business Affairs & Labor: Refer House Bill 25-1262 to the Committee on Finance.",8,5,0,0,13
1973935,1538294,2025-04-07,House,"House Finance: Postpone House Bill 25-1262 indefinitely.",13,0,0,0,13
1973952,1519880,2025-03-18,House,"House Transportation, Housing & Local Government: Adopt amendment L.002 (Attachment C)",13,0,0,0,13
1973952,1524622,2025-03-18,House,"House Transportation, Housing & Local Government: Adopt amendment L.001 (Attachment B)",13,0,0,0,13
1973952,1524623,2025-03-18,House,"House Transportation, Housing & Local Government: Adopt amendment L.003 (Attachment D)",13,0,0,0,13
1973952,1524624,2025-03-18,House,"House Transportation, Housing & Local Government: Adopt amendment L.004 (Attachment E)",13,0,0,0,13
1973952,1524625,2025-03-18,House,"House Transportation, Housing & Local Government: Adopt amendment L.005 (Attachment F)",13,0,0,0,13
1973952,1524626,2025-03-18,House,"House Transportation, Housing & Local Government: Adopt amendment L.006 (Attachment G)",13,0,0,0,13
1973952,1524627,2025-03-18,House,"House Transportation, Housing & Local Government: Adopt amendment L.007 (Attachment H)",13,0,0,0,13
1973952,1524628,2025-03-18,House,"House Transportation, Housing & Local Government: Refer House Bill 25-1272, as amended, to the Committee of the Whole.",12,1,0,0,13
1973952,1531335,2025-03-31,House,"House: Third Reading Bill",59,5,0,1,65
1973952,1544142,2025-04-10,Senate,"Senate Local Government & Housing: Adopt amendment L.037 (Attachment D).",7,0,0,0,7
1973952,1545703,2025-04-10,Senate,"Senate Local Government & Housing: Adopt amendment L.038 (Attachment E).",7,0,0,0,7
1973952,1545704,2025-04-10,Senate,"Senate Local Government & Housing: Adopt amendment L.039 (Attachment F).",7,0,0,0,7
1973952,1545705,2025-04-10,Senate,"Senate Local Government & Housing: Adopt amendment L.042 (Attachment G).",7,0,0,0,7
1973952,1545706,2025-04-10,Senate,"Senate Local Government & Housing: Adopt amendment L.044 (Attachment H).",7,0,0,0,7
1973952,1545707,2025-04-10,Senate,"Senate Local Government & Housing: Adopt amendment L.045 (Attachment I).",7,0,0,0,7
1973952,1545708,2025-04-10,Senate,"Senate Local Government & Housing: Adopt amendment L.046 (Attachment J).",7,0,0,0,7
1973952,1545709,2025-04-10,Senate,"Senate Local Government & Housing: Adopt amendment L.048 (Attachment K).",7,0,0,0,7
1973952,1545710,2025-04-10,Senate,"Senate Local Government & Housing: Adopt amendment L.049 (Attachment L).",7,0,0,0,7
1973952,1545711,2025-04-10,Senate,"Senate Local Government & Housing: Refer House Bill 25-1272, as amended, to the Committee of the Whole.",6,1,0,0,7
1973952,1551535,2025-04-17,Senate,"Senate: Third Reading Amend (l.052)",34,1,0,0,35
1973952,1551536,2025-04-17,Senate,"Senate: Third Reading Bill",32,3,0,0,35
1973952,1551537,2025-04-17,Senate,"Senate: Third Reading Bill",31,4,0,0,35
1973952,1555145,2025-04-23,House,"House: Senate Amendments Concur",59,5,0,1,65
1973952,1555146,2025-04-23,House,"House: Senate Amendments Repass",61,3,0,1,65
1973970,1523275,2025-03-20,House,"House Energy & Environment: Refer House Bill 25-1268, as amended, to the Committee on Finance.",8,4,0,1,13
1973970,1539080,2025-04-07,House,"House Finance: Adopt amendment L.004 (Attachment AA).",13,0,0,0,13
1973970,1547399,2025-04-07,House,"House Finance: Adopt amendment L.005 (Attachment BB), as amended.",13,0,0,0,13
1973970,1547400,2025-04-07,House,"House Finance: Adopt amendment L.006 (Attachment CC).",13,0,0,0,13
1973970,1547401,2025-04-07,House,"House Finance: Adopt amendment L.007 (Attachment DD).",13,0,0,0,13
1973970,1547402,2025-04-07,House,"House Finance: Adopt amendment L.008 (Attachment EE).",8,5,0,0,13
1973970,1547403,2025-04-07,House,"House Finance: Adopt amendment L.009 (Attachment FF), which amends L.005.",13,0,0,0,13
1973970,1547404,2025-04-07,House,"House Finance: Adopt amendment L.010 (Attachment GG).",13,0,0,0,13
1973970,1547405,2025-04-07,House,"House Finance: Adopt amendment L.011 (Attachment HH).",13,0,0,0,13
1973970,1547406,2025-04-07,House,"House Finance: Adopt amendment L.012 (Attachment II).",13,0,0,0,13
1973970,1547407,2025-04-07,House,"House Finance: Refer House Bill 25-1268, as amended, to the Committee on Appropriations.",7,6,0,0,13
1973970,1553494,2025-04-22,House,"House Appropriations: Adopt amendment L.013",11,0,0,0,11
1973970,1555508,2025-04-23,House,"House: Third Reading Bill",38,26,0,1,65
1973970,1559914,2025-04-22,House,"House Appropriations: Adopt amendment J.001",11,0,0,0,11
1973970,1559915,2025-04-22,House,"House Appropriations: Refer House Bill 25-1268, as amended, to the Committee of the Whole.",6,5,0,0,11
1973970,1560561,2025-04-29,Senate,"Senate Finance: Adopt amendment L.021 (Attachment G)",9,0,0,0,9
1973970,1565006,2025-04-29,Senate,"Senate Finance: Adopt amendment L.022 (Attachment H)",9,0,0,0,9
1973970,1565007,2025-04-29,Senate,"Senate Finance: Adopt amendment L.023 (Attachment I)",9,0,0,0,9
1973970,1565008,2025-04-29,Senate,"Senate Finance: Adopt amendment L.024 (Attachment J)",9,0,0,0,9
1973970,1565009,2025-04-29,Senate,"Senate Finance: Refer House Bill 25-1268, as amended, to the Committee on Appropriations.",5,4,0,0,9
1973970,1565010,2025-05-05,Senate,"Senate Appropriations: Postpone House Bill 25-1268 indefinitely using a reversal of the previous roll call. There was no objection to the use of the reverse roll call, therefore, the bill was postponed indefinitely.",5,2,0,0,7
1973970,1565011,2025-05-05,Senate,"Senate Appropriations: Refer House Bill 25-1268 to the Committee of the Whole.",2,5,0,0,7
1973982,1507256,2025-03-06,House,"House State, Civic, Military, & Veterans Affairs: Adopt amendment L.001 (Attachment C).",11,0,0,0,11
1973982,1508786,2025-03-06,House,"House State, Civic, Military, & Veterans Affairs: Refer House Bill 25-1266, as amended, to the Committee of the Whole.",10,0,0,1,11
1973982,1509120,2025-03-10,House,"House: Third Reading Bill",50,10,0,5,65
1973982,1560421,2025-04-29,Senate,"Senate State, Veterans, & Military Affairs: Postpone House Bill 25-1266 indefinitely.",3,0,0,2,5
1974000,1514819,2025-03-11,House,"House Health & Human Services: Postpone House Bill 25-1263 indefinitely.",13,0,0,0,13
1974012,1529227,2025-03-27,Senate,"Senate Health & Human Services: Adopt amendment L.002 (Attachment C).",9,0,0,0,9
1974012,1532363,2025-04-01,Senate,"Senate: Third Reading Bill",34,1,0,0,35
1974012,1540531,2025-04-08,House,"House Health & Human Services: Refer Senate Bill 25-166 to the Committee of the Whole.",13,0,0,0,13
1974012,1551038,2025-04-17,House,"House: Third Reading Bill",53,10,0,2,65
1974012,1551464,2025-03-27,Senate,"Senate Health & Human Services: Refer Senate Bill 25-166, as amended, to the Committee of the Whole.",9,0,0,0,9
1974029,1507787,2025-03-06,House,"House Energy & Environment: Adopt amendment L.001",13,0,0,0,13
1974029,1521604,2025-03-06,House,"House Energy & Environment: Refer House Bill 25-1269, as amended, to the Committee on Finance.",9,4,0,0,13
1974029,1529239,2025-03-27,House,"House Finance: Adopt amendment L.002",13,0,0,0,13
1974029,1544031,2025-03-27,House,"House Finance: Adopt amendment L.003",13,0,0,0,13
1974029,1544032,2025-03-27,House,"House Finance: Adopt amendment L.004",13,0,0,0,13
1974029,1544033,2025-03-27,House,"House Finance: Adopt amendment L.005",13,0,0,0,13
1974029,1544034,2025-03-27,House,"House Finance: Adopt amendment L.006",13,0,0,0,13
1974029,1544035,2025-03-27,House,"House Finance: Refer House Bill 25-1269, as amended, to the Committee on Appropriations.",7,6,0,0,13
1974029,1545670,2025-04-11,House,"House Appropriations: Adopt amendment J.001",11,0,0,0,11
1974029,1545671,2025-04-11,House,"House Appropriations: Adopt amendment L.008",11,0,0,0,11
1974029,1545672,2025-04-11,House,"House Appropriations: Refer House Bill 25-1269, as amended, to the Committee of the Whole.",6,5,0,0,11
1974029,1555672,2025-04-23,House,"House: Third Reading Amd (l.021)",41,23,0,1,65
1974029,1555673,2025-04-23,House,"House: Third Reading Bill",40,24,0,1,65
1974029,1555674,2025-04-23,House,"House: Third Reading Perm",42,21,0,2,65
1974029,1560912,2025-04-29,Senate,"Senate Finance: Adopt amendment L.022 (Attachment E)",9,0,0,0,9
1974029,1563476,2025-05-01,Senate,"Senate Appropriations: Refer House Bill 25-1269 to the Committee of the Whole.",4,3,0,0,7
1974029,1564860,2025-04-29,Senate,"Senate Finance: Refer House Bill 25-1269, as amended, to the Committee on Appropriations.",6,3,0,0,9
1974029,1566019,2025-05-06,Senate,"Senate: Third Reading Amend (l.029)",35,0,0,0,35
1974029,1566020,2025-05-06,Senate,"Senate: Third Reading Bill",24,11,0,0,35
1974029,1567095,2025-05-07,Senate,"Senate: Third Reading Amend (l.030)",35,0,0,0,35
1974029,1567096,2025-05-07,Senate,"Senate: Third Reading Bill",24,11,0,0,35
1974029,1567608,2025-05-07,House,"House: Senate Amendments Concur",41,21,0,3,65
1974029,1567609,2025-05-07,House,"House: Senate Amendments Repass",42,23,0,0,65
1974046,1533777,2025-04-01,Senate,"Senate Finance: Adopt amendment L.003 (Attachment D)",9,0,0,0,9
1974046,1537451,2025-04-01,Senate,"Senate Finance: Adopt amendment L.004 (Attachment E)",9,0,0,0,9
1974046,1537452,2025-04-01,Senate,"Senate Finance: Adopt amendment L.005 (Attachment F)",7,2,0,0,9
1974046,1537453,2025-04-01,Senate,"Senate Finance: Adopt amendment L.006 (Attachment G)",9,0,0,0,9
1974046,1537454,2025-04-01,Senate,"Senate Finance: Adopt amendment L.007 (Attachment H)",9,0,0,0,9
1974046,1537455,2025-04-01,Senate,"Senate Finance: Refer Senate Bill 25-167, as amended, to the Committee on Appropriations.",6,3,0,0,9
1974046,1546190,2025-04-11,Senate,"Senate Appropriations: Adopt amendment J.001",7,0,0,0,7
1974046,1546191,2025-04-11,Senate,"Senate Appropriations: Refer Senate Bill 25-167, as amended, to the Committee of the Whole.",6,1,0,0,7
1974046,1551317,2025-04-17,Senate,"Senate: Third Reading Bill",27,8,0,0,35
1974046,1557633,2025-04-24,House,"House Education: Refer Senate Bill 25-167 to the Committee on Appropriations.",12,1,0,0,13
1974046,1563356,2025-05-01,House,"House Appropriations: Refer Senate Bill 25-167 to the Committee of the Whole.",9,2,0,0,11
1974046,1564572,2025-05-02,House,"House: Third Reading Bill",45,19,0,1,65
1974046,1565379,2025-05-05,Senate,"Senate: House Amendments Concur",35,0,0,0,35
1974046,1565380,2025-05-05,Senate,"Senate: House Amendments Repass",24,11,0,0,35
1974058,1506699,2025-03-05,House,"House Health & Human Services: Refer House Bill 25-1270 to the Committee of the Whole.",12,0,0,1,13
1974058,1517963,2025-03-14,House,"House: Third Reading Bill",64,0,0,1,65
1974058,1544495,2025-04-10,Senate,"Senate Health & Human Services: Refer House Bill 25-1270 to the Committee of the Whole and with a recommendation that it be placed on the consent calendar.",9,0,0,0,9
1974058,1546936,2025-04-14,Senate,"Senate: Third Reading Bill",33,0,0,2,35
1974077,1507913,2025-03-06,House,"House Energy & Environment: Adopt amendment L.001",13,0,0,0,13
1974077,1522027,2025-03-06,House,"House Energy & Environment: Adopt amendment L.002",13,0,0,0,13
1974077,1522028,2025-03-06,House,"House Energy & Environment: Refer House Bill 25-1267, as amended, to the Committee on Appropriations.",8,3,0,2,13
1974077,1551160,2025-04-17,House,"House Appropriations: Adopt amendment J.001",11,0,0,0,11
1974077,1551644,2025-04-17,House,"House: Committee of the Whole Amd (h.001)",22,39,0,4,65
1974077,1552487,2025-04-21,House,"House: Third Reading Bill",40,23,0,2,65
1974077,1553468,2025-04-17,House,"House Appropriations: Refer House Bill 25-1267, as amended, to the Committee of the Whole.",8,3,0,0,11
1974077,1558936,2025-04-28,Senate,"Senate Transportation & Energy: Adopt amendment L.004",9,0,0,0,9
1974077,1560081,2025-04-28,Senate,"Senate Transportation & Energy: Refer House Bill 25-1267, as amended, to the Committee on Appropriations.",7,2,0,0,9
1974077,1561776,2025-04-30,Senate,"Senate Appropriations: Refer House Bill 25-1267 to the Committee of the Whole.",4,3,0,0,7
1974077,1566577,2025-05-06,Senate,"Senate: Third Reading Bill",23,12,0,0,35
1974077,1567170,2025-05-07,House,"House: Senate Amendments Concur",41,23,0,1,65
1974077,1567171,2025-05-07,House,"House: Senate Amendments Repass",41,23,0,1,65
1974089,1504086,2025-03-03,House,"House State, Civic, Military, & Veterans Affairs: Adopt amendment L.003 (Attachment G).",11,0,0,0,11
1974089,1517787,2025-03-03,House,"House State, Civic, Military, & Veterans Affairs: Adopt amendment L.003 (Attachment G), as amended.",8,3,0,0,11
1974089,1517788,2025-03-03,House,"House State, Civic, Military, & Veterans Affairs: Adopt amendment L.006 (Attachment H).",9,2,0,0,11
1974089,1517789,2025-03-03,House,"House State, Civic, Military, & Veterans Affairs: Postpone House Bill 25-1265 indefinitely using a reversal of the previous roll call. There was no objection to the use of the reverse roll call, therefore, the bill was postponed indefinitely.",6,5,0,0,11
1974089,1517790,2025-03-03,House,"House State, Civic, Military, & Veterans Affairs: Reconsider amendment L.003 (Attachment G).",10,1,0,0,11
1974089,1517791,2025-03-03,House,"House State, Civic, Military, & Veterans Affairs: Refer House Bill 25-1265, as amended, to the Committee of the Whole.",5,6,0,0,11
1974105,1521823,2025-03-19,House,"House Health & Human Services: Adopt amendment L.002 (Attachment D).",13,0,0,0,13
1974105,1525014,2025-03-19,House,"House Health & Human Services: Refer House Bill 25-1271, as amended, to the Committee on Appropriations.",10,3,0,0,13
1974105,1553478,2025-04-22,House,"House Appropriations: Adopt amendment J.001",11,0,0,0,11
1974105,1555504,2025-04-23,House,"House: Third Reading Bill",63,0,0,2,65
1974105,1559855,2025-04-22,House,"House Appropriations: Adopt amendment L.003",11,0,0,0,11
1974105,1559856,2025-04-22,House,"House Appropriations: Refer House Bill 25-1271, as amended, to the Committee of the Whole.",8,3,0,0,11
1974105,1562148,2025-04-30,Senate,"Senate Health & Human Services: Refer House Bill 25-1271, as amended, to the Committee on Appropriations.",9,0,0,0,9
1974105,1564469,2025-05-02,Senate,"Senate Appropriations: Adopt amendment J.002",7,0,0,0,7
1974105,1564470,2025-05-02,Senate,"Senate Appropriations: Refer House Bill 25-1271, as amended, to the Committee of the Whole.",5,2,0,0,7
1974105,1565835,2025-05-06,Senate,"Senate: Third Reading Bill",32,3,0,0,35
1974105,1567127,2025-05-07,House,"House: Senate Amendments Concur",62,3,0,0,65
1974105,1567128,2025-05-07,House,"House: Senate Amendments Repass",64,1,0,0,65
1975245,1506026,2025-03-05,Senate,"Senate Agriculture & Natural Resources: Adopt amendment L.001 (Attachment B).",7,0,0,0,7
1975245,1517534,2025-03-05,Senate,"Senate Agriculture & Natural Resources: Refer Senate Bill 25-169, as amended, to the Committee on Appropriations.",7,0,0,0,7
1975245,1548281,2025-04-15,Senate,"Senate Appropriations: Refer Senate Bill 25-169 to the Committee of the Whole and with a recommendation that it be placed on the consent calendar.",7,0,0,0,7
1975245,1552492,2025-04-21,Senate,"Senate: Third Reading Bill",34,1,0,0,35
1975245,1554837,2025-04-22,House,"House Health & Human Services: Refer Senate Bill 25-169 to the Committee on Appropriations.",10,3,0,0,13
1975245,1560142,2025-04-29,House,"House Appropriations: Refer Senate Bill 25-169 to the Committee of the Whole.",8,3,0,0,11
1975245,1561728,2025-04-30,House,"House: Third Reading Bill",44,21,0,0,65
1975379,1501425,2025-02-27,Senate,"Senate Appropriations: Refer Senate Bill 25-170 to the Committee of the Whole and with a recommendation that it be placed on the consent calendar.",6,0,0,1,7
1975379,1504156,2025-03-04,Senate,"Senate: Third Reading Bill",33,0,0,1,34
1975379,1508581,2025-03-07,House,"House Appropriations: Refer Senate Bill 25-170 to the Committee of the Whole.",11,0,0,0,11
1975379,1517471,2025-03-13,House,"House: Third Reading Bill",60,0,0,5,65
1975516,1507582,2025-03-06,Senate,"Senate Agriculture & Natural Resources: Adopt amendment L.001 (Attachment A).",7,0,0,0,7
1975516,1517251,2025-03-06,Senate,"Senate Agriculture & Natural Resources: Adopt amendment L.002 (Attachment B).",7,0,0,0,7
1975516,1517252,2025-03-06,Senate,"Senate Agriculture & Natural Resources: Refer Senate Bill 25-168, as amended, to the Committee on Appropriations.",7,0,0,0,7
1975516,1545628,2025-04-11,Senate,"Senate Appropriations: Refer Senate Bill 25-168 to the Committee of the Whole.",7,0,0,0,7
1975516,1546948,2025-04-14,Senate,"Senate: Third Reading Bill",31,2,0,2,35
1975516,1553095,2025-04-21,House,"House Agriculture, Water & Natural Resources: Refer Senate Bill 25-168 to the Committee on Appropriations.",11,1,0,1,13
1975516,1556411,2025-04-24,House,"House Appropriations: Refer Senate Bill 25-168 to the Committee of the Whole.",9,2,0,0,11
1975516,1557981,2025-04-25,House,"House: Third Reading Bill",53,10,0,2,65
1975656,1528464,2025-03-26,House,"House Judiciary: Refer House Bill 25-1275, as amended, to the Committee on Appropriations.",11,0,0,0,11
1975656,1548187,2025-04-15,House,"House Appropriations: Adopt amendment J.001",11,0,0,0,11
1975656,1550014,2025-04-16,House,"House: Third Reading Bill",65,0,0,0,65
1975656,1556314,2025-04-23,Senate,"Senate Judiciary: Refer House Bill 25-1275 to the Committee on Appropriations.",7,0,0,0,7
1975656,1560677,2025-04-15,House,"House Appropriations: Adopt amendment L.004",11,0,0,0,11
1975656,1560678,2025-04-15,House,"House Appropriations: Refer House Bill 25-1275, as amended, to the Committee of the Whole.",9,2,0,0,11
1975656,1560679,2025-04-29,Senate,"Senate Appropriations: Refer House Bill 25-1275 to the Committee of the Whole and with a recommendation that it be placed on the consent calendar.",6,0,0,1,7
1975656,1562139,2025-04-30,Senate,"Senate: Third Reading Bill",35,0,0,0,35
1975801,1507627,2025-03-06,House,"House Education: Adopt amendment L.001",13,0,0,0,13
1975801,1509713,2025-03-10,House,"House Finance: Adopt amendment L.003 (Attachment H).",13,0,0,0,13
1975801,1518516,2025-03-10,House,"House Finance: Adopt amendment L.004 (Attachment I).",13,0,0,0,13
1975801,1518517,2025-03-10,House,"House Finance: Refer House Bill 25-1274, as amended, to the Committee on Appropriations.",7,6,0,0,13
1975801,1522348,2025-03-06,House,"House Education: Refer House Bill 25-1274, as amended, to the Committee on Finance.",7,5,0,1,13
1975801,1545336,2025-04-11,House,"House Appropriations: Refer House Bill 25-1274 to the Committee of the Whole.",8,3,0,0,11
1975801,1552512,2025-04-21,House,"House: Third Reading Bill",40,22,0,3,65
1975801,1558218,2025-04-24,Senate,"Senate Finance: Refer House Bill 25-1274 to the Committee on Appropriations.",6,3,0,0,9
1975801,1561778,2025-04-30,Senate,"Senate Appropriations: Refer House Bill 25-1274 to the Committee of the Whole.",4,3,0,0,7
1975801,1566479,2025-05-06,Senate,"Senate: Third Reading Bill",24,11,0,0,35
1975801,1567141,2025-05-07,House,"House: Senate Amendments Concur",42,22,0,1,65
1975801,1567142,2025-05-07,House,"House: Senate Amendments Repass",42,22,0,1,65
1975952,1502597,2025-02-28,House,"House: RESOLUTIONS Res",57,0,0,8,65
1975952,1506224,2025-03-05,Senate,"Senate: Consideration of Resolutions Resolution",34,0,0,0,34
1976104,1520454,2025-03-18,House,"House Transportation, Housing & Local Government: Refer House Bill 25-1273, as amended, to the Committee of the Whole.",12,1,0,0,13
1977232,1515181,2025-03-11,Senate,"Senate State, Veterans, & Military Affairs: Refer Senate Bill 25-172 to the Committee of the Whole and with a recommendation that it be placed on the consent calendar.",3,0,0,2,5
1977232,1518350,2025-03-17,Senate,"Senate: Third Reading Bill",34,0,0,0,34
1977232,1531195,2025-03-31,House,"House State, Civic, Military, & Veterans Affairs: Refer Senate Bill 25-172 to the Committee of the Whole.",11,0,0,0,11
1977232,1536521,2025-04-03,House,"House: Third Reading Bill",65,0,0,0,65
1977319,1501316,2025-02-27,Senate,"Senate Agriculture & Natural Resources: Refer Senate Bill 25-174 to the Committee on Appropriations.",7,0,0,0,7
1977319,1527976,2025-03-26,Senate,"Senate Appropriations: Refer Senate Bill 25-174 to the Committee of the Whole.",7,0,0,0,7
1977319,1531306,2025-03-31,Senate,"Senate: Third Reading Bill",33,1,0,1,35
1977319,1536987,2025-04-03,House,"House Agriculture, Water & Natural Resources: Refer Senate Bill 25-174 to the Committee on Appropriations.",13,0,0,0,13
1977319,1548504,2025-04-15,House,"House Appropriations: Refer Senate Bill 25-174 to the Committee of the Whole.",8,3,0,0,11
1977319,1552645,2025-04-21,House,"House: Third Reading Bill",50,13,0,2,65
1977319,1554229,2025-04-22,Senate,"Senate: House Amendments Concur",35,0,0,0,35
1977319,1554230,2025-04-22,Senate,"Senate: House Amendments Repass",34,1,0,0,35
1977407,1498018,2025-02-24,Senate,"Senate: Consideration of Resolutions Amend (l.001)",31,0,0,3,34
1977407,1498019,2025-02-24,Senate,"Senate: Consideration of Resolutions Resolution",31,0,0,3,34
1977500,1516529,2025-03-12,Senate,"Senate Transportation & Energy: Adopt amendment L.001",9,0,0,0,9
1977500,1527588,2025-03-26,Senate,"Senate Appropriations: Refer Senate Bill 25-175 to the Committee of the Whole.",4,3,0,0,7
1977500,1530815,2025-03-31,Senate,"Senate: Third Reading Bill",23,11,0,1,35
1977500,1540701,2025-04-08,House,"House Transportation, Housing & Local Government: Refer Senate Bill 25-175 to the Committee on Appropriations.",8,3,0,2,13
1977500,1547598,2025-03-12,Senate,"Senate Transportation & Energy: Refer Senate Bill 25-175, as amended, to the Committee on Appropriations.",5,3,0,1,9
1977500,1553730,2025-04-22,House,"House Appropriations: Refer Senate Bill 25-175 to the Committee of the Whole.",7,4,0,0,11
1977500,1558328,2025-04-25,House,"House: Third Reading Bill",40,22,0,3,65
1977591,1503808,2025-03-03,Senate,"Senate Judiciary: Refer Senate Bill 25-171 to the Committee of the Whole and with a recommendation that it be placed on the consent calendar.",7,0,0,0,7
1977591,1508568,2025-03-07,Senate,"Senate: Third Reading Bill",31,0,0,3,34
1977591,1526797,2025-03-25,House,"House Judiciary: Refer Senate Bill 25-171 to the Committee of the Whole.",11,0,0,0,11
1977591,1532246,2025-04-01,House,"House: Third Reading Bill",63,0,0,2,65
1977681,1508567,2025-03-06,Senate,"Senate Finance: Refer Senate Bill 25-173 to the Committee on Appropriations.",6,3,0,0,9
1977681,1517854,2025-03-14,Senate,"Senate Appropriations: Refer Senate Bill 25-173 to the Committee of the Whole.",4,3,0,0,7
1977681,1520741,2025-03-19,Senate,"Senate: Third Reading Bill",22,12,0,0,34
1977681,1536975,2025-04-03,House,"House Finance: Refer Senate Bill 25-173 to the Committee on Appropriations.",8,5,0,0,13
1977681,1546161,2025-04-11,House,"House Appropriations: Adopt amendment L.002",11,0,0,0,11
1977681,1546162,2025-04-11,House,"House Appropriations: Refer Senate Bill 25-173, as amended, to the Committee of the Whole.",7,4,0,0,11
1977681,1559010,2025-04-28,House,"House: Third Reading Bill",40,24,0,1,65
1977681,1560637,2025-04-29,Senate,"Senate: House Amendments Concur",32,0,0,3,35
1977681,1560638,2025-04-29,Senate,"Senate: House Amendments Repass",20,12,0,3,35
1977768,1501778,2025-02-27,Senate,"Senate Agriculture & Natural Resources: Adopt amendment L.001 (Attachment A).",7,0,0,0,7
1977768,1513334,2025-02-27,Senate,"Senate Agriculture & Natural Resources: Adopt amendment L.002 (Attachment B).",7,0,0,0,7
1977768,1513335,2025-02-27,Senate,"Senate Agriculture & Natural Resources: Refer Senate Bill 25-176, as amended, to the Committee on Appropriations.",7,0,0,0,7
1977768,1527979,2025-03-26,Senate,"Senate Appropriations: Refer Senate Bill 25-176 to the Committee of the Whole and with a recommendation that it be placed on the consent calendar.",6,0,0,1,7
1977768,1530837,2025-03-31,Senate,"Senate: Third Reading Bill",33,1,0,1,35
1977768,1536308,2025-04-03,House,"House Agriculture, Water & Natural Resources: Refer Senate Bill 25-176 to the Committee on Appropriations.",13,0,0,0,13
1977768,1549089,2025-04-15,House,"House Appropriations: Refer Senate Bill 25-176 to the Committee of the Whole.",8,3,0,0,11
1977768,1562015,2025-04-30,House,"House: Third Reading Bill",59,6,0,0,65
1977832,1517140,2025-03-13,House,"House Finance: Refer House Bill 25-1282 to the Committee of the Whole.",9,3,0,1,13
1977832,1520872,2025-03-19,House,"House: Third Reading Bill",43,21,0,1,65
1977832,1559209,2025-04-28,Senate,"Senate Judiciary: Postpone House Bill 25-1282 indefinitely.",6,0,0,1,7
1977889,1540353,2025-04-08,House,"House Judiciary: Postpone House Bill 25-1276 indefinitely.",11,0,0,0,11
1977946,1508376,2025-03-06,House,"House Energy & Environment: Refer House Bill 25-1280 to the Committee of the Whole.",10,2,0,1,13
1977946,1517083,2025-03-13,House,"House: Third Reading Bill",41,19,0,5,65
1977946,1528443,2025-03-26,Senate,"Senate Transportation & Energy: Refer House Bill 25-1280 to the Committee of the Whole.",6,3,0,0,9
1977946,1536607,2025-04-03,Senate,"Senate: Committee of the Whole Cow * (s.001)",13,21,0,1,35
1977946,1536608,2025-04-03,Senate,"Senate: Committee of the Whole Cow * (s.002)",13,21,0,1,35
1977946,1537384,2025-04-04,Senate,"Senate: Third Reading Bill",23,11,0,1,35
1977999,1508354,2025-03-06,House,"House Energy & Environment: Adopt amendment L.004",13,0,0,0,13
1977999,1521644,2025-03-06,House,"House Energy & Environment: Adopt amendment L.001",13,0,0,0,13
1977999,1521645,2025-03-06,House,"House Energy & Environment: Adopt amendment L.002",13,0,0,0,13
1977999,1521646,2025-03-06,House,"House Energy & Environment: Adopt amendment L.003",13,0,0,0,13
1977999,1521647,2025-03-06,House,"House Energy & Environment: Adopt amendment L.005",13,0,0,0,13
1977999,1521648,2025-03-06,House,"House Energy & Environment: Refer House Bill 25-1277, as amended, to the Committee of the Whole.",7,6,0,0,13
1977999,1533189,2025-04-01,House,"House: Committee of the Whole Amd (h.001)",22,41,0,2,65
1977999,1533190,2025-04-01,House,"House: Committee of the Whole Amd (h.002)",21,42,0,2,65
1977999,1534099,2025-04-02,House,"House: Third Reading Bill",33,30,0,2,65
1977999,1555375,2025-04-23,Senate,"Senate Transportation & Energy: Postpone House Bill 25-1277 indefinitely.",7,0,0,2,9
1978057,1504888,2025-03-04,House,"House Health & Human Services: Adopt amendment L.001 (Attachment O).",13,0,0,0,13
1978057,1517849,2025-03-14,House,"House Appropriations: Adopt amendment L.005",11,0,0,0,11
1978057,1520888,2025-03-19,House,"House: Third Reading Bill",44,20,0,1,65
1978057,1526472,2025-03-04,House,"House Health & Human Services: Adopt amendment L.002 (Attachment P).",13,0,0,0,13
1978057,1526473,2025-03-04,House,"House Health & Human Services: Adopt amendment L.003 (Attachment Q).",13,0,0,0,13
1978057,1526474,2025-03-04,House,"House Health & Human Services: Adopt amendment L.004 (Attachment R).",13,0,0,0,13
1978057,1526475,2025-03-04,House,"House Health & Human Services: Refer House Bill 25-1279, as amended, to the Committee on Appropriations.",8,4,0,1,13
1978057,1537118,2025-03-14,House,"House Appropriations: Adopt amendment J.002",11,0,0,0,11
1978057,1537119,2025-03-14,House,"House Appropriations: Refer House Bill 25-1279, as amended, to the Committee of the Whole.",7,4,0,0,11
1978057,1549689,2025-04-16,Senate,"Senate Health & Human Services: Adopt amendment L.009 (Attachment B).",9,0,0,0,9
1978057,1553375,2025-04-22,Senate,"Senate Appropriations: Adopt amendment J.003",7,0,0,0,7
1978057,1553376,2025-04-22,Senate,"Senate Appropriations: Refer House Bill 25-1279, as amended, to the Committee of the Whole.",6,1,0,0,7
1978057,1557966,2025-04-25,Senate,"Senate: Third Reading Bill",26,9,0,0,35
1978057,1560477,2025-04-16,Senate,"Senate Health & Human Services: Refer House Bill 25-1279, as amended, to the Committee on Appropriations.",9,0,0,0,9
1978057,1563938,2025-05-01,House,"House: Senate Amendments Concur",42,21,0,2,65
1978057,1563939,2025-05-01,House,"House: Senate Amendments Repass",42,21,0,2,65
1978110,1528351,2025-03-26,House,"House Education: Refer House Bill 25-1278, as amended, to the Committee on Appropriations.",12,1,0,0,13
1978110,1557964,2025-04-25,House,"House Appropriations: Adopt amendment L.018",11,0,0,0,11
1978110,1559001,2025-04-28,House,"House: Third Reading Amd (l.022)",47,17,0,1,65
1978110,1559002,2025-04-28,House,"House: Third Reading Bill",51,13,0,1,65
1978110,1559003,2025-04-28,House,"House: Third Reading Perm",43,21,0,1,65
1978110,1560168,2025-04-25,House,"House Appropriations: Adopt amendment J.002",11,0,0,0,11
1978110,1560169,2025-04-25,House,"House Appropriations: Refer House Bill 25-1278, as amended, to the Committee of the Whole.",9,2,0,0,11
1978110,1562875,2025-04-30,Senate,"Senate Education: Refer House Bill 25-1278 to the Committee on Appropriations.",6,0,0,1,7
1978110,1564479,2025-05-02,Senate,"Senate Appropriations: Refer House Bill 25-1278 to the Committee of the Whole and with a recommendation that it be placed on the consent calendar.",7,0,0,0,7
1978110,1564835,2025-05-05,Senate,"Senate: Third Reading Bill",32,3,0,0,35
1978159,1516177,2025-03-12,House,"House Transportation, Housing & Local Government: Adopt amendment L.001 (Attachment B)",13,0,0,0,13
1978159,1519012,2025-03-12,House,"House Transportation, Housing & Local Government: Adopt amendment L.002 (Attachment C)",13,0,0,0,13
1978159,1519013,2025-03-12,House,"House Transportation, Housing & Local Government: Adopt amendment L.003 (Attachment D)",13,0,0,0,13
1978159,1519014,2025-03-12,House,"House Transportation, Housing & Local Government: Adopt amendment L.004 (Attachment E)",13,0,0,0,13
1978159,1519015,2025-03-12,House,"House Transportation, Housing & Local Government: Refer House Bill 25-1281, as amended, to the Committee on Finance.",10,0,0,3,13
1978159,1531410,2025-03-31,House,"House Finance: Adopt amendment L.006 (Attachment D).",13,0,0,0,13
1978159,1544188,2025-03-31,House,"House Finance: Refer House Bill 25-1281, as amended, to the Committee on Appropriations.",13,0,0,0,13
1978159,1545756,2025-04-11,House,"House Appropriations: Adopt amendment L.009",11,0,0,0,11
1978159,1545757,2025-04-11,House,"House Appropriations: Refer House Bill 25-1281, as amended, to the Committee of the Whole.",11,0,0,0,11
1978159,1547449,2025-04-14,House,"House: Third Reading Bill",64,0,0,1,65
1978159,1556225,2025-04-23,Senate,"Senate Transportation & Energy: Refer House Bill 25-1281 to the Committee on Appropriations.",8,0,0,1,9
1978159,1561736,2025-04-30,Senate,"Senate Appropriations: Refer House Bill 25-1281 to the Committee of the Whole and with a recommendation that it be placed on the consent calendar.",7,0,0,0,7
1978159,1563478,2025-05-01,Senate,"Senate: Third Reading Bill",35,0,0,0,35
1979532,1506681,2025-03-05,Senate,"Senate Education: Refer Senate Bill 25-177 to the Committee on Appropriations.",7,0,0,0,7
1979532,1527981,2025-03-26,Senate,"Senate Appropriations: Refer Senate Bill 25-177 to the Committee of the Whole and with a recommendation that it be placed on the consent calendar.",6,0,0,1,7
1979532,1530816,2025-03-31,Senate,"Senate: Third Reading Bill",32,2,0,1,35
1979532,1536579,2025-04-03,House,"House Education: Refer Senate Bill 25-177 to the Committee on Appropriations.",12,0,0,1,13
1979532,1549021,2025-04-15,House,"House Appropriations: Refer Senate Bill 25-177 to the Committee of the Whole.",8,3,0,0,11
1979532,1552765,2025-04-21,House,"House: Third Reading Bill",53,11,0,1,65
1979823,1516543,2025-03-12,Senate,"Senate Education: Refer Senate Bill 25-178 to the Committee of the Whole and with a recommendation that it be placed on the consent calendar.",6,0,0,1,7
1979823,1519352,2025-03-18,Senate,"Senate: Third Reading Bill",23,10,0,1,34
1979823,1534722,2025-04-02,House,"House Education: Refer Senate Bill 25-178 to the Committee of the Whole.",7,5,0,1,13
1979823,1544521,2025-04-03,House,"House Education: Reconsider",8,4,0,1,13
1979823,1544522,2025-04-03,House,"House Education: Refer Senate Bill 25-178 to the Committee on Appropriations.",8,4,0,1,13
1979823,1552774,2025-04-21,House,"House: Third Reading Bill",41,22,0,2,65
1981422,1501709,2025-02-27,Senate,"Senate Appropriations: Refer Senate Bill 25-180 to the Committee of the Whole and with a recommendation that it be placed on the consent calendar.",7,0,0,0,7
1981422,1504320,2025-03-04,Senate,"Senate: Third Reading Bill",33,0,0,1,34
1981422,1508585,2025-03-07,House,"House Appropriations: Refer Senate Bill 25-180 to the Committee of the Whole.",8,3,0,0,11
1981422,1518025,2025-03-14,House,"House: Third Reading Bill",51,13,0,1,65
1981710,1509192,2025-03-10,Senate,"Senate Judiciary: Refer Senate Bill 25-179 to the Committee on Appropriations.",4,2,0,1,7
1981710,1546165,2025-04-11,Senate,"Senate Appropriations: Adopt amendment J.002",7,0,0,0,7
1981710,1546166,2025-04-11,Senate,"Senate Appropriations: Adopt amendment L.002",7,0,0,0,7
1981710,1546167,2025-04-11,Senate,"Senate Appropriations: Refer Senate Bill 25-179, as amended, to the Committee of the Whole.",7,0,0,0,7
1981710,1551586,2025-04-17,Senate,"Senate: Third Reading Bill",26,9,0,0,35
1981710,1554969,2025-04-22,House,"House Judiciary: Refer Senate Bill 25-179 to the Committee on Appropriations.",7,4,0,0,11
1981710,1558251,2025-04-25,House,"House Appropriations: Refer Senate Bill 25-179 to the Committee of the Whole.",8,3,0,0,11
1981710,1559276,2025-04-28,House,"House: Third Reading Bill",42,22,0,1,65
1981791,1509563,2025-03-10,House,"House Agriculture, Water & Natural Resources: Adopt amendment L.002 (Attachment A)",13,0,0,0,13
1981791,1518760,2025-03-10,House,"House Agriculture, Water & Natural Resources: Adopt amendment L.003 (Attachment B)",13,0,0,0,13
1981791,1518761,2025-03-10,House,"House Agriculture, Water & Natural Resources: Adopt amendment L.004 (Attachment C)",13,0,0,0,13
1981791,1518762,2025-03-10,House,"House Agriculture, Water & Natural Resources: Adopt amendment L.005 (Attachment D)",13,0,0,0,13
1981791,1518763,2025-03-10,House,"House Agriculture, Water & Natural Resources: Adopt amendment L.006 (Attachment E)",13,0,0,0,13
1981791,1518764,2025-03-10,House,"House Agriculture, Water & Natural Resources: Refer House Bill 25-1285, as amended, to the Committee of the Whole.",11,1,0,1,13
1981791,1527560,2025-03-26,House,"House: Third Reading Bill",50,15,0,0,65
1981791,1535999,2025-04-03,Senate,"Senate Agriculture & Natural Resources: Refer House Bill 25-1285 to the Committee of the Whole.",7,0,0,0,7
1981791,1541358,2025-04-09,Senate,"Senate: Third Reading Bill",32,2,0,1,35
1981791,1545982,2025-04-11,House,"House: Senate Amendments Concur",50,11,0,4,65
1981791,1545983,2025-04-11,House,"House: Senate Amendments Repass",50,11,0,4,65
1981867,1529330,2025-03-27,House,"House Business Affairs & Labor: Postpone House Bill 25-1286 indefinitely.",12,0,0,1,13
1981941,1535207,2025-04-02,House,"House Business Affairs & Labor: Adopt amendment L.001",13,0,0,0,13
1981941,1545057,2025-04-02,House,"House Business Affairs & Labor: Refer House Bill 25-1284, as amended, to the Committee on Appropriations.",9,4,0,0,13
1981941,1551044,2025-04-17,House,"House Appropriations: Refer House Bill 25-1284 to the Committee of the Whole.",7,4,0,0,11
1981941,1552566,2025-04-21,House,"House: Third Reading Bill",41,21,0,3,65
1981941,1560316,2025-04-29,Senate,"Senate Business, Labor, & Technology: Refer House Bill 25-1284 to the Committee on Appropriations.",6,1,0,0,7
1981941,1564044,2025-05-01,Senate,"Senate Appropriations: Refer House Bill 25-1284 to the Committee of the Whole and with a recommendation that it be placed on the consent calendar.",7,0,0,0,7
1981941,1564494,2025-05-02,Senate,"Senate: Third Reading Bill",33,1,0,1,35
1982012,1517265,2025-03-13,House,"House Agriculture, Water & Natural Resources: Adopt amendment L.001 (Attachment B)",13,0,0,0,13
1982012,1520871,2025-03-19,House,"House: Third Reading Bill",56,8,0,1,65
1982012,1524025,2025-03-13,House,"House Agriculture, Water & Natural Resources: Adopt amendment L.002 (Attachment C)",13,0,0,0,13
1982012,1524026,2025-03-13,House,"House Agriculture, Water & Natural Resources: Refer House Bill 25-1283, as amended, to the Committee of the Whole.",13,0,0,0,13
1982012,1544256,2025-04-10,Senate,"Senate Agriculture & Natural Resources: Adopt amendment L.006 (Attachment A).",7,0,0,0,7
1982012,1547420,2025-04-10,Senate,"Senate Agriculture & Natural Resources: Refer House Bill 25-1283, as amended, to the Committee of the Whole.",5,2,0,0,7
1982012,1547421,2025-04-14,Senate,"Senate: Committee of the Whole Adopt Report",33,0,0,2,35
1982012,1552481,2025-04-21,Senate,"Senate: Third Reading Bill",29,6,0,0,35
1982012,1555163,2025-04-23,House,"House: Senate Amendments Concur",64,0,0,1,65
1982012,1555164,2025-04-23,House,"House: Senate Amendments Repass",60,4,0,1,65
1985509,1506427,2025-03-05,Senate,"Senate Judiciary: Adopt amendment L.001 (Attachment C)",5,2,0,0,7
1985509,1507268,2025-03-05,Senate,"Senate Judiciary: Refer Senate Bill 25-183, as amended, to the Committee on Appropriations.",5,2,0,0,7
1985509,1508608,2025-03-07,Senate,"Senate Appropriations: Adopt amendment J.001",4,3,0,0,7
1985509,1508809,2025-03-07,Senate,"Senate Appropriations: Refer Senate Bill 25-183, as amended, to the Committee of the Whole.",4,3,0,0,7
1985509,1513785,2025-03-11,Senate,"Senate: Committee of the Whole Cow * (s.001)",13,21,0,0,34
1985509,1515950,2025-03-12,Senate,"Senate: Third Reading Bill",22,12,0,0,34
1985509,1526517,2025-03-25,House,"House Health & Human Services: Refer Senate Bill 25-183 to the Committee on Appropriations.",9,4,0,0,13
1985509,1537006,2025-04-04,House,"House Appropriations: Refer Senate Bill 25-183 to the Committee of the Whole.",7,4,0,0,11
1985509,1537416,2025-04-04,House,"House: Committee of the Whole Amd (h.002)",19,38,0,8,65
1985509,1537417,2025-04-04,House,"House: Committee of the Whole Amd (h.003)",19,38,0,8,65
1985509,1537418,2025-04-04,House,"House: Committee of the Whole Amd (h.004)",19,38,0,8,65
1985509,1537893,2025-04-06,House,"House: Third Reading Bill",40,21,0,4,65
1985509,1537894,2025-04-06,House,"House: Third Reading Lo",20,39,0,6,65
1985509,1537895,2025-04-06,House,"House: Third Reading Prev ?",38,21,0,6,65
1985562,1503651,2025-03-03,Senate,"Senate: Consideration of Resolutions Resolution",34,0,0,0,34
1985562,1535623,2025-04-03,House,"House: RESOLUTIONS Res",64,0,0,1,65
1985615,1534811,2025-04-02,House,"House Health & Human Services: Adopt amendment L.004 (Attachment D).",13,0,0,0,13
1985615,1555189,2025-04-02,House,"House Health & Human Services: Adopt amendment L.002 (Attachment C).",13,0,0,0,13
1985615,1555190,2025-04-02,House,"House Health & Human Services: Adopt amendment L.005 (Attachment E).",13,0,0,0,13
1985615,1555191,2025-04-02,House,"House Health & Human Services: Refer House Bill 25-1287, as amended, to the Committee on Appropriations.",9,4,0,0,13
1985670,1522584,2025-03-20,Senate,"Senate Business, Labor, & Technology: Adopt amendment L.002",7,0,0,0,7
1985670,1537742,2025-03-20,Senate,"Senate Business, Labor, & Technology: Refer Senate Bill 25-181, as amended, to the Committee on Appropriations.",6,1,0,0,7
1985670,1546192,2025-04-11,Senate,"Senate Appropriations: Refer Senate Bill 25-181 to the Committee of the Whole.",4,3,0,0,7
1985670,1551607,2025-04-17,Senate,"Senate: Third Reading Bill",26,9,0,0,35
1985670,1557656,2025-04-24,House,"House Business Affairs & Labor: Refer Senate Bill 25-181 to the Committee on Appropriations.",9,4,0,0,13
1985670,1560671,2025-04-29,House,"House Appropriations: Refer Senate Bill 25-181 to the Committee of the Whole.",8,2,0,1,11
1985670,1562578,2025-04-30,House,"House: Third Reading Bill",47,18,0,0,65
1985721,1516073,2025-03-12,Senate,"Senate Transportation & Energy: Refer Senate Bill 25-182, as amended, to the Committee on Appropriations.",8,0,0,1,9
1985721,1518953,2025-03-12,Senate,"Senate Transportation & Energy: Adopt amendment L.003",9,0,0,0,9
1985721,1545652,2025-04-11,Senate,"Senate Appropriations: Refer Senate Bill 25-182 to the Committee of the Whole.",5,2,0,0,7
1985721,1547500,2025-03-12,Senate,"Senate Transportation & Energy: Postpone Senate Bill 25-182 indefinitely.",8,0,0,1,9
1985721,1547501,2025-03-12,Senate,"Senate Transportation & Energy: Reconsider",7,1,0,1,9
1985721,1547502,2025-03-12,Senate,"Senate Transportation & Energy: Refer Senate Bill 25-182, as amended, to the Committee on Appropriations.",8,0,0,1,9
1985721,1551453,2025-04-17,Senate,"Senate: Third Reading Bill",33,2,0,0,35
1985721,1554019,2025-04-22,House,"House Transportation, Housing & Local Government: Refer Senate Bill 25-182 to the Committee of the Whole.",11,2,0,0,13
1985721,1558188,2025-04-25,House,"House: Third Reading Bill",45,18,0,2,65
1987615,1521696,2025-03-19,House,"House Health & Human Services: Adopt amendment L.003 (Attachment A).",13,0,0,0,13
1987615,1525230,2025-03-19,House,"House Health & Human Services: Refer House Bill 25-1288, as amended, to the Committee of the Whole.",12,0,0,1,13
1987615,1562530,2025-04-30,House,"House: Third Reading Bill",58,7,0,0,65
1987615,1564018,2025-05-01,Senate,"Senate Health & Human Services: Refer House Bill 25-1288 to the Committee of the Whole and with a recommendation that it be placed on the consent calendar.",9,0,0,0,9
1987615,1565134,2025-05-05,Senate,"Senate: Third Reading Bill",34,1,0,0,35
1987684,1518491,2025-03-17,Senate,"Senate Judiciary: Adopt amendment L.002 (Attachment A)",7,0,0,0,7
1987684,1524524,2025-03-21,Senate,"Senate: Third Reading Bill",23,11,0,1,35
1987684,1547195,2025-03-17,Senate,"Senate Judiciary: Refer Senate Bill 25-185, as amended, to the Committee of the Whole.",4,3,0,0,7
1987684,1554646,2025-04-22,House,"House Judiciary: Refer Senate Bill 25-185 to the Committee of the Whole.",7,4,0,0,11
1987756,1508102,2025-03-06,Senate,"Senate Local Government & Housing: Refer Senate Bill 25-184 to the Committee on Appropriations.",4,2,0,1,7
1987756,1527534,2025-03-26,Senate,"Senate Appropriations: Refer Senate Bill 25-184 to the Committee of the Whole.",4,2,0,1,7
1987756,1530809,2025-03-31,Senate,"Senate: Third Reading Bill",23,11,0,1,35
1987756,1539855,2025-04-08,House,"House Transportation, Housing & Local Government: Adopt amendment L.002 (Attachment B)",13,0,0,0,13
1987756,1544017,2025-04-08,House,"House Transportation, Housing & Local Government: Refer Senate Bill 25-184, as amended, to the Committee on Appropriations.",11,0,0,2,13
1987756,1553578,2025-04-22,House,"House Appropriations: Refer Senate Bill 25-184 to the Committee of the Whole.",7,4,0,0,11
1987756,1558268,2025-04-25,House,"House: Third Reading Bill",40,22,0,3,65
1987756,1559259,2025-04-28,Senate,"Senate: House Amendments Concur",33,0,0,2,35
1987756,1559260,2025-04-28,Senate,"Senate: House Amendments Repass",22,11,0,2,35
1989007,1523412,2025-03-20,Senate,"Senate Business, Labor, & Technology: Refer Senate Bill 25-186 to the Committee on Appropriations.",6,1,0,0,7
1989007,1546159,2025-04-11,Senate,"Senate Appropriations: Adopt amendment J.001",4,3,0,0,7
1989007,1546160,2025-04-11,Senate,"Senate Appropriations: Refer Senate Bill 25-186, as amended, to the Committee of the Whole.",4,3,0,0,7
1989007,1551604,2025-04-17,Senate,"Senate: Third Reading Amend (l.001)",35,0,0,0,35
1989007,1551605,2025-04-17,Senate,"Senate: Third Reading Bill",23,12,0,0,35
1989007,1557409,2025-04-24,House,"House Business Affairs & Labor: Refer Senate Bill 25-186, as amended, to the Committee on Finance.",8,4,0,1,13
1989007,1561250,2025-04-29,House,"House Finance: Refer Senate Bill 25-186 to the Committee on Appropriations.",8,5,0,0,13
1989007,1563563,2025-05-01,House,"House Appropriations: Refer Senate Bill 25-186 to the Committee of the Whole.",8,3,0,0,11
1989007,1564615,2025-05-02,House,"House: Third Reading Bill",43,21,0,1,65
1989007,1566638,2025-05-06,Senate,"Senate: House Amendments Concur",35,0,0,0,35
1989007,1566639,2025-05-06,Senate,"Senate: House Amendments Repass",23,12,0,0,35
1989013,1536840,2025-04-03,House,"House Business Affairs & Labor: Adopt amendment L.002",13,0,0,0,13
1989013,1543949,2025-04-03,House,"House Business Affairs & Labor: Adopt amendment L.001 as amended",13,0,0,0,13
1989013,1543950,2025-04-03,House,"House Business Affairs & Labor: Adopt amendment L.004",13,0,0,0,13
1989013,1543951,2025-04-03,House,"House Business Affairs & Labor: Adopt amendment L.005",13,0,0,0,13
1989013,1543952,2025-04-03,House,"House Business Affairs & Labor: Adopt amendment L.006",13,0,0,0,13
1989013,1543953,2025-04-03,House,"House Business Affairs & Labor: Refer House Bill 25-1291, as amended, to the Committee of the Whole.",11,2,0,0,13
1989013,1549848,2025-04-16,House,"House: Third Reading Bill",59,6,0,0,65
1989013,1554048,2025-04-22,Senate,"Senate Business, Labor, & Technology: Refer House Bill 25-1291, as amended, to the Committee of the Whole.",4,3,0,0,7
1989013,1565816,2025-05-06,Senate,"Senate: Committee of the Whole Adopt Report",33,2,0,0,35
1989013,1567157,2025-05-07,House,"House: Senate Amendments Concur",64,0,0,1,65
1989013,1567158,2025-05-07,House,"House: Senate Amendments Repass",58,6,0,1,65
1989013,1567159,2025-05-07,Senate,"Senate: Third Reading Amend (l.069)",35,0,0,0,35
1989013,1567160,2025-05-07,Senate,"Senate: Third Reading Bill",22,13,0,0,35
1989090,1523368,2025-03-20,House,"House Finance: Adopt amendment L.001 (Attachment D).",13,0,0,0,13
1989090,1528023,2025-03-26,House,"House: Third Reading Bill",65,0,0,0,65
1989090,1543709,2025-03-20,House,"House Finance: Refer House Bill 25-1289, as amended, to the Committee of the Whole.",13,0,0,0,13
1989090,1549197,2025-04-15,Senate,"Senate Finance: Refer House Bill 25-1289 to the Committee of the Whole and with a recommendation that it be placed on the consent calendar.",8,0,0,1,9
1989090,1553409,2025-04-22,Senate,"Senate: Third Reading Bill",35,0,0,0,35
1989172,1521627,2025-03-19,House,"House Transportation, Housing & Local Government: Adopt amendment L.001 (Attachment A)",13,0,0,0,13
1989172,1524209,2025-03-19,House,"House Transportation, Housing & Local Government: Adopt amendment L.002 (Attachment B)",13,0,0,0,13
1989172,1524210,2025-03-19,House,"House Transportation, Housing & Local Government: Adopt amendment L.004 (Attachment C)",13,0,0,0,13
1989172,1524211,2025-03-19,House,"House Transportation, Housing & Local Government: Refer House Bill 25-1290, as amended, to the Committee of the Whole.",11,0,0,2,13
1989172,1526146,2025-03-25,House,"House: Third Reading Bill",37,24,0,4,65
1989172,1547487,2025-04-14,Senate,"Senate Judiciary: Adopt amendment L.008 (Attachment A)",7,0,0,0,7
1989172,1554110,2025-04-22,Senate,"Senate: Third Reading Amend (l.009)",35,0,0,0,35
1989172,1554111,2025-04-22,Senate,"Senate: Third Reading Bill",30,5,0,0,35
1989172,1555589,2025-04-14,Senate,"Senate Judiciary: Refer House Bill 25-1290, as amended, to the Committee of the Whole and with a recommendation that it be placed on the consent calendar.",7,0,0,0,7
1989172,1555590,2025-04-23,House,"House: Senate Amendments Concur",42,22,0,1,65
1989172,1555591,2025-04-23,House,"House: Senate Amendments Repass",37,27,0,1,65
1989598,1527920,2025-03-26,Senate,"Senate Judiciary: Adopt amendment L.001 (Attachment A)",7,0,0,0,7
1989598,1529840,2025-03-26,Senate,"Senate Judiciary: Adopt amendment L.002 (Attachment B)",7,0,0,0,7
1989598,1529841,2025-03-26,Senate,"Senate Judiciary: Refer Senate Bill 25-189, as amended, to the Committee on Appropriations.",6,1,0,0,7
1989598,1545690,2025-04-11,Senate,"Senate Appropriations: Adopt amendment J.001",7,0,0,0,7
1989598,1545691,2025-04-11,Senate,"Senate Appropriations: Refer Senate Bill 25-189, as amended, to the Committee of the Whole.",6,1,0,0,7
1989598,1551468,2025-04-17,Senate,"Senate: Third Reading Bill",32,3,0,0,35
1989598,1562674,2025-04-30,House,"House Judiciary: Refer Senate Bill 25-189 to the Committee on Appropriations.",11,0,0,0,11
1989598,1564764,2025-05-03,House,"House Appropriations: Refer Senate Bill 25-189 to the Committee of the Whole.",9,2,0,0,11
1989598,1565122,2025-05-05,House,"House: Third Reading Bill",64,0,0,1,65
1989762,1523416,2025-03-19,Senate,"Senate Transportation & Energy: Refer Senate Bill 25-187 to the Committee on Appropriations.",9,0,0,0,9
1989762,1546182,2025-04-11,Senate,"Senate Appropriations: Refer Senate Bill 25-187 to the Committee of the Whole and with a recommendation that it be placed on the consent calendar.",7,0,0,0,7
1989762,1547617,2025-04-14,Senate,"Senate: Third Reading Bill",31,2,0,2,35
1989762,1554064,2025-04-22,House,"House Transportation, Housing & Local Government: Adopt amendment L.004 (Attachment A)",13,0,0,0,13
1989762,1555584,2025-04-22,House,"House Transportation, Housing & Local Government: Adopt amendment L.005 (Attachment B)",13,0,0,0,13
1989762,1555585,2025-04-22,House,"House Transportation, Housing & Local Government: Adopt amendment L.006 (Attachment C)",13,0,0,0,13
1989762,1555586,2025-04-22,House,"House Transportation, Housing & Local Government: Refer Senate Bill 25-187, as amended, to the Committee on Appropriations.",13,0,0,0,13
1989762,1559822,2025-04-29,House,"House Appropriations: Refer Senate Bill 25-187 to the Committee of the Whole.",8,3,0,0,11
1989762,1562477,2025-04-30,House,"House: Third Reading Bill",57,8,0,0,65
1989762,1564423,2025-05-01,Senate,"Senate: House Amendments Concur",32,0,0,3,35
1989762,1564424,2025-05-01,Senate,"Senate: House Amendments Repass",30,2,0,3,35
1989928,1508579,2025-03-07,Senate,"Senate Appropriations: Adopt amendment L.004",7,0,0,0,7
1989928,1508802,2025-03-07,Senate,"Senate Appropriations: Adopt amendment L.001",3,4,0,0,7
1989928,1508803,2025-03-07,Senate,"Senate Appropriations: Adopt amendment L.003",3,4,0,0,7
1989928,1508804,2025-03-07,Senate,"Senate Appropriations: Refer Senate Bill 25-188, as amended, to the Committee of the Whole.",4,3,0,0,7
1989928,1514933,2025-03-11,Senate,"Senate: Committee of the Whole Cow * (s.001)",15,19,0,0,34
1989928,1514934,2025-03-11,Senate,"Senate: Committee of the Whole Cow * (s.002)",14,20,0,0,34
1989928,1516076,2025-03-12,Senate,"Senate: Third Reading Bill",18,16,0,0,34
1989928,1520162,2025-03-18,House,"House Appropriations: Adopt amendment L.012",11,0,0,0,11
1989928,1520163,2025-03-18,House,"House Appropriations: Refer Senate Bill 25-188, as amended, to the Committee of the Whole.",8,3,0,0,11
1989928,1527998,2025-03-26,House,"House: Third Reading Bill",42,23,0,0,65
1989928,1530289,2025-03-28,Senate,"Senate: House Amendments Concur",34,0,0,1,35
1989928,1530290,2025-03-28,Senate,"Senate: House Amendments Repass",18,16,0,1,35
1990300,1526799,2025-03-25,House,"House Transportation, Housing & Local Government: Adopt amendment L.001 (Attachment I)",13,0,0,0,13
1990300,1529958,2025-03-25,House,"House Transportation, Housing & Local Government: Adopt amendment L.002 (Attachment J)",13,0,0,0,13
1990300,1529959,2025-03-25,House,"House Transportation, Housing & Local Government: Refer House Bill 25-1292, as amended, to the Committee on Finance.",11,2,0,0,13
1990300,1539149,2025-04-07,House,"House Finance: Adopt amendment L.005 (Attachment N).",13,0,0,0,13
1990300,1547567,2025-04-07,House,"House Finance: Adopt amendment L.007 (Attachment O).",13,0,0,0,13
1990300,1547568,2025-04-07,House,"House Finance: Adopt amendment L.009 (Attachment P).",13,0,0,0,13
1990300,1547569,2025-04-07,House,"House Finance: Adopt amendment L.010 (Attachment Q).",13,0,0,0,13
1990300,1547570,2025-04-07,House,"House Finance: Adopt amendment L.011 (Attachment R).",13,0,0,0,13
1990300,1547571,2025-04-07,House,"House Finance: Refer House Bill 25-1292, as amended, to the Committee on Appropriations.",9,4,0,0,13
1990300,1559812,2025-04-29,House,"House Appropriations: Refer House Bill 25-1292 to the Committee of the Whole.",8,3,0,0,11
1990300,1562249,2025-04-30,House,"House: Third Reading Bill",45,20,0,0,65
1990300,1564967,2025-05-05,Senate,"Senate Appropriations: Refer House Bill 25-1292 to the Committee of the Whole.",4,3,0,0,7
1990300,1564968,2025-05-05,Senate,"Senate Transportation & Energy: Adopt amendment L.017",6,3,0,0,9
1990300,1565184,2025-05-05,Senate,"Senate Transportation & Energy: Adopt amendment L.018",9,0,0,0,9
1990300,1565185,2025-05-05,Senate,"Senate Transportation & Energy: Refer House Bill 25-1292, as amended, to the Committee on Appropriations.",6,3,0,0,9
1990300,1566448,2025-05-06,Senate,"Senate: Third Reading Bill",23,12,0,0,35
1990300,1567131,2025-05-07,House,"House: Senate Amendments Concur",46,17,0,2,65
1990300,1567132,2025-05-07,House,"House: Senate Amendments Repass",46,18,0,1,65
1991214,1526775,2025-03-25,House,"House Transportation, Housing & Local Government: Adopt amendment L.003 (Attachment B)",13,0,0,0,13
1991214,1529311,2025-03-25,House,"House Transportation, Housing & Local Government: Adopt amendment L.005 (Attachment C)",9,4,0,0,13
1991214,1529312,2025-03-25,House,"House Transportation, Housing & Local Government: Adopt amendment L.006 (Attachment D)",9,4,0,0,13
1991214,1529313,2025-03-25,House,"House Transportation, Housing & Local Government: Adopt amendment L.007 (Attachment E)",7,6,0,0,13
1991214,1529314,2025-03-25,House,"House Transportation, Housing & Local Government: Adopt amendment L.008 (Attachment F)",7,6,0,0,13
1991214,1529315,2025-03-25,House,"House Transportation, Housing & Local Government: Adopt amendment L.009 (Attachment G)",7,6,0,0,13
1991214,1529316,2025-03-25,House,"House Transportation, Housing & Local Government: Refer House Bill 25-1295, as amended, to the Committee of the Whole.",8,5,0,0,13
1991214,1559032,2025-04-28,House,"House: Third Reading Bill",38,27,0,0,65
1991214,1563946,2025-05-01,Senate,"Senate Local Government & Housing: Adopt amendment L.020",7,0,0,0,7
1991214,1564461,2025-05-01,Senate,"Senate Local Government & Housing: Refer House Bill 25-1295, as amended, to the Committee of the Whole and with a recommendation that it be placed on the consent calendar.",7,0,0,0,7
1991214,1565891,2025-05-06,Senate,"Senate: Third Reading Amend (l.022)",35,0,0,0,35
1991214,1565892,2025-05-06,Senate,"Senate: Third Reading Bill",34,1,0,0,35
1991214,1567594,2025-05-07,House,"House: Senate Amendments Concur",47,17,0,1,65
1991214,1567595,2025-05-07,House,"House: Senate Amendments Repass",48,16,0,1,65
1991246,1523427,2025-03-20,House,"House Education: Adopt amendment L.001",13,0,0,0,13
1991246,1542466,2025-03-20,House,"House Education: Adopt amendment L.003",13,0,0,0,13
1991246,1542467,2025-03-20,House,"House Education: Refer House Bill 25-1293, as amended, to the Committee on Appropriations.",13,0,0,0,13
1991246,1548092,2025-04-15,House,"House Appropriations: Refer House Bill 25-1293 to the Committee of the Whole.",9,2,0,0,11
1991246,1552710,2025-04-21,House,"House: Third Reading Bill",60,4,0,1,65
1991246,1559080,2025-04-28,Senate,"Senate Education: Adopt amendment L.005",7,0,0,0,7
1991246,1561757,2025-04-30,Senate,"Senate Appropriations: Refer House Bill 25-1293 to the Committee of the Whole and with a recommendation that it be placed on the consent calendar.",7,0,0,0,7
1991246,1563482,2025-05-01,Senate,"Senate: Third Reading Bill",35,0,0,0,35
1991246,1564658,2025-04-28,Senate,"Senate Education: Refer House Bill 25-1293, as amended, to the Committee on Appropriations.",5,0,0,2,7
1991246,1564742,2025-05-02,House,"House: Senate Amendments Concur",60,1,0,4,65
1991246,1564743,2025-05-02,House,"House: Senate Amendments Repass",57,4,0,4,65
1991286,1526882,2025-03-25,House,"House Judiciary: Adopt amendment L.001 (Attachment A)",11,0,0,0,11
1991286,1531313,2025-03-31,House,"House: Third Reading Bill",41,23,0,1,65
1991286,1550255,2025-04-16,Senate,"Senate Judiciary: Refer House Bill 25-1294 to the Committee of the Whole.",4,2,0,1,7
1991286,1552550,2025-03-25,House,"House Judiciary: Adopt amendment L.003 (Attachment B)",11,0,0,0,11
1991286,1552551,2025-03-25,House,"House Judiciary: Refer House Bill 25-1294, as amended, to the Committee of the Whole.",8,3,0,0,11
1991286,1555619,2025-04-23,Senate,"Senate: Third Reading Bill",24,11,0,0,35
1991323,1527572,2025-03-26,Senate,"Senate Judiciary: Adopt amendment L.001 (Attachment C)",7,0,0,0,7
1991323,1530276,2025-03-26,Senate,"Senate Judiciary: Adopt amendment L.002 (Attachment D)",7,0,0,0,7
1991323,1530277,2025-03-26,Senate,"Senate Judiciary: Refer Senate Bill 25-190, as amended, to the Committee of the Whole.",5,2,0,0,7
1991323,1530278,2025-03-26,Senate,"Senate Judiciary: This is a conceptual amendment",7,0,0,0,7
1991323,1530279,2025-03-26,Senate,"Senate Judiciary: This is a conceptual amendment",7,0,0,0,7
1991323,1532515,2025-04-01,Senate,"Senate: Third Reading Bill",23,12,0,0,35
1991323,1554961,2025-04-22,House,"House Judiciary: Refer Senate Bill 25-190, as amended, to the Committee of the Whole.",8,3,0,0,11
1991323,1560660,2025-04-29,House,"House: Committee of the Whole Amd (h.001)",18,44,0,3,65
1991323,1562202,2025-04-30,House,"House: Third Reading Amd (l.010)",21,44,0,0,65
1991323,1562203,2025-04-30,House,"House: Third Reading Bill",44,21,0,0,65
1991323,1562204,2025-04-30,House,"House: Third Reading Perm",44,21,0,0,65
1991323,1564418,2025-05-01,Senate,"Senate: House Amendments Concur",32,0,0,3,35
1991323,1564419,2025-05-01,Senate,"Senate: House Amendments Repass",21,11,0,3,35
1991361,1521936,2025-03-19,Senate,"Senate Health & Human Services: Refer Senate Bill 25-192 to the Committee on Appropriations.",7,2,0,0,9
1991361,1546180,2025-04-11,Senate,"Senate Appropriations: Refer Senate Bill 25-192 to the Committee of the Whole.",6,1,0,0,7
1991361,1551588,2025-04-17,Senate,"Senate: Third Reading Bill",26,9,0,0,35
1991361,1554749,2025-04-22,House,"House Health & Human Services: Refer Senate Bill 25-192 to the Committee on Appropriations.",13,0,0,0,13
1991361,1559908,2025-04-29,House,"House Appropriations: Refer Senate Bill 25-192 to the Committee of the Whole.",8,2,0,1,11
1991361,1562561,2025-04-30,House,"House: Third Reading Bill",51,14,0,0,65
1991400,1521362,2025-03-19,Senate,"Senate Education: Adopt amendment L.003",7,0,0,0,7
1991400,1523139,2025-03-19,Senate,"Senate Education: Refer Senate Bill 25-191, as amended, to the Committee of the Whole.",7,0,0,0,7
1991400,1526415,2025-03-25,Senate,"Senate: Third Reading Bill",35,0,0,0,35
1991400,1536397,2025-04-03,House,"House Education: Refer Senate Bill 25-191 to the Committee of the Whole.",13,0,0,0,13
1991400,1551072,2025-04-17,House,"House: Third Reading Bill",55,8,0,2,65
1992734,1517139,2025-03-13,Senate,"Senate Health & Human Services: Adopt amendment L.001 (Attachment A).",9,0,0,0,9
1992734,1529075,2025-03-13,Senate,"Senate Health & Human Services: Adopt amendment L.002 (Attachment B).",9,0,0,0,9
1992734,1529076,2025-03-13,Senate,"Senate Health & Human Services: Refer Senate Bill 25-197, as amended, to the Committee on Appropriations.",8,0,0,1,9
1992734,1545665,2025-04-11,Senate,"Senate Appropriations: Adopt amendment J.001",7,0,0,0,7
1992734,1545666,2025-04-11,Senate,"Senate Appropriations: Refer Senate Bill 25-197, as amended, to the Committee of the Whole and with a recommendation that it be placed on the consent calendar.",7,0,0,0,7
1992734,1546909,2025-04-14,Senate,"Senate: Third Reading Bill",31,2,0,2,35
1992734,1554195,2025-04-22,House,"House Health & Human Services: Refer Senate Bill 25-197 to the Committee of the Whole.",13,0,0,0,13
1992734,1558185,2025-04-25,House,"House: Third Reading Bill",50,12,0,3,65
1992734,1558829,2025-04-28,Senate,"Senate: House Amendments Concur",32,1,0,2,35
1992734,1558830,2025-04-28,Senate,"Senate: House Amendments Repass",33,0,0,2,35
1992773,1551666,2025-04-17,Senate,"Senate Health & Human Services: Postpone Senate Bill 25-198 indefinitely.",9,0,0,0,9
1992810,1508820,2025-03-07,Senate,"Senate Appropriations: Adopt amendment J.001",7,0,0,0,7
1992810,1508821,2025-03-07,Senate,"Senate Appropriations: Reconsider SB25-199",6,1,0,0,7
1992810,1508822,2025-03-07,Senate,"Senate Appropriations: Refer Senate Bill 25-199 to the Committee of the Whole.",7,0,0,0,7
1992810,1508823,2025-03-07,Senate,"Senate Appropriations: Refer Senate Bill 25-199, as amended, to the Committee of the Whole.",7,0,0,0,7
1992810,1517160,2025-03-13,Senate,"Senate: Third Reading Bill",33,0,0,1,34
1992810,1520159,2025-03-18,House,"House Appropriations: Adopt amendment J.002",11,0,0,0,11
1992810,1520160,2025-03-18,House,"House Appropriations: Refer Senate Bill 25-199, as amended, to the Committee of the Whole.",11,0,0,0,11
1992810,1527995,2025-03-26,House,"House: Third Reading Bill",65,0,0,0,65
1992810,1530298,2025-03-28,Senate,"Senate: House Amendments Not Concur Appt Cc",34,0,0,1,35
1992810,1538165,2025-04-07,Joint,"CC_SB25-199_2025A: Adopt the draft conference committee report CLSB199.001",6,0,0,0,6
1992810,1549383,2025-04-15,House,"House: Conference Committee Report Adopt",64,0,0,1,65
1992810,1549384,2025-04-15,House,"House: Conference Committee Report Repass",64,0,0,1,65
1992810,1549769,2025-04-16,Senate,"Senate: Conference Committee Report Adopt Ccr",32,0,0,3,35
1992810,1549770,2025-04-16,Senate,"Senate: Conference Committee Report Repass",31,1,0,3,35
1992852,1529370,2025-03-27,Senate,"Senate Health & Human Services: Adopt amendment L.002 (Attachment F).",9,0,0,0,9
1992852,1545339,2025-04-11,Senate,"Senate Appropriations: Adopt amendment L.009",7,0,0,0,7
1992852,1545785,2025-04-11,Senate,"Senate Appropriations: Refer Senate Bill 25-194, as amended, to the Committee of the Whole.",6,1,0,0,7
1992852,1551503,2025-03-27,Senate,"Senate Health & Human Services: Adopt amendment L.003 (Attachment G).",9,0,0,0,9
1992852,1551504,2025-03-27,Senate,"Senate Health & Human Services: Adopt amendment L.004 (Attachment H).",9,0,0,0,9
1992852,1551505,2025-03-27,Senate,"Senate Health & Human Services: Adopt amendment L.005 (Attachment I).",9,0,0,0,9
1992852,1551506,2025-03-27,Senate,"Senate Health & Human Services: Refer Senate Bill 25-194, as amended, to the Committee on Appropriations.",9,0,0,0,9
1992852,1551507,2025-04-17,Senate,"Senate: Third Reading Amend (l.018)",35,0,0,0,35
1992852,1551508,2025-04-17,Senate,"Senate: Third Reading Bill",25,10,0,0,35
1992852,1551509,2025-04-17,Senate,"Senate: Third Reading Bill",28,7,0,0,35
1992852,1554116,2025-04-22,House,"House Health & Human Services: Refer Senate Bill 25-194 to the Committee on Appropriations.",12,0,0,1,13
1992852,1556450,2025-04-24,House,"House Appropriations: Refer Senate Bill 25-194 to the Committee of the Whole.",10,1,0,0,11
1992852,1558149,2025-04-25,House,"House: Third Reading Bill",54,8,0,3,65
1992852,1558150,2025-04-25,House,"House: Third Reading Perm",19,43,0,3,65
1992889,1544934,2025-04-10,Senate,"Senate Health & Human Services: Adopt amendment L.001 (Attachment E).",9,0,0,0,9
1992889,1548463,2025-04-15,Senate,"Senate Appropriations: Refer Senate Bill 25-195 to the Committee of the Whole and with a recommendation that it be placed on the consent calendar.",7,0,0,0,7
1992889,1552468,2025-04-21,Senate,"Senate: Third Reading Bill",34,1,0,0,35
1992889,1554955,2025-04-22,House,"House Health & Human Services: Refer Senate Bill 25-195 to the Committee on Appropriations.",10,1,0,2,13
1992889,1560490,2025-04-10,Senate,"Senate Health & Human Services: Refer Senate Bill 25-195, as amended, to the Committee on Appropriations.",8,0,0,1,9
1992889,1560491,2025-04-29,House,"House Appropriations: Refer Senate Bill 25-195 to the Committee of the Whole.",8,2,0,1,11
1992889,1562555,2025-04-30,House,"House: Third Reading Bill",54,11,0,0,65
1992929,1529375,2025-03-27,Senate,"Senate Health & Human Services: Refer Senate Bill 25-196 to the Committee of the Whole.",6,3,0,0,9
1992929,1539473,2025-04-08,Senate,"Senate: Third Reading Bill",23,11,0,1,35
1992929,1549020,2025-04-15,House,"House Health & Human Services: Refer Senate Bill 25-196 to the Committee of the Whole.",9,4,0,0,13
1992929,1557969,2025-04-25,House,"House: Third Reading Bill",40,22,0,3,65
1992965,1521162,2025-03-19,Senate,"Senate Health & Human Services: Adopt amendment L.001 (Attachment D).",9,0,0,0,9
1992965,1531659,2025-03-19,Senate,"Senate Health & Human Services: Refer Senate Bill 25-193, as amended, to the Committee on Appropriations.",8,1,0,0,9
1992965,1546081,2025-04-11,Senate,"Senate Appropriations: Refer Senate Bill 25-193 to the Committee of the Whole.",6,1,0,0,7
1992965,1551634,2025-04-17,Senate,"Senate: Third Reading Bill",29,6,0,0,35
1992965,1554779,2025-04-22,House,"House Health & Human Services: Refer Senate Bill 25-193 to the Committee on Appropriations.",10,3,0,0,13
1992965,1556519,2025-04-24,House,"House Appropriations: Refer Senate Bill 25-193 to the Committee of the Whole.",9,2,0,0,11
1992965,1557986,2025-04-25,House,"House: Third Reading Bill",51,12,0,2,65
1992973,1552954,2025-04-21,House,"House Finance: Refer House Bill 25-1296, as amended, to the Committee of the Whole.",10,3,0,0,13
1992973,1558219,2025-04-25,House,"House Appropriations: Refer House Bill 25-1296 to the Committee of the Whole.",6,5,0,0,11
1992973,1559153,2025-04-28,House,"House: Third Reading Bill",39,25,0,1,65
1992973,1563924,2025-04-21,House,"House Finance: Adopt amendment L.014 (Attachment I).",12,1,0,0,13
1992973,1563925,2025-05-01,Senate,"Senate Finance: Adopt amendment L.016 (Attachment I)",9,0,0,0,9
1992973,1564474,2025-05-02,Senate,"Senate Appropriations: Refer House Bill 25-1296 to the Committee of the Whole.",4,3,0,0,7
1992973,1564641,2025-04-21,House,"House Finance: Refer House Bill 25-1296, as amended, to the Committee on Appropriations.",7,6,0,0,13
1992973,1565059,2025-05-01,Senate,"Senate Finance: Refer House Bill 25-1296, as amended, to the Committee on Appropriations.",5,3,0,1,9
1992973,1565867,2025-05-06,Senate,"Senate: Third Reading Bill",23,12,0,0,35
1992973,1567079,2025-05-07,House,"House: Senate Amendments Concur",42,22,0,1,65
1992973,1567080,2025-05-07,House,"House: Senate Amendments Repass",40,24,0,1,65
1992982,1527927,2025-03-26,House,"House Health & Human Services: Adopt amendment L.001 (Attachment C).",13,0,0,0,13
1992982,1529236,2025-03-26,House,"House Health & Human Services: Adopt amendment L.003 (Attachment D).",13,0,0,0,13
1992982,1529237,2025-03-26,House,"House Health & Human Services: Refer House Bill 25-1297, as amended, to the Committee on Finance.",9,4,0,0,13
1992982,1566003,2025-05-06,House,"House Finance: Postpone House Bill 25-1297 indefinitely.",12,1,0,0,13
1994041,1519500,2025-03-18,House,"House Judiciary: Refer House Bill 25-1298 to the Committee of the Whole.",8,0,0,3,11
1994041,1522779,2025-03-20,House,"House: Third Reading Bill",63,0,0,2,65
1994041,1538607,2025-04-07,Senate,"Senate Judiciary: Refer House Bill 25-1298 to the Committee of the Whole and with a recommendation that it be placed on the consent calendar.",7,0,0,0,7
1994041,1545101,2025-04-10,Senate,"Senate: Third Reading Bill",33,0,0,2,35
1996613,1516957,2025-03-13,Senate,"Senate: Consideration of Resolutions Resolution",34,0,0,0,34
1996613,1521879,2025-03-19,House,"House: RESOLUTIONS Res",59,5,0,1,65
1996649,1515722,2025-03-12,Senate,"Senate: Consideration of Resolutions Resolution",23,11,0,0,34
1996691,1525498,2025-03-24,House,"House Finance: Refer House Bill 25-1299 to the Committee on Appropriations.",11,2,0,0,13
1996691,1537025,2025-04-04,House,"House Appropriations: Adopt amendment J.001",11,0,0,0,11
1996691,1537902,2025-04-04,House,"House Appropriations: Refer House Bill 25-1299, as amended, to the Committee of the Whole.",8,3,0,0,11
1996691,1548177,2025-04-15,House,"House: Third Reading Bill",45,17,0,3,65
1996691,1551517,2025-04-17,Senate,"Senate Finance: Refer House Bill 25-1299 to the Committee on Appropriations.",8,0,0,1,9
1996691,1559791,2025-04-29,Senate,"Senate Appropriations: Refer House Bill 25-1299 to the Committee of the Whole and with a recommendation that it be placed on the consent calendar.",6,0,0,1,7
1996691,1561813,2025-04-30,Senate,"Senate: Third Reading Bill",34,1,0,0,35
1996730,1528003,2025-03-26,House,"House: RESOLUTIONS Res",65,0,0,0,65
1996769,1552046,2025-04-17,Senate,"Senate State, Veterans, & Military Affairs: Postpone SCR25-001 indefinitely using a reversal of the previous roll call. There was no objection to the use of the reverse roll call, therefore, the bill was postponed indefinitely.",3,1,0,1,5
1996769,1567849,2025-04-17,Senate,"Senate State, Veterans, & Military Affairs: Postpone SCR25-001 indefinitely using a reversal of the previous roll call. There was no objection to the use of the reverse roll call, therefore, the bill was postponed indefinitely.",3,1,0,1,5
1999727,1518812,2025-03-17,Senate,"Senate: Consideration of Resolutions Resolution",34,0,0,0,34
1999727,1547517,2025-04-11,House,"House: RESOLUTIONS Res",61,0,0,4,65
2004600,1518396,2025-03-17,Senate,"Senate: Consideration of Resolutions Resolution",34,0,0,0,34
2004600,1519510,2025-03-18,House,"House: RESOLUTIONS Amd (l.001)",24,38,0,3,65
2004600,1519511,2025-03-18,House,"House: RESOLUTIONS Res",42,20,0,3,65
2005028,1526846,2025-03-25,House,"House Judiciary: Refer House Bill 25-1301 to the Committee of the Whole.",10,0,0,1,11
2005028,1529319,2025-03-27,House,"House: Committee of the Whole Amd (h.001)",19,41,0,5,65
2005028,1531093,2025-03-31,House,"House: Third Reading Bill",51,13,0,1,65
2005028,1547227,2025-04-14,Senate,"Senate Judiciary: Refer House Bill 25-1301 to the Committee of the Whole and with a recommendation that it be placed on the consent calendar.",7,0,0,0,7
2005028,1551698,2025-04-17,Senate,"Senate: Third Reading Bill",34,1,0,0,35
2005595,1527964,2025-03-26,House,"House Business Affairs & Labor: Adopt amendment L.001",13,0,0,0,13
2005595,1537114,2025-03-26,House,"House Business Affairs & Labor: Adopt amendment L.002",13,0,0,0,13
2005595,1537115,2025-03-26,House,"House Business Affairs & Labor: Refer House Bill 25-1300, as amended, to the Committee of the Whole.",8,5,0,0,13
2005595,1546932,2025-04-14,House,"House: Third Reading Bill",38,25,0,2,65
2005595,1557275,2025-04-24,Senate,"Senate Business, Labor, & Technology: Refer House Bill 25-1300, as amended, to the Committee of the Whole.",4,3,0,0,7
2005595,1560486,2025-04-29,Senate,"Senate: Committee of the Whole Adopt Report",33,0,0,2,35
2005595,1561760,2025-04-30,Senate,"Senate: Third Reading Bill",22,13,0,0,35
2005595,1567122,2025-05-07,House,"House: Senate Amendments Concur",42,22,0,1,65
2005595,1567123,2025-05-07,House,"House: Senate Amendments Repass",39,25,0,1,65
2005595,1567666,2025-05-07,House,"House: Conference Committee Report Adopt",43,22,0,0,65
2005595,1567667,2025-05-07,House,"House: Conference Committee Report Repass",41,24,0,0,65
2005595,1567668,2025-05-07,House,"House: Senate Amendments Not Cncr",44,21,0,0,65
2005595,1567669,2025-05-07,Senate,"Senate: Conference Committee Report Adopt Ccr",35,0,0,0,35
2005595,1567670,2025-05-07,Senate,"Senate: Conference Committee Report Repass",22,13,0,0,35
2006602,1518029,2025-03-14,Senate,"Senate: Consideration of Resolutions Resolution",34,0,0,0,34
2006602,1519113,2025-03-17,House,"House: RESOLUTIONS Res",63,0,0,2,65
2007587,1538660,2025-04-07,House,"House Finance: Adopt amendment L.001 (Attachment A).",11,2,0,0,13
2007587,1547643,2025-04-07,House,"House Finance: Adopt amendment L.002 (Attachment B).",13,0,0,0,13
2007587,1547644,2025-04-07,House,"House Finance: Adopt amendment L.003 (Attachment C).",13,0,0,0,13
2007587,1547645,2025-04-07,House,"House Finance: Adopt amendment L.004 (Attachment D).",13,0,0,0,13
2007587,1547646,2025-04-07,House,"House Finance: Adopt amendment L.005 (Attachment E).",13,0,0,0,13
2007587,1547647,2025-04-07,House,"House Finance: Adopt amendment L.006 (Attachment F).",13,0,0,0,13
2007587,1547648,2025-04-07,House,"House Finance: Adopt amendment L.007 (Attachment G).",13,0,0,0,13
2007587,1547649,2025-04-07,House,"House Finance: Adopt amendment L.008 (Attachment H).",13,0,0,0,13
2007587,1547650,2025-04-07,House,"House Finance: Adopt amendment L.009 (Attachment I).",13,0,0,0,13
2007587,1547651,2025-04-07,House,"House Finance: Refer House Bill 25-1302, as amended, to the Committee on Appropriations.",9,4,0,0,13
2007587,1553368,2025-04-22,House,"House Appropriations: Adopt amendment L.011",11,0,0,0,11
2007587,1555561,2025-04-23,House,"House: Third Reading Bill",40,24,0,1,65
2007587,1559877,2025-04-22,House,"House Appropriations: Adopt amendment J.002",11,0,0,0,11
2007587,1559878,2025-04-22,House,"House Appropriations: Refer House Bill 25-1302, as amended, to the Committee of the Whole.",7,4,0,0,11
2007587,1565652,2025-05-06,Senate,"Senate Finance: Postpone House Bill 25-1302 indefinitely using a reversal of the previous roll call. There was no objection to the use of the reverse roll call, therefore, the bill was postponed indefinitely.",6,2,0,1,9
2007587,1565653,2025-05-06,Senate,"Senate Finance: Refer House Bill 25-1302 to the Committee on Appropriations.",2,6,0,1,9
2009591,1521160,2025-03-19,Senate,"Senate: Consideration of Resolutions Resolution",34,0,0,0,34
2009591,1522868,2025-03-20,House,"House: RESOLUTIONS Amd (l.001)",61,0,0,4,65
2009591,1522869,2025-03-20,House,"House: RESOLUTIONS Res",61,0,0,4,65
2009591,1524525,2025-03-21,Senate,"Senate: House Amendments Concur",34,0,0,1,35
2009591,1524526,2025-03-21,Senate,"Senate: House Amendments Repass",34,0,0,1,35
2010342,1531567,2025-03-31,Senate,"Senate Education: Adopt amendment L.001 (Attachment E)",7,0,0,0,7
2010342,1534605,2025-03-31,Senate,"Senate Education: Adopt amendment L.003 (Attachment F)",7,0,0,0,7
2010342,1534606,2025-03-31,Senate,"Senate Education: Refer Senate Bill 25-200, as amended, to the Committee of the Whole.",6,0,0,1,7
2010342,1538106,2025-04-07,Senate,"Senate: Third Reading Bill",34,0,0,1,35
2010342,1550712,2025-04-16,House,"House Education: Refer Senate Bill 25-200 to the Committee of the Whole.",12,1,0,0,13
2010342,1561822,2025-04-30,House,"House: Third Reading Bill",60,4,0,1,65
2010342,1564356,2025-05-01,Senate,"Senate: House Amendments Concur",32,0,0,3,35
2010342,1564357,2025-05-01,Senate,"Senate: House Amendments Repass",32,0,0,3,35
2010342,1566626,2025-04-16,House,"House Education: Refer Senate Bill 25-200 to the Committee of the Whole.",12,1,0,0,13
2010431,1524527,2025-03-21,Senate,"Senate: Consideration of Resolutions Resolution",34,0,0,1,35
2010431,1532826,2025-04-01,House,"House: RESOLUTIONS Res",61,0,0,4,65
2011425,1533034,2025-04-01,House,"House Transportation, Housing & Local Government: Adopt amendment L.001 (Attachment B)",13,0,0,0,13
2011425,1537407,2025-04-01,House,"House Transportation, Housing & Local Government: Adopt amendment L.002 (Attachment C)",13,0,0,0,13
2011425,1537408,2025-04-01,House,"House Transportation, Housing & Local Government: Adopt amendment L.003 (Attachment D)",13,0,0,0,13
2011425,1537409,2025-04-01,House,"House Transportation, Housing & Local Government: Adopt amendment L.004 (Attachment E)",13,0,0,0,13
2011425,1537410,2025-04-01,House,"House Transportation, Housing & Local Government: Adopt amendment L.005 (Attachment F)",13,0,0,0,13
2011425,1537411,2025-04-01,House,"House Transportation, Housing & Local Government: Refer House Bill 25-1303, as amended, to the Committee on Finance.",9,4,0,0,13
2011425,1539076,2025-04-07,House,"House Finance: Adopt amendment L.006 (Attachment T).",13,0,0,0,13
2011425,1547763,2025-04-07,House,"House Finance: Adopt amendment L.007 (Attachment U).",13,0,0,0,13
2011425,1547764,2025-04-07,House,"House Finance: Adopt amendment L.008 (Attachment V).",13,0,0,0,13
2011425,1547765,2025-04-07,House,"House Finance: Adopt amendment L.009 (Attachment X).",13,0,0,0,13
2011425,1547766,2025-04-07,House,"House Finance: Refer House Bill 25-1303, as amended, to the Committee on Appropriations.",8,5,0,0,13
2011425,1551227,2025-04-17,House,"House Appropriations: Refer House Bill 25-1303 to the Committee of the Whole.",7,4,0,0,11
2011425,1552479,2025-04-21,House,"House: Third Reading Bill",38,25,0,2,65
2011425,1558236,2025-04-24,Senate,"Senate Finance: Adopt amendment L.013 (Attachment D)",9,0,0,0,9
2011425,1560595,2025-04-29,Senate,"Senate Finance: Postpone House Bill 25-1303 indefinitely.",6,2,0,1,9
2012038,1536726,2025-04-03,House,"House Education: Refer House Bill 25-1307 to the Committee of the Whole.",13,0,0,0,13
2012038,1547432,2025-04-14,House,"House: Third Reading Bill",63,1,0,1,65
2012038,1552662,2025-04-21,Senate,"Senate Education: Refer House Bill 25-1307 to the Committee of the Whole and with a recommendation that it be placed on the consent calendar.",5,0,0,2,7
2012038,1555577,2025-04-23,Senate,"Senate: Third Reading Bill",35,0,0,0,35
2012072,1540706,2025-04-08,House,"House Judiciary: Refer House Bill 25-1304, as amended, to the Committee of the Whole.",10,0,0,1,11
2012072,1551566,2025-04-17,House,"House: Third Reading Bill",52,11,0,2,65
2012072,1559252,2025-04-28,Senate,"Senate Judiciary: Refer House Bill 25-1304 to the Committee of the Whole and with a recommendation that it be placed on the consent calendar.",7,0,0,0,7
2012072,1564027,2025-05-01,Senate,"Senate: Third Reading Bill",30,5,0,0,35
2012107,1531208,2025-03-31,House,"House State, Civic, Military, & Veterans Affairs: Refer House Bill 25-1305 to the Committee of the Whole.",11,0,0,0,11
2012107,1547626,2025-04-14,House,"House: Third Reading Bill",64,0,0,1,65
2012107,1554172,2025-04-22,Senate,"Senate State, Veterans, & Military Affairs: Refer House Bill 25-1305 to the Committee of the Whole and with a recommendation that it be placed on the consent calendar.",4,0,0,1,5
2012107,1559083,2025-04-28,Senate,"Senate: Third Reading Bill",34,0,0,1,35
2012146,1529296,2025-03-27,Senate,"Senate Health & Human Services: Adopt amendment L.001 (Attachment L).",9,0,0,0,9
2012146,1551637,2025-03-27,Senate,"Senate Health & Human Services: Adopt amendment L.002 (Attachment M).",9,0,0,0,9
2012146,1551638,2025-03-27,Senate,"Senate Health & Human Services: Adopt amendment L.003 (Attachment N).",9,0,0,0,9
2012146,1551639,2025-03-27,Senate,"Senate Health & Human Services: Refer Senate Bill 25-201, as amended, to the Committee of the Whole.",8,1,0,0,9
2012176,1531205,2025-03-31,House,"House State, Civic, Military, & Veterans Affairs: Refer House Bill 25-1306 to the Committee of the Whole.",11,0,0,0,11
2012176,1547499,2025-04-14,House,"House: Third Reading Bill",63,1,0,1,65
2012176,1554080,2025-04-22,Senate,"Senate Business, Labor, & Technology: Refer House Bill 25-1306 to the Committee of the Whole and with a recommendation that it be placed on the consent calendar.",6,0,0,1,7
2012176,1558828,2025-04-28,Senate,"Senate: Third Reading Bill",34,0,0,1,35
2012823,1544498,2025-04-10,Senate,"Senate Health & Human Services: Refer Senate Bill 25-203 to the Committee of the Whole and with a recommendation that it be placed on the consent calendar.",9,0,0,0,9
2012823,1547597,2025-04-14,Senate,"Senate: Third Reading Bill",33,0,0,2,35
2012823,1553131,2025-04-21,House,"House State, Civic, Military, & Veterans Affairs: Refer Senate Bill 25-203 to the Committee of the Whole.",11,0,0,0,11
2012823,1557988,2025-04-25,House,"House: Third Reading Bill",63,0,0,2,65
2012824,1531311,2025-03-31,Senate,"Senate Transportation & Energy: Refer Senate Bill 25-204 to the Committee of the Whole and with a recommendation that it be placed on the consent calendar.",9,0,0,0,9
2012824,1537185,2025-04-04,Senate,"Senate: Third Reading Bill",34,0,0,1,35
2012824,1549881,2025-04-16,House,"House Energy & Environment: Refer Senate Bill 25-204 to the Committee of the Whole.",12,0,0,1,13
2012824,1558996,2025-04-28,House,"House: Third Reading Bill",63,1,0,1,65
2012825,1544132,2025-04-10,Senate,"Senate Health & Human Services: Refer Senate Bill 25-202 to the Committee of the Whole and with a recommendation that it be placed on the consent calendar.",9,0,0,0,9
2012825,1547149,2025-04-14,Senate,"Senate: Third Reading Bill",33,0,0,2,35
2012825,1553077,2025-04-21,House,"House State, Civic, Military, & Veterans Affairs: Refer Senate Bill 25-202 to the Committee of the Whole.",10,1,0,0,11
2012825,1562581,2025-04-30,House,"House: Third Reading Bill",63,2,0,0,65
2014534,1533227,2025-04-01,Senate,"Senate State, Veterans, & Military Affairs: Adopt amendment L.001 (Attachment B).",5,0,0,0,5
2014534,1537377,2025-04-01,Senate,"Senate State, Veterans, & Military Affairs: Adopt amendment L.003 (Attachment C).",5,0,0,0,5
2014534,1537378,2025-04-01,Senate,"Senate State, Veterans, & Military Affairs: Refer Senate Bill 25-205, as amended, to the Committee of the Whole.",3,2,0,0,5
2014534,1539519,2025-04-08,Senate,"Senate: Third Reading Bill",23,11,0,1,35
2014534,1553186,2025-04-21,House,"House State, Civic, Military, & Veterans Affairs: Refer Senate Bill 25-205 to the Committee of the Whole.",8,3,0,0,11
2014534,1557264,2025-04-24,House,"House: Committee of the Whole Amd (h.001)",23,38,0,4,65
2014534,1557623,2025-04-24,House,"House: Committee of the Whole Amd (h.002)",24,37,0,4,65
2014534,1557624,2025-04-24,House,"House: Committee of the Whole Amd (h.003)",24,37,0,4,65
2014534,1557625,2025-04-24,House,"House: Committee of the Whole Amd (h.004)",23,38,0,4,65
2014534,1557626,2025-04-24,House,"House: Committee of the Whole Amd (h.005)",25,36,0,4,65
2014534,1557627,2025-04-24,House,"House: Committee of the Whole Amd (h.006)",28,33,0,4,65
2014534,1557628,2025-04-24,House,"House: Committee of the Whole Amd (h.007)",22,39,0,4,65
2014534,1557629,2025-04-24,House,"House: Committee of the Whole Amd (h.008)",25,36,0,4,65
2014534,1558242,2025-04-25,House,"House: Third Reading Bill",36,27,0,2,65
2014534,1558906,2025-04-28,Senate,"Senate: House Amendments Concur",33,0,0,2,35
2014534,1558907,2025-04-28,Senate,"Senate: House Amendments Repass",22,11,0,2,35
2014648,1531201,2025-03-31,House,"House State, Civic, Military, & Veterans Affairs: Refer House Bill 25-1308 to the Committee of the Whole.",11,0,0,0,11
2014648,1547623,2025-04-14,House,"House: Third Reading Bill",64,0,0,1,65
2014648,1554640,2025-04-22,Senate,"Senate State, Veterans, & Military Affairs: Refer House Bill 25-1308 to the Committee of the Whole and with a recommendation that it be placed on the consent calendar.",5,0,0,0,5
2014648,1559035,2025-04-28,Senate,"Senate: Third Reading Bill",34,0,0,1,35
2014990,1530979,2025-03-31,Senate,"Senate: Consideration of Resolutions Resolution",22,12,0,1,35
2015535,1533665,2025-04-01,Senate,"Senate: Consideration of Resolutions Resolution",35,0,0,0,35
2015535,1548275,2025-04-15,House,"House: RESOLUTIONS Res",59,0,0,6,65
2015994,1543343,2025-04-10,Senate,"Senate: Consideration of Resolutions Resolution",33,0,0,2,35
2015994,1554353,2025-04-22,House,"House: RESOLUTIONS Res",61,0,0,4,65
2016028,1537359,2025-04-04,House,"House: RESOLUTIONS Res",63,0,0,2,65
2016028,1548212,2025-04-15,Senate,"Senate: Consideration of Resolutions Resolution",33,0,0,2,35
2016592,1534726,2025-04-02,House,"House: RESOLUTIONS Res",63,0,0,2,65
2016592,1534727,2025-04-02,Senate,"Senate: Consideration of Resolutions Resolution",35,0,0,0,35
2016600,1530924,2025-03-31,House,"House: RESOLUTIONS Res",63,0,0,2,65
2016616,1552751,2025-04-21,House,"House Finance: Adopt amendment L.003 (Attachment A).",13,0,0,0,13
2016616,1557935,2025-04-25,House,"House Appropriations: Adopt amendment L.004",11,0,0,0,11
2016616,1559091,2025-04-28,House,"House: Third Reading Bill",52,13,0,0,65
2016616,1560974,2025-04-25,House,"House Appropriations: Adopt amendment J.003",11,0,0,0,11
2016616,1560975,2025-04-25,House,"House Appropriations: Refer House Bill 25-1311, as amended, to the Committee of the Whole.",8,3,0,0,11
2016616,1564045,2025-05-01,Senate,"Senate Finance: Adopt amendment L.006 (Attachment B)",9,0,0,0,9
2016616,1564593,2025-04-21,House,"House Finance: Refer House Bill 25-1311, as amended, to the Committee on Appropriations.",9,4,0,0,13
2016616,1564594,2025-05-02,Senate,"Senate Appropriations: Refer House Bill 25-1311 to the Committee of the Whole.",5,2,0,0,7
2016616,1564897,2025-05-01,Senate,"Senate Finance: Refer House Bill 25-1311, as amended, to the Committee on Appropriations.",9,0,0,0,9
2016616,1566793,2025-05-06,Senate,"Senate: Third Reading Bill",28,7,0,0,35
2016616,1568031,2025-05-07,House,"House: Senate Amendments Concur",54,9,0,2,65
2016616,1568032,2025-05-07,House,"House: Senate Amendments Repass",52,11,0,2,65
2016629,1533735,2025-04-01,House,"House Judiciary: Adopt amendment L.001 (Attachment B)",11,0,0,0,11
2016629,1537434,2025-04-04,House,"House: Committee of the Whole Amd (h.001)",19,38,0,8,65
2016629,1537915,2025-04-06,House,"House: Third Reading Bill",36,20,0,9,65
2016629,1537916,2025-04-06,House,"House: Third Reading Bill",36,20,0,9,65
2016629,1537917,2025-04-06,House,"House: Third Reading Prev ?",38,20,0,7,65
2016629,1552748,2025-04-01,House,"House Judiciary: Refer House Bill 25-1312, as amended, to the Committee of the Whole.",7,4,0,0,11
2016629,1563257,2025-04-30,Senate,"Senate Judiciary: Adopt amendment L.008 (Attachment C)",7,0,0,0,7
2016629,1565048,2025-04-30,Senate,"Senate Judiciary: Adopt amendment L.009 (Attachment D)",7,0,0,0,7
2016629,1565049,2025-04-30,Senate,"Senate Judiciary: Adopt amendment L.010 (Attachment E)",7,0,0,0,7
2016629,1565050,2025-04-30,Senate,"Senate Judiciary: Adopt amendment L.011 (Attachment F)",7,0,0,0,7
2016629,1565051,2025-04-30,Senate,"Senate Judiciary: Adopt amendment L.012 (Attachment G)",7,0,0,0,7
2016629,1565052,2025-04-30,Senate,"Senate Judiciary: Adopt amendment L.013 (Attachment H)",7,0,0,0,7
2016629,1565053,2025-04-30,Senate,"Senate Judiciary: Refer House Bill 25-1312, as amended, to the Committee of the Whole.",5,2,0,0,7
2016629,1565376,2025-05-05,Senate,"Senate: Committee of the Whole Cow * (s.002)",14,21,0,0,35
2016629,1566391,2025-05-06,Senate,"Senate: Third Reading Bill",20,14,0,1,35
2016629,1566827,2025-05-06,House,"House: Senate Amendments Concur",39,24,0,2,65
2016629,1566828,2025-05-06,House,"House: Senate Amendments Prev ?",37,27,0,1,65
2016629,1566829,2025-05-06,House,"House: Senate Amendments Repass",40,24,0,1,65
2016641,1535076,2025-04-02,House,"House Health & Human Services: Refer House Bill 25-1309 to the Committee of the Whole.",9,4,0,0,13
2016641,1537398,2025-04-04,House,"House: Committee of the Whole Amd (h.001)",19,38,0,8,65
2016641,1537399,2025-04-04,House,"House: Committee of the Whole Amd (h.002)",20,37,0,8,65
2016641,1537400,2025-04-04,House,"House: Committee of the Whole Amd (h.003)",19,38,0,8,65
2016641,1537401,2025-04-04,House,"House: Committee of the Whole Amd (h.004)",19,38,0,8,65
2016641,1537898,2025-04-06,House,"House: Third Reading Bill",40,20,0,5,65
2016641,1537899,2025-04-06,House,"House: Third Reading Lo",20,40,0,5,65
2016641,1537900,2025-04-06,House,"House: Third Reading Prev ?",39,21,0,5,65
2016641,1537901,2025-04-06,House,"House: Third Reading Prev ?",39,21,0,5,65
2016641,1564023,2025-05-01,Senate,"Senate Health & Human Services: Refer House Bill 25-1309, as amended, to the Committee of the Whole.",6,3,0,0,9
2016641,1566695,2025-05-06,Senate,"Senate: Third Reading Bill",23,12,0,0,35
2016641,1567676,2025-05-01,Senate,"Senate Health & Human Services: Refer House Bill 25-1309, as amended, to the Committee of the Whole.",6,3,0,0,9
2016641,1567677,2025-05-07,House,"House: Senate Amendments Concur",39,24,0,2,65
2016641,1567678,2025-05-07,House,"House: Senate Amendments Repass",42,23,0,0,65
2016651,1547152,2025-04-14,House,"House State, Civic, Military, & Veterans Affairs: Adopt amendment L.001 (Attachment B).",6,5,0,0,11
2016651,1551874,2025-04-14,House,"House State, Civic, Military, & Veterans Affairs: Adopt amendment L.006 (Attachment C).",11,0,0,0,11
2016651,1551875,2025-04-14,House,"House State, Civic, Military, & Veterans Affairs: Adopt amendment L.007 (Attachment D).",11,0,0,0,11
2016651,1551876,2025-04-14,House,"House State, Civic, Military, & Veterans Affairs: Refer House Bill 25-1310, as amended, to the Committee on Appropriations.",8,2,0,1,11
2017069,1532229,2025-04-01,Senate,"Senate Appropriations: Refer Senate Bill 25-260 to the Committee of the Whole and with a recommendation that it be placed on the consent calendar.",7,0,0,0,7
2017069,1536119,2025-04-03,Senate,"Senate: Third Reading Bill",30,0,0,5,35
2017069,1540423,2025-04-08,House,"House Appropriations: Refer Senate Bill 25-260 to the Committee of the Whole.",11,0,0,0,11
2017069,1545103,2025-04-10,House,"House: Third Reading Bill",65,0,0,0,65
2017072,1532548,2025-04-01,Senate,"Senate Appropriations: Refer Senate Bill 25-241 to the Committee of the Whole and with a recommendation that it be placed on the consent calendar.",7,0,0,0,7
2017072,1536026,2025-04-03,Senate,"Senate: Third Reading Bill",30,0,0,5,35
2017072,1540132,2025-04-08,House,"House Appropriations: Refer Senate Bill 25-241 to the Committee of the Whole.",9,2,0,0,11
2017072,1543374,2025-04-10,House,"House: Third Reading Bill",60,1,0,4,65
2017075,1532546,2025-04-01,Senate,"Senate Appropriations: Refer Senate Bill 25-255 to the Committee of the Whole.",5,2,0,0,7
2017075,1536492,2025-04-03,Senate,"Senate: Third Reading Bill",34,0,0,1,35
2017075,1540014,2025-04-08,House,"House Appropriations: Refer Senate Bill 25-255 to the Committee of the Whole.",10,1,0,0,11
2017075,1545111,2025-04-10,House,"House: Third Reading Bill",45,20,0,0,65
2017079,1532551,2025-04-01,Senate,"Senate Appropriations: Refer Senate Bill 25-246 to the Committee of the Whole and with a recommendation that it be placed on the consent calendar.",7,0,0,0,7
2017079,1535658,2025-04-03,Senate,"Senate: Third Reading Bill",31,2,0,2,35
2017079,1535659,2025-04-03,Senate,"Senate: Third Reading Bill",29,1,0,5,35
2017079,1540053,2025-04-08,House,"House Appropriations: Refer Senate Bill 25-246 to the Committee of the Whole.",9,2,0,0,11
2017079,1544113,2025-04-10,House,"House: Third Reading Bill",44,19,0,2,65
2017092,1532557,2025-04-01,Senate,"Senate Appropriations: Refer Senate Bill 25-234 to the Committee of the Whole and with a recommendation that it be placed on the consent calendar.",7,0,0,0,7
2017092,1535936,2025-04-03,Senate,"Senate: Third Reading Bill",30,0,0,5,35
2017092,1539914,2025-04-08,House,"House Appropriations: Refer Senate Bill 25-234 to the Committee of the Whole.",11,0,0,0,11
2017092,1543458,2025-04-10,House,"House: Third Reading Bill",61,0,0,4,65
2017096,1532104,2025-04-01,Senate,"Senate Appropriations: Refer Senate Bill 25-227 to the Committee of the Whole and with a recommendation that it be placed on the consent calendar.",7,0,0,0,7
2017096,1536428,2025-04-03,Senate,"Senate: Third Reading Bill",30,0,0,5,35
2017096,1540054,2025-04-08,House,"House Appropriations: Refer Senate Bill 25-227 to the Committee of the Whole.",11,0,0,0,11
2017096,1543402,2025-04-10,House,"House: Third Reading Bill",51,12,0,2,65
2017101,1532207,2025-04-01,Senate,"Senate Appropriations: Refer Senate Bill 25-265 to the Committee of the Whole and with a recommendation that it be placed on the consent calendar.",7,0,0,0,7
2017101,1536443,2025-04-03,Senate,"Senate: Third Reading Bill",30,0,0,5,35
2017101,1540422,2025-04-08,House,"House Appropriations: Refer Senate Bill 25-265 to the Committee of the Whole.",11,0,0,0,11
2017101,1544903,2025-04-10,House,"House: Third Reading Bill",64,1,0,0,65
2017109,1532569,2025-04-01,Senate,"Senate Appropriations: Refer Senate Bill 25-221 to the Committee of the Whole and with a recommendation that it be placed on the consent calendar.",7,0,0,0,7
2017109,1536422,2025-04-03,Senate,"Senate: Third Reading Bill",30,0,0,5,35
2017109,1540425,2025-04-08,House,"House Appropriations: Refer Senate Bill 25-221 to the Committee of the Whole.",8,3,0,0,11
2017109,1543397,2025-04-10,House,"House: Third Reading Bill",62,1,0,2,65
2017117,1532535,2025-04-01,Senate,"Senate Appropriations: Refer Senate Bill 25-240 to the Committee of the Whole and with a recommendation that it be placed on the consent calendar.",7,0,0,0,7
2017117,1535964,2025-04-03,Senate,"Senate: Third Reading Bill",30,0,0,5,35
2017117,1540062,2025-04-08,House,"House Appropriations: Refer Senate Bill 25-240 to the Committee of the Whole.",8,3,0,0,11
2017117,1543448,2025-04-10,House,"House: Third Reading Bill",58,3,0,4,65
2017121,1532507,2025-04-01,Senate,"Senate Appropriations: Adopt amendment J.001",7,0,0,0,7
2017121,1532508,2025-04-01,Senate,"Senate Appropriations: Refer Senate Bill 25-229, as amended, to the Committee of the Whole.",6,1,0,0,7
2017121,1535875,2025-04-03,Senate,"Senate: Third Reading Bill",34,0,0,1,35
2017121,1539529,2025-04-08,House,"House Appropriations: Adopt amendment L.002",11,0,0,0,11
2017121,1543007,2025-04-09,House,"House: Committee of the Whole Amd (h.001)",45,18,0,2,65
2017121,1543369,2025-04-10,House,"House: Third Reading Bill",46,15,0,4,65
2017121,1545742,2025-04-08,House,"House Appropriations: Refer Senate Bill 25-229, as amended, to the Committee of the Whole.",11,0,0,0,11
2017121,1545743,2025-04-11,Senate,"Senate: House Amendments Not Concur Appt Cc",33,0,0,2,35
2017121,1549573,2025-04-15,House,"House: Conference Committee Report Byd Scp",63,1,0,1,65
2017121,1555567,2025-04-23,House,"House: Conference Committee Report Adopt",56,9,0,0,65
2017121,1555568,2025-04-23,House,"House: Conference Committee Report Repass",57,8,0,0,65
2017121,1556759,2025-04-24,Senate,"Senate: Conference Committee Report Adopt Ccr",30,0,0,5,35
2017121,1556760,2025-04-24,Senate,"Senate: Conference Committee Report Repass",31,1,0,3,35
2017127,1532527,2025-04-01,Senate,"Senate Appropriations: Refer Senate Bill 25-232 to the Committee of the Whole and with a recommendation that it be placed on the consent calendar.",7,0,0,0,7
2017127,1536472,2025-04-03,Senate,"Senate: Third Reading Bill",30,0,0,5,35
2017127,1539305,2025-04-08,House,"House Appropriations: Refer Senate Bill 25-232 to the Committee of the Whole.",11,0,0,0,11
2017127,1543396,2025-04-10,House,"House: Third Reading Bill",61,0,0,4,65
2017138,1532225,2025-04-01,Senate,"Senate Appropriations: Refer Senate Bill 25-237 to the Committee of the Whole and with a recommendation that it be placed on the consent calendar.",7,0,0,0,7
2017138,1536458,2025-04-03,Senate,"Senate: Third Reading Bill",30,3,0,2,35
2017138,1536459,2025-04-03,Senate,"Senate: Third Reading Bill",29,1,0,5,35
2017138,1539316,2025-04-08,House,"House Appropriations: Refer Senate Bill 25-237 to the Committee of the Whole.",11,0,0,0,11
2017138,1543231,2025-04-09,House,"House: Committee of the Whole Amd (h.001)",53,10,0,2,65
2017142,1532493,2025-04-01,Senate,"Senate Appropriations: Refer Senate Bill 25-233 to the Committee of the Whole and with a recommendation that it be placed on the consent calendar.",7,0,0,0,7
2017142,1536435,2025-04-03,Senate,"Senate: Third Reading Bill",30,0,0,5,35
2017142,1539410,2025-04-08,House,"House Appropriations: Refer Senate Bill 25-233 to the Committee of the Whole.",11,0,0,0,11
2017142,1543364,2025-04-10,House,"House: Third Reading Bill",61,0,0,4,65
2017148,1532517,2025-04-01,Senate,"Senate Appropriations: Refer Senate Bill 25-245 to the Committee of the Whole.",5,2,0,0,7
2017148,1536032,2025-04-03,Senate,"Senate: Third Reading Bill",34,0,0,1,35
2017148,1540125,2025-04-08,House,"House Appropriations: Refer Senate Bill 25-245 to the Committee of the Whole.",9,2,0,0,11
2017148,1543449,2025-04-10,House,"House: Third Reading Bill",43,19,0,3,65
2017155,1532233,2025-04-01,Senate,"Senate Appropriations: Refer Senate Bill 25-217 to the Committee of the Whole and with a recommendation that it be placed on the consent calendar.",7,0,0,0,7
2017155,1536476,2025-04-03,Senate,"Senate: Third Reading Bill",30,0,0,5,35
2017155,1539372,2025-04-08,House,"House Appropriations: Refer Senate Bill 25-217 to the Committee of the Whole.",11,0,0,0,11
2017155,1544645,2025-04-10,House,"House: Third Reading Bill",59,4,0,2,65
2017157,1532529,2025-04-01,Senate,"Senate Appropriations: Refer Senate Bill 25-208 to the Committee of the Whole.",5,2,0,0,7
2017157,1535866,2025-04-03,Senate,"Senate: Third Reading Bill",33,0,0,2,35
2017157,1539254,2025-04-08,House,"House Appropriations: Refer Senate Bill 25-208 to the Committee of the Whole.",11,0,0,0,11
2017157,1543309,2025-04-10,House,"House: Third Reading Bill",42,21,0,2,65
2017166,1532526,2025-04-01,Senate,"Senate Appropriations: Refer Senate Bill 25-223 to the Committee of the Whole and with a recommendation that it be placed on the consent calendar.",7,0,0,0,7
2017166,1536058,2025-04-03,Senate,"Senate: Third Reading Bill",30,0,0,5,35
2017166,1539645,2025-04-08,House,"House Appropriations: Refer Senate Bill 25-223 to the Committee of the Whole.",10,1,0,0,11
2017166,1543380,2025-04-10,House,"House: Third Reading Bill",61,2,0,2,65
2017172,1532523,2025-04-01,Senate,"Senate Appropriations: Refer Senate Bill 25-244 to the Committee of the Whole and with a recommendation that it be placed on the consent calendar.",7,0,0,0,7
2017172,1536037,2025-04-03,Senate,"Senate: Third Reading Bill",27,6,0,2,35
2017172,1536038,2025-04-03,Senate,"Senate: Third Reading Bill",29,1,0,5,35
2017172,1539413,2025-04-08,House,"House Appropriations: Refer Senate Bill 25-244 to the Committee of the Whole.",10,1,0,0,11
2017172,1544110,2025-04-10,House,"House: Third Reading Bill",42,21,0,2,65
2017181,1532502,2025-04-01,Senate,"Senate Appropriations: Adopt amendment L.001",7,0,0,0,7
2017181,1532503,2025-04-01,Senate,"Senate Appropriations: Refer Senate Bill 25-262, as amended, to the Committee of the Whole and with a recommendation that it be placed on the consent calendar.",7,0,0,0,7
2017181,1536501,2025-04-03,Senate,"Senate: Third Reading Bill",34,0,0,1,35
2017181,1540455,2025-04-08,House,"House Appropriations: Adopt amendment L.004",11,0,0,0,11
2017181,1544486,2025-04-10,House,"House: Third Reading Bill",65,0,0,0,65
2017181,1546172,2025-04-08,House,"House Appropriations: Refer Senate Bill 25-262, as amended, to the Committee of the Whole.",8,3,0,0,11
2017181,1546173,2025-04-11,Senate,"Senate: House Amendments Not Concur Appt Cc",33,0,0,2,35
2017181,1549582,2025-04-15,House,"House: Conference Committee Report Byd Scp",59,5,0,1,65
2017181,1555600,2025-04-23,House,"House: Conference Committee Report Adopt",63,1,0,1,65
2017181,1555601,2025-04-23,House,"House: Conference Committee Report Repass",61,3,0,1,65
2017181,1555602,2025-04-23,Senate,"Senate: Conference Committee Report Adopt Ccr",35,0,0,0,35
2017181,1555603,2025-04-23,Senate,"Senate: Conference Committee Report Repass",35,0,0,0,35
2017189,1532525,2025-04-01,Senate,"Senate Appropriations: Refer Senate Bill 25-214 to the Committee of the Whole.",5,2,0,0,7
2017189,1536351,2025-04-03,Senate,"Senate: Third Reading Bill",34,0,0,1,35
2017189,1539550,2025-04-08,House,"House Appropriations: Adopt amendment L.004",8,3,0,0,11
2017189,1543251,2025-04-10,House,"House: Third Reading Bill",42,21,0,2,65
2017189,1545943,2025-04-08,House,"House Appropriations: Adopt amendment L.005",11,0,0,0,11
2017189,1545944,2025-04-08,House,"House Appropriations: Refer Senate Bill 25-214, as amended, to the Committee of the Whole.",9,2,0,0,11
2017189,1545945,2025-04-11,Senate,"Senate: House Amendments Not Concur Appt Cc",33,0,0,2,35
2017189,1549436,2025-04-15,House,"House: Conference Committee Report Byd Scp",53,11,0,1,65
2017189,1555112,2025-04-23,House,"House: Conference Committee Report Adopt",44,21,0,0,65
2017189,1555113,2025-04-23,House,"House: Conference Committee Report Repass",44,21,0,0,65
2017189,1555114,2025-04-23,Senate,"Senate: Conference Committee Report Adopt Ccr",35,0,0,0,35
2017189,1555115,2025-04-23,Senate,"Senate: Conference Committee Report Repass",35,0,0,0,35
2017192,1532512,2025-04-01,Senate,"Senate Appropriations: Refer Senate Bill 25-222 to the Committee of the Whole and with a recommendation that it be placed on the consent calendar.",7,0,0,0,7
2017192,1536456,2025-04-03,Senate,"Senate: Third Reading Bill",30,0,0,5,35
2017192,1540319,2025-04-08,House,"House Appropriations: Refer Senate Bill 25-222 to the Committee of the Whole.",11,0,0,0,11
2017192,1543350,2025-04-10,House,"House: Third Reading Bill",62,1,0,2,65
2017203,1532275,2025-04-01,Senate,"Senate Appropriations: Refer Senate Bill 25-257 to the Committee of the Whole.",6,1,0,0,7
2017203,1536436,2025-04-03,Senate,"Senate: Third Reading Bill",29,5,0,1,35
2017203,1540500,2025-04-08,House,"House Appropriations: Adopt amendment L.002",11,0,0,0,11
2017203,1544022,2025-04-10,House,"House: Third Reading Bill",45,20,0,0,65
2017203,1545958,2025-04-08,House,"House Appropriations: Refer Senate Bill 25-257, as amended, to the Committee of the Whole.",8,3,0,0,11
2017203,1545959,2025-04-11,Senate,"Senate: House Amendments Not Concur Appt Cc",33,0,0,2,35
2017203,1549441,2025-04-15,House,"House: Conference Committee Report Byd Scp",62,2,0,1,65
2017203,1553501,2025-04-17,Joint,"CC_SB25-257_2025A: Adopt the first draft conference committee report for the first conference committee on SB 25-257",6,0,0,0,6
2017203,1555139,2025-04-23,House,"House: Conference Committee Report Adopt",44,21,0,0,65
2017203,1555140,2025-04-23,House,"House: Conference Committee Report Repass",44,21,0,0,65
2017203,1555141,2025-04-23,Senate,"Senate: Conference Committee Report Adopt Ccr",34,1,0,0,35
2017203,1555142,2025-04-23,Senate,"Senate: Conference Committee Report Repass",26,9,0,0,35
2017210,1532521,2025-04-01,Senate,"Senate Appropriations: Refer Senate Bill 25-218 to the Committee of the Whole and with a recommendation that it be placed on the consent calendar.",7,0,0,0,7
2017210,1535891,2025-04-03,Senate,"Senate: Third Reading Bill",30,0,0,5,35
2017210,1539839,2025-04-08,House,"House Appropriations: Refer Senate Bill 25-218 to the Committee of the Whole.",10,1,0,0,11
2017210,1543422,2025-04-10,House,"House: Third Reading Bill",58,5,0,2,65
2017215,1532256,2025-04-01,Senate,"Senate Appropriations: Refer Senate Bill 25-224 to the Committee of the Whole and with a recommendation that it be placed on the consent calendar.",7,0,0,0,7
2017215,1536430,2025-04-03,Senate,"Senate: Third Reading Bill",30,0,0,5,35
2017215,1539835,2025-04-08,House,"House Appropriations: Refer Senate Bill 25-224 to the Committee of the Whole.",11,0,0,0,11
2017215,1544641,2025-04-10,House,"House: Third Reading Bill",63,0,0,2,65
2017226,1532494,2025-04-01,Senate,"Senate Appropriations: Refer Senate Bill 25-254 to the Committee of the Whole.",5,2,0,0,7
2017226,1536490,2025-04-03,Senate,"Senate: Third Reading Bill",34,0,0,1,35
2017226,1539897,2025-04-08,House,"House Appropriations: Refer Senate Bill 25-254 to the Committee of the Whole.",7,3,0,1,11
2017226,1543427,2025-04-10,House,"House: Third Reading Bill",44,21,0,0,65
2017226,1546133,2025-04-11,Senate,"Senate: House Amendments Not Concur Appt Cc",33,0,0,2,35
2017226,1549575,2025-04-15,House,"House: Conference Committee Report Byd Scp",60,4,0,1,65
2017226,1555605,2025-04-23,House,"House: Conference Committee Report Adopt",48,17,0,0,65
2017226,1555606,2025-04-23,House,"House: Conference Committee Report Repass",44,21,0,0,65
2017226,1555607,2025-04-23,Senate,"Senate: Conference Committee Report Adopt Ccr",35,0,0,0,35
2017226,1555608,2025-04-23,Senate,"Senate: Conference Committee Report Repass",33,2,0,0,35
2017230,1532524,2025-04-01,Senate,"Senate Appropriations: Refer Senate Bill 25-219 to the Committee of the Whole and with a recommendation that it be placed on the consent calendar.",7,0,0,0,7
2017230,1536167,2025-04-03,Senate,"Senate: Third Reading Bill",30,0,0,5,35
2017230,1539502,2025-04-08,House,"House Appropriations: Refer Senate Bill 25-219 to the Committee of the Whole.",11,0,0,0,11
2017230,1543375,2025-04-10,House,"House: Third Reading Bill",60,3,0,2,65
2017236,1532520,2025-04-01,Senate,"Senate Appropriations: Refer Senate Bill 25-206 to the Committee of the Whole.",6,1,0,0,7
2017236,1534687,2025-04-02,Senate,"Senate: Committee of the Whole Cow * (s.001)",17,16,0,2,35
2017236,1534688,2025-04-02,Senate,"Senate: Committee of the Whole Cow * (s.002)",21,12,0,2,35
2017236,1534689,2025-04-02,Senate,"Senate: Committee of the Whole Cow * (s.003)",17,16,0,2,35
2017236,1534690,2025-04-02,Senate,"Senate: Committee of the Whole Cow * (s.004)",19,14,0,2,35
2017236,1534691,2025-04-02,Senate,"Senate: Committee of the Whole Cow * (s.005)",16,17,0,2,35
2017236,1536025,2025-04-03,Senate,"Senate: Third Reading Bill",22,11,0,2,35
2017236,1539409,2025-04-08,House,"House Appropriations: Adopt amendment J.084",11,0,0,0,11
2017236,1542982,2025-04-09,House,"House: Committee of the Whole Amd (h.001)",29,33,0,3,65
2017236,1542983,2025-04-09,House,"House: Committee of the Whole Amd (h.003)",23,40,0,2,65
2017236,1542984,2025-04-09,House,"House: Committee of the Whole Amd (h.004)",22,40,0,3,65
2017236,1542985,2025-04-09,House,"House: Committee of the Whole Amd (h.005)",20,43,0,2,65
2017236,1542986,2025-04-09,House,"House: Committee of the Whole Amd (h.006)",20,43,0,2,65
2017236,1542987,2025-04-09,House,"House: Committee of the Whole Amd (h.007)",24,39,0,2,65
2017236,1542988,2025-04-09,House,"House: Committee of the Whole Amd (h.008)",19,44,0,2,65
2017236,1544502,2025-04-10,House,"House: Third Reading Bill",44,21,0,0,65
2017236,1545927,2025-04-08,House,"House Appropriations: Refer Senate Bill 25-206, as amended, to the Committee of the Whole.",8,3,0,0,11
2017236,1545928,2025-04-11,Senate,"Senate: House Amendments Not Concur Appt Cc",33,0,0,2,35
2017236,1549218,2025-04-15,House,"House: Conference Committee Report Byd Scp",45,19,0,1,65
2017236,1552719,2025-04-21,House,"House: Conference Committee Report Adopt",55,9,0,1,65
2017236,1552720,2025-04-21,House,"House: Conference Committee Report Repass",43,21,0,1,65
2017236,1552721,2025-04-21,Senate,"Senate: Conference Committee Report Adopt Ccr",34,1,0,0,35
2017236,1552722,2025-04-21,Senate,"Senate: Conference Committee Report Repass",24,11,0,0,35
2017236,1553527,2025-04-17,Joint,"CC_SB25-206_2025A: Adopt the first conference committee report of the first conference committee on SB 25-206",6,0,0,0,6
2017242,1532184,2025-04-01,Senate,"Senate Appropriations: Refer Senate Bill 25-242 to the Committee of the Whole.",6,1,0,0,7
2017242,1536035,2025-04-03,Senate,"Senate: Third Reading Bill",34,0,0,1,35
2017242,1539294,2025-04-08,House,"House Appropriations: Refer Senate Bill 25-242 to the Committee of the Whole.",8,3,0,0,11
2017242,1544321,2025-04-10,House,"House: Third Reading Bill",43,18,0,4,65
2017250,1532115,2025-04-01,Senate,"Senate Appropriations: Refer Senate Bill 25-252 to the Committee of the Whole and with a recommendation that it be placed on the consent calendar.",7,0,0,0,7
2017250,1536028,2025-04-03,Senate,"Senate: Third Reading Bill",30,0,0,5,35
2017250,1539320,2025-04-08,House,"House Appropriations: Refer Senate Bill 25-252 to the Committee of the Whole.",11,0,0,0,11
2017250,1545137,2025-04-10,House,"House: Third Reading Bill",64,0,0,1,65
2017260,1532490,2025-04-01,Senate,"Senate Appropriations: Refer Senate Bill 25-248 to the Committee of the Whole and with a recommendation that it be placed on the consent calendar.",7,0,0,0,7
2017260,1536475,2025-04-03,Senate,"Senate: Third Reading Bill",30,0,0,5,35
2017260,1540449,2025-04-08,House,"House Appropriations: Refer Senate Bill 25-248 to the Committee of the Whole.",11,0,0,0,11
2017260,1545117,2025-04-10,House,"House: Third Reading Bill",63,1,0,1,65
2017262,1533170,2025-04-01,Senate,"Senate Appropriations: Refer Senate Bill 25-207 to the Committee of the Whole and with a recommendation that it be placed on the consent calendar.",7,0,0,0,7
2017262,1536417,2025-04-03,Senate,"Senate: Third Reading Bill",30,0,0,5,35
2017262,1539437,2025-04-08,House,"House Appropriations: Refer Senate Bill 25-207 to the Committee of the Whole.",11,0,0,0,11
2017262,1543297,2025-04-10,House,"House: Third Reading Bill",63,0,0,2,65
2017272,1532134,2025-04-01,Senate,"Senate Appropriations: Adopt amendment J.001",7,0,0,0,7
2017272,1532135,2025-04-01,Senate,"Senate Appropriations: Refer Senate Bill 25-270, as amended, to the Committee of the Whole.",4,3,0,0,7
2017272,1536395,2025-04-03,Senate,"Senate: Third Reading Bill",22,12,0,1,35
2017272,1540430,2025-04-08,House,"House Appropriations: Refer Senate Bill 25-270 to the Committee of the Whole.",8,3,0,0,11
2017272,1544487,2025-04-10,House,"House: Third Reading Bill",44,21,0,0,65
2017272,1544488,2025-04-10,House,"House: Third Reading Refer (hhs)",26,39,0,0,65
2017272,1546187,2025-04-11,Senate,"Senate: House Amendments Not Concur Appt Cc",33,0,0,2,35
2017272,1549588,2025-04-15,House,"House: Conference Committee Report Byd Scp",54,10,0,1,65
2017272,1554123,2025-04-17,Joint,"CC_SB25-270_2025A: Adopt the first draft conference committee report of the first conference committee on SB 25-270",6,0,0,0,6
2017272,1555633,2025-04-23,House,"House: Conference Committee Report Adopt",45,20,0,0,65
2017272,1555634,2025-04-23,House,"House: Conference Committee Report Repass",45,20,0,0,65
2017272,1555635,2025-04-23,Senate,"Senate: Conference Committee Report Adopt Ccr",30,5,0,0,35
2017272,1555636,2025-04-23,Senate,"Senate: Conference Committee Report Repass",23,12,0,0,35
2017279,1532123,2025-04-01,Senate,"Senate Appropriations: Refer Senate Bill 25-235 to the Committee of the Whole.",7,0,0,0,7
2017279,1536463,2025-04-03,Senate,"Senate: Third Reading Bill",34,0,0,1,35
2017279,1539680,2025-04-08,House,"House Appropriations: Refer Senate Bill 25-235 to the Committee of the Whole.",11,0,0,0,11
2017279,1543473,2025-04-10,House,"House: Third Reading Bill",60,1,0,4,65
2017288,1532554,2025-04-01,Senate,"Senate Appropriations: Refer Senate Bill 25-239 to the Committee of the Whole and with a recommendation that it be placed on the consent calendar.",7,0,0,0,7
2017288,1536017,2025-04-03,Senate,"Senate: Third Reading Bill",30,0,0,5,35
2017288,1540169,2025-04-08,House,"House Appropriations: Refer Senate Bill 25-239 to the Committee of the Whole.",11,0,0,0,11
2017288,1544394,2025-04-10,House,"House: Third Reading Bill",61,0,0,4,65
2017291,1532176,2025-04-01,Senate,"Senate Appropriations: Refer Senate Bill 25-249 to the Committee of the Whole and with a recommendation that it be placed on the consent calendar.",7,0,0,0,7
2017291,1536044,2025-04-03,Senate,"Senate: Third Reading Bill",30,0,0,5,35
2017291,1540193,2025-04-08,House,"House Appropriations: Refer Senate Bill 25-249 to the Committee of the Whole.",9,2,0,0,11
2017291,1544666,2025-04-10,House,"House: Third Reading Bill",59,6,0,0,65
2017303,1532545,2025-04-01,Senate,"Senate Appropriations: Refer Senate Bill 25-216 to the Committee of the Whole and with a recommendation that it be placed on the consent calendar.",7,0,0,0,7
2017303,1536429,2025-04-03,Senate,"Senate: Third Reading Bill",30,0,0,5,35
2017303,1539295,2025-04-08,House,"House Appropriations: Refer Senate Bill 25-216 to the Committee of the Whole.",11,0,0,0,11
2017303,1543360,2025-04-10,House,"House: Third Reading Bill",63,0,0,2,65
2017307,1532578,2025-04-01,Senate,"Senate Appropriations: Refer Senate Bill 25-211 to the Committee of the Whole.",6,1,0,0,7
2017307,1536461,2025-04-03,Senate,"Senate: Third Reading Bill",34,0,0,1,35
2017307,1540447,2025-04-08,House,"House Appropriations: Refer Senate Bill 25-211 to the Committee of the Whole.",11,0,0,0,11
2017307,1544733,2025-04-10,House,"House: Third Reading Bill",63,0,0,2,65
2017311,1532540,2025-04-01,Senate,"Senate Appropriations: Refer Senate Bill 25-228 to the Committee of the Whole.",5,2,0,0,7
2017311,1535907,2025-04-03,Senate,"Senate: Third Reading Bill",34,0,0,1,35
2017311,1539364,2025-04-08,House,"House Appropriations: Refer Senate Bill 25-228 to the Committee of the Whole.",8,3,0,0,11
2017311,1543378,2025-04-10,House,"House: Third Reading Bill",41,22,0,2,65
2017311,1545857,2025-04-11,Senate,"Senate: House Amendments Not Concur Appt Cc",33,0,0,2,35
2017311,1549592,2025-04-15,House,"House: Conference Committee Report Byd Scp",63,1,0,1,65
2017311,1553533,2025-04-17,Joint,"CC_SB25-228_2025A: Adopt the first draft conference committee report of the first conference committee on SB 25-228",6,0,0,0,6
2017311,1555392,2025-04-23,House,"House: Conference Committee Report Adopt",44,21,0,0,65
2017311,1555393,2025-04-23,House,"House: Conference Committee Report Repass",44,21,0,0,65
2017311,1555394,2025-04-23,Senate,"Senate: Conference Committee Report Adopt Ccr",35,0,0,0,35
2017311,1555395,2025-04-23,Senate,"Senate: Conference Committee Report Repass",27,8,0,0,35
2017324,1532259,2025-04-01,Senate,"Senate Appropriations: Refer Senate Bill 25-267 to the Committee of the Whole and with a recommendation that it be placed on the consent calendar.",7,0,0,0,7
2017324,1536467,2025-04-03,Senate,"Senate: Third Reading Bill",30,0,0,5,35
2017324,1539671,2025-04-08,House,"House Appropriations: Refer Senate Bill 25-267 to the Committee of the Whole.",10,1,0,0,11
2017324,1544598,2025-04-10,House,"House: Third Reading Bill",64,1,0,0,65
2017326,1532572,2025-04-01,Senate,"Senate Appropriations: Refer Senate Bill 25-226 to the Committee of the Whole.",6,1,0,0,7
2017326,1536450,2025-04-03,Senate,"Senate: Third Reading Bill",34,0,0,1,35
2017326,1540499,2025-04-08,House,"House Appropriations: Adopt amendment L.001",11,0,0,0,11
2017326,1543363,2025-04-10,House,"House: Third Reading Bill",57,6,0,2,65
2017326,1545884,2025-04-08,House,"House Appropriations: Refer Senate Bill 25-226, as amended, to the Committee of the Whole.",10,1,0,0,11
2017326,1545885,2025-04-11,Senate,"Senate: House Amendments Not Concur Appt Cc",33,0,0,2,35
2017326,1549586,2025-04-15,House,"House: Conference Committee Report Byd Scp",61,3,0,1,65
2017326,1554098,2025-04-17,Joint,"CC_SB25-226_2025A: Adopt the first draft conference committee report of the first conference committee on SB 25-226",6,0,0,0,6
2017326,1555593,2025-04-23,House,"House: Conference Committee Report Adopt",53,12,0,0,65
2017326,1555594,2025-04-23,House,"House: Conference Committee Report Repass",50,15,0,0,65
2017326,1555595,2025-04-23,Senate,"Senate: Conference Committee Report Adopt Ccr",35,0,0,0,35
2017326,1555596,2025-04-23,Senate,"Senate: Conference Committee Report Repass",35,0,0,0,35
2017331,1532575,2025-04-01,Senate,"Senate Appropriations: Adopt amendment J.001",7,0,0,0,7
2017331,1532576,2025-04-01,Senate,"Senate Appropriations: Refer Senate Bill 25-266, as amended, to the Committee of the Whole and with a recommendation that it be placed on the consent calendar.",7,0,0,0,7
2017331,1536446,2025-04-03,Senate,"Senate: Third Reading Bill",34,0,0,1,35
2017331,1539965,2025-04-08,House,"House Appropriations: Refer Senate Bill 25-266 to the Committee of the Whole.",11,0,0,0,11
2017331,1544756,2025-04-10,House,"House: Third Reading Bill",65,0,0,0,65
2017337,1532562,2025-04-01,Senate,"Senate Appropriations: Refer Senate Bill 25-268 to the Committee of the Whole.",6,1,0,0,7
2017337,1536469,2025-04-03,Senate,"Senate: Third Reading Bill",34,0,0,1,35
2017337,1540472,2025-04-08,House,"House Appropriations: Adopt amendment L.002",11,0,0,0,11
2017337,1542990,2025-04-09,House,"House: Committee of the Whole Amd (h.002)",26,37,0,2,65
2017337,1544483,2025-04-10,House,"House: Third Reading Bill",39,26,0,0,65
2017337,1546141,2025-04-08,House,"House Appropriations: Refer Senate Bill 25-268, as amended, to the Committee of the Whole.",11,0,0,0,11
2017337,1546142,2025-04-11,Senate,"Senate: House Amendments Not Concur Appt Cc",33,0,0,2,35
2017337,1549501,2025-04-15,House,"House: Conference Committee Report Byd Scp",46,18,0,1,65
2017337,1553735,2025-04-17,Joint,"CC_SB25-268_2025A: Adopt the first draft conference committee report of the first conference committee on SB 25-268",6,0,0,0,6
2017337,1555155,2025-04-23,House,"House: Conference Committee Report Adopt",37,27,0,1,65
2017337,1555156,2025-04-23,House,"House: Conference Committee Report Repass",29,36,0,0,65
2017337,1555571,2025-04-23,House,"House: Conference Committee Report Repass",39,25,0,1,65
2017337,1555572,2025-04-23,House,"House: MISC Recon",45,19,0,1,65
2017337,1557288,2025-04-24,Senate,"Senate: Conference Committee Report Adopt Ccr",32,0,0,3,35
2017337,1557289,2025-04-24,Senate,"Senate: Conference Committee Report Repass",32,0,0,3,35
2017348,1532542,2025-04-01,Senate,"Senate Appropriations: Adopt amendment J.001",7,0,0,0,7
2017348,1532543,2025-04-01,Senate,"Senate Appropriations: Refer Senate Bill 25-251, as amended, to the Committee of the Whole and with a recommendation that it be placed on the consent calendar.",7,0,0,0,7
2017348,1536051,2025-04-03,Senate,"Senate: Third Reading Bill",32,2,0,1,35
2017348,1539779,2025-04-08,House,"House Appropriations: Refer Senate Bill 25-251 to the Committee of the Whole.",11,0,0,0,11
2017348,1545116,2025-04-10,House,"House: Third Reading Bill",22,43,0,0,65
2017353,1532343,2025-04-01,Senate,"Senate Appropriations: Refer Senate Bill 25-250 to the Committee of the Whole and with a recommendation that it be placed on the consent calendar.",7,0,0,0,7
2017353,1536050,2025-04-03,Senate,"Senate: Third Reading Bill",30,0,0,5,35
2017353,1539678,2025-04-08,House,"House Appropriations: Refer Senate Bill 25-250 to the Committee of the Whole.",11,0,0,0,11
2017353,1544305,2025-04-10,House,"House: Third Reading Bill",64,1,0,0,65
2017357,1532537,2025-04-01,Senate,"Senate Appropriations: Adopt amendment L.001",7,0,0,0,7
2017357,1532538,2025-04-01,Senate,"Senate Appropriations: Refer Senate Bill 25-247, as amended, to the Committee of the Whole and with a recommendation that it be placed on the consent calendar.",7,0,0,0,7
2017357,1536031,2025-04-03,Senate,"Senate: Third Reading Bill",34,0,0,1,35
2017357,1540495,2025-04-08,House,"House Appropriations: Refer Senate Bill 25-247 to the Committee of the Whole.",11,0,0,0,11
2017357,1545120,2025-04-10,House,"House: Third Reading Bill",62,2,0,1,65
2017372,1532533,2025-04-01,Senate,"Senate Appropriations: Refer Senate Bill 25-256 to the Committee of the Whole and with a recommendation that it be placed on the consent calendar.",7,0,0,0,7
2017372,1535873,2025-04-03,Senate,"Senate: Third Reading Bill",30,0,0,5,35
2017372,1540452,2025-04-08,House,"House Appropriations: Refer Senate Bill 25-256 to the Committee of the Whole.",10,1,0,0,11
2017372,1543005,2025-04-09,House,"House: Committee of the Whole Amd (h.001)",19,44,0,2,65
2017372,1545132,2025-04-10,House,"House: Third Reading Bill",43,22,0,0,65
2017376,1532549,2025-04-01,Senate,"Senate Appropriations: Refer Senate Bill 25-263 to the Committee of the Whole.",7,0,0,0,7
2017376,1536448,2025-04-03,Senate,"Senate: Third Reading Bill",34,0,0,1,35
2017376,1540475,2025-04-08,House,"House Appropriations: Refer Senate Bill 25-263 to the Committee of the Whole.",8,3,0,0,11
2017376,1545125,2025-04-10,House,"House: Third Reading Bill",45,20,0,0,65
2017379,1532534,2025-04-01,Senate,"Senate Appropriations: Refer Senate Bill 25-210 to the Committee of the Whole.",6,1,0,0,7
2017379,1536433,2025-04-03,Senate,"Senate: Third Reading Bill",34,0,0,1,35
2017379,1540305,2025-04-08,House,"House Appropriations: Refer Senate Bill 25-210 to the Committee of the Whole.",9,2,0,0,11
2017379,1543399,2025-04-10,House,"House: Third Reading Bill",63,0,0,2,65
2017391,1532278,2025-04-01,Senate,"Senate Appropriations: Refer Senate Bill 25-212 to the Committee of the Whole.",6,1,0,0,7
2017391,1535654,2025-04-03,Senate,"Senate: Third Reading Bill",33,1,0,1,35
2017391,1540021,2025-04-08,House,"House Appropriations: Adopt amendment L.002",11,0,0,0,11
2017391,1543352,2025-04-10,House,"House: Third Reading Bill",58,5,0,2,65
2017391,1546169,2025-04-08,House,"House Appropriations: Refer Senate Bill 25-212, as amended, to the Committee of the Whole.",11,0,0,0,11
2017391,1546170,2025-04-11,Senate,"Senate: House Amendments Not Concur Appt Cc",33,0,0,2,35
2017391,1549581,2025-04-15,House,"House: Conference Committee Report Byd Scp",63,1,0,1,65
2017391,1554105,2025-04-17,Joint,"CC_SB25-212_2025A: Adopt first draft conference committee report of the first conference committee on SB 25-212",5,0,0,1,6
2017391,1555625,2025-04-23,House,"House: Conference Committee Report Adopt",64,0,0,1,65
2017391,1555626,2025-04-23,House,"House: Conference Committee Report Repass",61,3,0,1,65
2017391,1555627,2025-04-23,Senate,"Senate: Conference Committee Report Adopt Ccr",35,0,0,0,35
2017391,1555628,2025-04-23,Senate,"Senate: Conference Committee Report Repass",35,0,0,0,35
2017396,1532531,2025-04-01,Senate,"Senate Appropriations: Adopt amendment L.001",7,0,0,0,7
2017396,1532532,2025-04-01,Senate,"Senate Appropriations: Refer Senate Bill 25-258, as amended, to the Committee of the Whole and with a recommendation that it be placed on the consent calendar.",7,0,0,0,7
2017396,1536442,2025-04-03,Senate,"Senate: Third Reading Bill",34,0,0,1,35
2017396,1539468,2025-04-08,House,"House Appropriations: Adopt amendment L.002",11,0,0,0,11
2017396,1543886,2025-04-10,House,"House: Third Reading Bill",65,0,0,0,65
2017396,1546011,2025-04-08,House,"House Appropriations: Refer Senate Bill 25-258, as amended, to the Committee of the Whole.",11,0,0,0,11
2017396,1546012,2025-04-11,Senate,"Senate: House Amendments Not Concur Appt Cc",33,0,0,2,35
2017396,1549451,2025-04-15,House,"House: Conference Committee Report Byd Scp",62,2,0,1,65
2017396,1553456,2025-04-17,Joint,"CC_SB25-258_2025A: Adopt the first draft conference committee report of the first conference committee report on SB 25-258",6,0,0,0,6
2017396,1555118,2025-04-23,House,"House: Conference Committee Report Adopt",56,9,0,0,65
2017396,1555119,2025-04-23,House,"House: Conference Committee Report Repass",59,6,0,0,65
2017396,1555533,2025-04-23,Senate,"Senate: Conference Committee Report Adopt Ccr",35,0,0,0,35
2017396,1555534,2025-04-23,Senate,"Senate: Conference Committee Report Repass",35,0,0,0,35
2017402,1532084,2025-04-01,Senate,"Senate Appropriations: Adopt amendment L.001",7,0,0,0,7
2017402,1532085,2025-04-01,Senate,"Senate Appropriations: Refer Senate Bill 25-264, as amended, to the Committee of the Whole and with a recommendation that it be placed on the consent calendar.",7,0,0,0,7
2017402,1535842,2025-04-03,Senate,"Senate: Third Reading Bill",34,0,0,1,35
2017402,1539421,2025-04-08,House,"House Appropriations: Refer Senate Bill 25-264 to the Committee of the Whole.",9,2,0,0,11
2017402,1543874,2025-04-10,House,"House: Third Reading Bill",54,11,0,0,65
2017410,1532511,2025-04-01,Senate,"Senate Appropriations: Refer Senate Bill 25-238 to the Committee of the Whole and with a recommendation that it be placed on the consent calendar.",7,0,0,0,7
2017410,1535973,2025-04-03,Senate,"Senate: Third Reading Bill",30,0,0,5,35
2017410,1539367,2025-04-08,House,"House Appropriations: Refer Senate Bill 25-238 to the Committee of the Whole.",11,0,0,0,11
2017410,1543392,2025-04-10,House,"House: Third Reading Bill",49,12,0,4,65
2017416,1532530,2025-04-01,Senate,"Senate Appropriations: Refer Senate Bill 25-230 to the Committee of the Whole and with a recommendation that it be placed on the consent calendar.",7,0,0,0,7
2017416,1536042,2025-04-03,Senate,"Senate: Third Reading Bill",30,0,0,5,35
2017416,1539948,2025-04-08,House,"House Appropriations: Refer Senate Bill 25-230 to the Committee of the Whole.",10,1,0,0,11
2017416,1543426,2025-04-10,House,"House: Third Reading Bill",58,3,0,4,65
2017421,1532488,2025-04-01,Senate,"Senate Appropriations: Refer Senate Bill 25-231 to the Committee of the Whole.",6,1,0,0,7
2017421,1535984,2025-04-03,Senate,"Senate: Third Reading Bill",34,0,0,1,35
2017421,1539321,2025-04-08,House,"House Appropriations: Refer Senate Bill 25-231 to the Committee of the Whole.",11,0,0,0,11
2017421,1543379,2025-04-10,House,"House: Third Reading Bill",51,10,0,4,65
2017426,1532518,2025-04-01,Senate,"Senate Appropriations: Refer Senate Bill 25-261 to the Committee of the Whole.",7,0,0,0,7
2017426,1536520,2025-04-03,Senate,"Senate: Third Reading Bill",34,0,0,1,35
2017426,1539485,2025-04-08,House,"House Appropriations: Adopt amendment J.001",11,0,0,0,11
2017426,1544012,2025-04-10,House,"House: Third Reading Bill",64,1,0,0,65
2017426,1545922,2025-04-08,House,"House Appropriations: Refer Senate Bill 25-261, as amended, to the Committee of the Whole.",9,2,0,0,11
2017426,1545923,2025-04-11,Senate,"Senate: House Amendments Not Concur Appt Cc",33,0,0,2,35
2017426,1549465,2025-04-15,House,"House: Conference Committee Report Byd Scp",53,11,0,1,65
2017426,1555108,2025-04-23,House,"House: Conference Committee Report Adopt",34,30,0,1,65
2017426,1555109,2025-04-23,House,"House: Conference Committee Report Repass",41,23,0,1,65
2017426,1555513,2025-04-23,Senate,"Senate: Conference Committee Report Adopt Ccr",35,0,0,0,35
2017426,1555514,2025-04-23,Senate,"Senate: Conference Committee Report Repass",35,0,0,0,35
2017440,1532506,2025-04-01,Senate,"Senate Appropriations: Refer Senate Bill 25-225 to the Committee of the Whole and with a recommendation that it be placed on the consent calendar.",7,0,0,0,7
2017440,1535924,2025-04-03,Senate,"Senate: Third Reading Bill",30,0,0,5,35
2017440,1540135,2025-04-08,House,"House Appropriations: Refer Senate Bill 25-225 to the Committee of the Whole.",11,0,0,0,11
2017440,1543409,2025-04-10,House,"House: Third Reading Bill",63,0,0,2,65
2017442,1532489,2025-04-01,Senate,"Senate Appropriations: Refer Senate Bill 25-253 to the Committee of the Whole and with a recommendation that it be placed on the consent calendar.",7,0,0,0,7
2017442,1536470,2025-04-03,Senate,"Senate: Third Reading Bill",30,0,0,5,35
2017442,1540457,2025-04-08,House,"House Appropriations: Refer Senate Bill 25-253 to the Committee of the Whole.",8,2,0,1,11
2017442,1544269,2025-04-10,House,"House: Third Reading Bill",47,18,0,0,65
2017449,1532495,2025-04-01,Senate,"Senate Appropriations: Refer Senate Bill 25-243 to the Committee of the Whole and with a recommendation that it be placed on the consent calendar.",7,0,0,0,7
2017449,1535653,2025-04-03,Senate,"Senate: Third Reading Bill",30,0,0,5,35
2017449,1539566,2025-04-08,House,"House Appropriations: Refer Senate Bill 25-243 to the Committee of the Whole.",11,0,0,0,11
2017449,1543371,2025-04-10,House,"House: Third Reading Bill",62,0,0,3,65
2017456,1532505,2025-04-01,Senate,"Senate Appropriations: Refer Senate Bill 25-269 to the Committee of the Whole.",6,1,0,0,7
2017456,1536047,2025-04-03,Senate,"Senate: Third Reading Bill",34,0,0,1,35
2017456,1540070,2025-04-08,House,"House Appropriations: Refer Senate Bill 25-269 to the Committee of the Whole.",8,3,0,0,11
2017456,1545146,2025-04-10,House,"House: Third Reading Bill",45,20,0,0,65
2017464,1532516,2025-04-01,Senate,"Senate Appropriations: Refer Senate Bill 25-220 to the Committee of the Whole and with a recommendation that it be placed on the consent calendar.",7,0,0,0,7
2017464,1536457,2025-04-03,Senate,"Senate: Third Reading Bill",30,0,0,5,35
2017464,1539693,2025-04-08,House,"House Appropriations: Refer Senate Bill 25-220 to the Committee of the Whole.",10,1,0,0,11
2017464,1543373,2025-04-10,House,"House: Third Reading Bill",56,7,0,2,65
2017469,1532129,2025-04-01,Senate,"Senate Appropriations: Refer Senate Bill 25-236 to the Committee of the Whole and with a recommendation that it be placed on the consent calendar.",7,0,0,0,7
2017469,1536416,2025-04-03,Senate,"Senate: Third Reading Bill",30,0,0,5,35
2017469,1540066,2025-04-08,House,"House Appropriations: Refer Senate Bill 25-236 to the Committee of the Whole.",11,0,0,0,11
2017469,1543412,2025-04-10,House,"House: Third Reading Bill",60,1,0,4,65
2017476,1532522,2025-04-01,Senate,"Senate Appropriations: Refer Senate Bill 25-209 to the Committee of the Whole and with a recommendation that it be placed on the consent calendar.",7,0,0,0,7
2017476,1536473,2025-04-03,Senate,"Senate: Third Reading Bill",30,0,0,5,35
2017476,1540168,2025-04-08,House,"House Appropriations: Refer Senate Bill 25-209 to the Committee of the Whole.",10,1,0,0,11
2017476,1544386,2025-04-10,House,"House: Third Reading Bill",45,18,0,2,65
2017483,1532528,2025-04-01,Senate,"Senate Appropriations: Refer Senate Bill 25-259 to the Committee of the Whole and with a recommendation that it be placed on the consent calendar.",7,0,0,0,7
2017483,1536451,2025-04-03,Senate,"Senate: Third Reading Bill",31,2,0,2,35
2017483,1536452,2025-04-03,Senate,"Senate: Third Reading Bill",30,0,0,5,35
2017483,1539902,2025-04-08,House,"House Appropriations: Refer Senate Bill 25-259 to the Committee of the Whole.",9,2,0,0,11
2017483,1545126,2025-04-10,House,"House: Third Reading Bill",53,12,0,0,65
2017490,1532519,2025-04-01,Senate,"Senate Appropriations: Refer Senate Bill 25-215 to the Committee of the Whole and with a recommendation that it be placed on the consent calendar.",7,0,0,0,7
2017490,1536227,2025-04-03,Senate,"Senate: Third Reading Bill",30,0,0,5,35
2017490,1539493,2025-04-08,House,"House Appropriations: Refer Senate Bill 25-215 to the Committee of the Whole.",11,0,0,0,11
2017490,1543359,2025-04-10,House,"House: Third Reading Bill",58,5,0,2,65
2017494,1532498,2025-04-01,Senate,"Senate Appropriations: Refer Senate Bill 25-213 to the Committee of the Whole.",6,1,0,0,7
2017494,1536440,2025-04-03,Senate,"Senate: Third Reading Bill",34,0,0,1,35
2017494,1539559,2025-04-08,House,"House Appropriations: Refer Senate Bill 25-213 to the Committee of the Whole.",9,2,0,0,11
2017494,1543441,2025-04-10,House,"House: Third Reading Bill",43,20,0,2,65
2017522,1547508,2025-04-14,House,"House Finance: Refer House Bill 25-1314 to the Committee of the Whole.",8,5,0,0,13
2017522,1550629,2025-04-16,House,"House: Third Reading Bill",43,22,0,0,65
2017522,1554899,2025-04-22,Senate,"Senate Finance: Refer House Bill 25-1314 to the Committee of the Whole.",6,3,0,0,9
2017522,1559254,2025-04-28,Senate,"Senate: Third Reading Bill",21,13,0,1,35
2017537,1547804,2025-04-07,House,"House Finance: Adopt amendment L.001 (Attachment L).",7,6,0,0,13
2017537,1547805,2025-04-07,House,"House Finance: Adopt amendment L.002 (Attachment M).",6,7,0,0,13
2017537,1547806,2025-04-07,House,"House Finance: Refer House Joint Resolution 25-1023, as amended, to the full House with a favorable recommendation.",7,6,0,0,13
2017549,1547110,2025-04-14,House,"House State, Civic, Military, & Veterans Affairs: Adopt amendment L.001 (Attachment A).",11,0,0,0,11
2017549,1551076,2025-04-14,House,"House State, Civic, Military, & Veterans Affairs: Refer House Bill 25-1313, as amended, to the Committee of the Whole.",9,2,0,0,11
2017549,1552498,2025-04-21,House,"House: Third Reading Bill",46,17,0,2,65
2017549,1560356,2025-04-29,Senate,"Senate State, Veterans, & Military Affairs: Refer House Bill 25-1313 to the Committee of the Whole and with a recommendation that it be placed on the consent calendar.",4,0,0,1,5
2017549,1564475,2025-05-02,Senate,"Senate: Third Reading Bill",32,2,0,1,35
2017566,1538661,2025-04-07,House,"House State, Civic, Military, & Veterans Affairs: Refer HCR25-1002 to the Committee of the Whole.",5,6,0,0,11
2017566,1548181,2025-04-07,House,"House State, Civic, Military, & Veterans Affairs: Postpone HCR25-1002 indefinitely using a reversal of the previous roll call. There was no objection to the use of the reverse roll call, therefore, the bill was postponed indefinitely.",6,5,0,0,11
2017576,1538322,2025-04-07,House,"House State, Civic, Military, & Veterans Affairs: Adopt amendment L.001 (Attachment C).",10,1,0,0,11
2017576,1548346,2025-04-07,House,"House State, Civic, Military, & Veterans Affairs: Adopt amendment L.003 (Attachment D).",9,2,0,0,11
2017576,1548347,2025-04-07,House,"House State, Civic, Military, & Veterans Affairs: Adopt amendment L.004 (Attachment E).",11,0,0,0,11
2017576,1548348,2025-04-07,House,"House State, Civic, Military, & Veterans Affairs: Adopt amendment L.005 (Attachment F).",9,2,0,0,11
2017576,1548349,2025-04-07,House,"House State, Civic, Military, & Veterans Affairs: Adopt amendment L.006 (Attachment G).",9,2,0,0,11
2017576,1548350,2025-04-07,House,"House State, Civic, Military, & Veterans Affairs: Adopt amendment L.007 (Attachment H).",11,0,0,0,11
2017576,1548351,2025-04-07,House,"House State, Civic, Military, & Veterans Affairs: Refer House Bill 25-1315, as amended, to the Committee on Appropriations.",9,2,0,0,11
2017576,1551113,2025-04-17,House,"House Appropriations: Adopt amendment J.001",11,0,0,0,11
2017576,1554016,2025-04-17,House,"House Appropriations: Refer House Bill 25-1315, as amended, to the Committee of the Whole.",9,2,0,0,11
2017576,1554017,2025-04-22,House,"House: Committee of the Whole Amd (h.001)",9,47,0,9,65
2017576,1556313,2025-04-23,House,"House: Third Reading Bill",55,9,0,1,65
2017576,1560730,2025-04-29,Senate,"Senate State, Veterans, & Military Affairs: Refer House Bill 25-1315, as amended, to the Committee on Appropriations.",5,0,0,0,5
2017576,1563574,2025-05-01,Senate,"Senate Appropriations: Adopt amendment J.002",7,0,0,0,7
2017576,1563575,2025-05-01,Senate,"Senate Appropriations: Refer House Bill 25-1315, as amended, to the Committee of the Whole and with a recommendation that it be placed on the consent calendar.",7,0,0,0,7
2017576,1564568,2025-05-02,Senate,"Senate: Third Reading Bill",32,2,0,1,35
2017576,1564717,2025-05-02,House,"House: Senate Amendments Concur",59,2,0,4,65
2017576,1564718,2025-05-02,House,"House: Senate Amendments Repass",53,8,0,4,65
2017576,1567297,2025-04-29,Senate,"Senate State, Veterans, & Military Affairs: Adopt amendment L.022 (Attachment F).",5,0,0,0,5
2017576,1567298,2025-04-29,Senate,"Senate State, Veterans, & Military Affairs: Refer House Bill 25-1315, as amended, to the Committee on Appropriations.",5,0,0,0,5
2018389,1543533,2025-04-10,Senate,"Senate Business, Labor, & Technology: Refer Senate Bill 25-271 to the Committee of the Whole and with a recommendation that it be placed on the consent calendar.",6,0,0,1,7
2018389,1547600,2025-04-14,Senate,"Senate: Third Reading Bill",33,0,0,2,35
2018389,1553158,2025-04-21,House,"House State, Civic, Military, & Veterans Affairs: Refer Senate Bill 25-271 to the Committee of the Whole.",11,0,0,0,11
2018389,1562571,2025-04-30,House,"House: Third Reading Bill",65,0,0,0,65
2018494,1552157,2025-04-14,Senate,"Senate Transportation & Energy: Adopt amendment L.001",9,0,0,0,9
2018494,1552158,2025-04-14,Senate,"Senate Transportation & Energy: Refer Senate Bill 25-272, as amended, to the Committee on Appropriations.",7,0,0,2,9
2018494,1560104,2025-04-29,Senate,"Senate Appropriations: Refer Senate Bill 25-272 to the Committee of the Whole.",6,1,0,0,7
2018494,1562129,2025-04-30,Senate,"Senate: Third Reading Bill",30,5,0,0,35
2018494,1564022,2025-05-01,House,"House Finance: Refer Senate Bill 25-272 to the Committee on Appropriations.",8,3,0,2,13
2018494,1564773,2025-05-03,House,"House Appropriations: Refer Senate Bill 25-272 to the Committee of the Whole.",8,3,0,0,11
2018494,1565080,2025-05-05,House,"House: Third Reading Bill",43,21,0,1,65
2018613,1541224,2025-04-08,House,"House Health & Human Services: Refer House Bill 25-1316 to the Committee of the Whole.",13,0,0,0,13
2018613,1552717,2025-04-21,House,"House: Third Reading Bill",58,6,0,1,65
2018613,1562549,2025-04-30,Senate,"Senate Health & Human Services: Refer House Bill 25-1316 to the Committee of the Whole and with a recommendation that it be placed on the consent calendar.",9,0,0,0,9
2018613,1564500,2025-05-02,Senate,"Senate: Third Reading Bill",34,0,0,1,35
2018615,1540648,2025-04-08,House,"House Health & Human Services: Refer House Bill 25-1317 to the Committee of the Whole.",13,0,0,0,13
2018615,1559571,2025-04-28,House,"House: Third Reading Bill",64,0,0,1,65
2018615,1563570,2025-05-01,Senate,"Senate State, Veterans, & Military Affairs: Refer House Bill 25-1317 to the Committee of the Whole and with a recommendation that it be placed on the consent calendar.",4,0,0,1,5
2018615,1564697,2025-05-02,Senate,"Senate: Third Reading Bill",34,0,0,1,35
2019243,1538628,2025-04-07,House,"House State, Civic, Military, & Veterans Affairs: Adopt amendment L.001 (Attachment J).",7,3,0,1,11
2019243,1548495,2025-04-07,House,"House State, Civic, Military, & Veterans Affairs: Adopt amendment L.002 (Attachment K).",9,1,0,1,11
2019243,1548496,2025-04-07,House,"House State, Civic, Military, & Veterans Affairs: Adopt amendment L.003 (Attachment L).",7,3,0,1,11
2019243,1548497,2025-04-07,House,"House State, Civic, Military, & Veterans Affairs: Adopt amendment L.004 (Attachment M).",8,2,0,1,11
2019243,1548498,2025-04-07,House,"House State, Civic, Military, & Veterans Affairs: Refer House Bill 25-1319, as amended, to the Committee on Appropriations.",9,2,0,0,11
2019243,1550898,2025-04-17,House,"House Appropriations: Adopt amendment J.001",11,0,0,0,11
2019243,1553400,2025-04-17,House,"House Appropriations: Refer House Bill 25-1319, as amended, to the Committee of the Whole.",9,2,0,0,11
2019243,1555604,2025-04-23,House,"House: Third Reading Bill",52,12,0,1,65
2019243,1560891,2025-04-29,Senate,"Senate State, Veterans, & Military Affairs: Refer House Bill 25-1319, as amended, to the Committee on Appropriations.",4,1,0,0,5
2019243,1563495,2025-05-01,Senate,"Senate Appropriations: Refer House Bill 25-1319 to the Committee of the Whole and with a recommendation that it be placed on the consent calendar.",7,0,0,0,7
2019243,1564487,2025-05-02,Senate,"Senate: Third Reading Bill",30,4,0,1,35
2019243,1564733,2025-05-02,House,"House: Senate Amendments Concur",40,21,0,4,65
2019243,1564734,2025-05-02,House,"House: Senate Amendments Repass",47,14,0,4,65
2019243,1567033,2025-04-29,Senate,"Senate State, Veterans, & Military Affairs: Adopt amendment L.021 (Attachment I).",5,0,0,0,5
2019243,1567034,2025-04-29,Senate,"Senate State, Veterans, & Military Affairs: Refer House Bill 25-1319, as amended, to the Committee on Appropriations.",4,1,0,0,5
2019287,1539159,2025-04-07,House,"House Education: Refer House Bill 25-1320, as amended, to the Committee on Appropriations.",13,0,0,0,13
2019287,1548142,2025-04-15,House,"House Appropriations: Adopt amendment L.011",11,0,0,0,11
2019287,1551119,2025-04-17,House,"House: Third Reading Amd (l.024)",59,3,0,3,65
2019287,1551120,2025-04-17,House,"House: Third Reading Bill",57,5,0,3,65
2019287,1551121,2025-04-17,House,"House: Third Reading Perm",51,11,0,3,65
2019287,1560183,2025-04-15,House,"House Appropriations: Adopt amendment J.002",11,0,0,0,11
2019287,1560184,2025-04-15,House,"House Appropriations: Adopt amendment L.012",11,0,0,0,11
2019287,1560185,2025-04-15,House,"House Appropriations: Adopt amendment L.014",11,0,0,0,11
2019287,1560186,2025-04-15,House,"House Appropriations: Adopt amendment L.015",11,0,0,0,11
2019287,1560187,2025-04-15,House,"House Appropriations: Refer House Bill 25-1320, as amended, to the Committee of the Whole.",8,3,0,0,11
2019287,1562536,2025-04-30,Senate,"Senate Education: Refer House Bill 25-1320, as amended, to the Committee on Appropriations.",7,0,0,0,7
2019287,1563633,2025-05-01,Senate,"Senate Appropriations: Adopt amendment J.003",7,0,0,0,7
2019287,1563634,2025-05-01,Senate,"Senate Appropriations: Adopt amendment J.005",5,2,0,0,7
2019287,1563635,2025-05-01,Senate,"Senate Appropriations: Adopt amendment L.038",4,3,0,0,7
2019287,1563636,2025-05-01,Senate,"Senate Appropriations: Adopt amendment L.045",5,2,0,0,7
2019287,1563637,2025-05-01,Senate,"Senate Appropriations: Refer House Bill 25-1320, as amended, to the Committee of the Whole.",7,0,0,0,7
2019287,1565787,2025-05-06,Senate,"Senate: Third Reading Amend (l.053)",35,0,0,0,35
2019287,1565788,2025-05-06,Senate,"Senate: Third Reading Bill",35,0,0,0,35
2019287,1567764,2025-05-07,House,"House: Senate Amendments Concur",59,5,0,1,65
2019287,1567765,2025-05-07,House,"House: Senate Amendments Repass",57,8,0,0,65
2019333,1536523,2025-04-03,House,"House Agriculture, Water & Natural Resources: Refer House Bill 25-1318 to the Committee on Appropriations.",12,0,0,1,13
2019333,1548049,2025-04-15,House,"House Appropriations: Refer House Bill 25-1318 to the Committee of the Whole.",9,2,0,0,11
2019333,1552663,2025-04-21,House,"House: Third Reading Bill",50,13,0,2,65
2019333,1557680,2025-04-24,Senate,"Senate Agriculture & Natural Resources: Refer House Bill 25-1318 to the Committee on Appropriations.",7,0,0,0,7
2019333,1561833,2025-04-30,Senate,"Senate Appropriations: Refer House Bill 25-1318 to the Committee of the Whole and with a recommendation that it be placed on the consent calendar.",7,0,0,0,7
2019333,1563538,2025-05-01,Senate,"Senate: Third Reading Bill",33,2,0,0,35
2020028,1549776,2025-04-16,Senate,"Senate Health & Human Services: Adopt amendment L.003 (Attachment A).",9,0,0,0,9
2020028,1553386,2025-04-22,Senate,"Senate: Third Reading Bill",32,3,0,0,35
2020028,1560462,2025-04-16,Senate,"Senate Health & Human Services: Refer Senate Bill 25-273, as amended, to the Committee of the Whole.",8,1,0,0,9
2020028,1562649,2025-04-30,House,"House Judiciary: Refer Senate Bill 25-273 to the Committee of the Whole.",10,1,0,0,11
2020028,1564755,2025-05-03,House,"House: Third Reading Bill",53,9,0,3,65
2020068,1544517,2025-04-10,Senate,"Senate State, Veterans, & Military Affairs: Refer Senate Bill 25-275 to the Committee of the Whole and with a recommendation that it be placed on the consent calendar.",5,0,0,0,5
2020068,1547525,2025-04-14,Senate,"Senate: Third Reading Bill",33,0,0,2,35
2020068,1553113,2025-04-21,House,"House State, Civic, Military, & Veterans Affairs: Adopt amendment L.001 (Attachment E).",11,0,0,0,11
2020068,1562548,2025-04-30,House,"House: Third Reading Bill",64,1,0,0,65
2020068,1564425,2025-05-01,Senate,"Senate: House Amendments Concur",32,0,0,3,35
2020068,1564426,2025-05-01,Senate,"Senate: House Amendments Repass",32,0,0,3,35
2020068,1565408,2025-04-21,House,"House State, Civic, Military, & Veterans Affairs: Refer Senate Bill 25-275, as amended, to the Committee of the Whole.",11,0,0,0,11
2020116,1543480,2025-04-10,Senate,"Senate Finance: Refer Senate Bill 25-274 to the Committee of the Whole and with a recommendation that it be placed on the consent calendar.",8,0,0,1,9
2020116,1547117,2025-04-14,Senate,"Senate: Third Reading Bill",33,0,0,2,35
2020116,1553202,2025-04-21,House,"House Finance: Refer Senate Bill 25-274 to the Committee of the Whole.",13,0,0,0,13
2020116,1562602,2025-04-30,House,"House: Third Reading Bill",64,0,0,1,65
2020770,1540782,2025-04-08,Senate,"Senate State, Veterans, & Military Affairs: Refer Senate Bill 25-276, as amended, to the Committee on Appropriations.",3,2,0,0,5
2020770,1545813,2025-04-11,Senate,"Senate Appropriations: Adopt amendment J.001",7,0,0,0,7
2020770,1545814,2025-04-11,Senate,"Senate Appropriations: Refer Senate Bill 25-276, as amended, to the Committee of the Whole.",4,3,0,0,7
2020770,1549229,2025-04-15,Senate,"Senate: Committee of the Whole Cow * (s.001)",12,21,0,2,35
2020770,1552680,2025-04-21,Senate,"Senate: Third Reading Amend (l.036)",35,0,0,0,35
2020770,1552681,2025-04-21,Senate,"Senate: Third Reading Amend (l.037)",35,0,0,0,35
2020770,1552682,2025-04-21,Senate,"Senate: Third Reading Amend (l.038)",35,0,0,0,35
2020770,1552683,2025-04-21,Senate,"Senate: Third Reading Amend (l.041)",35,0,0,0,35
2020770,1552684,2025-04-21,Senate,"Senate: Third Reading Amend (l.042)",35,0,0,0,35
2020770,1552685,2025-04-21,Senate,"Senate: Third Reading Bill",22,13,0,0,35
2020770,1559335,2025-04-28,House,"House Judiciary: Refer Senate Bill 25-276, as amended, to the Committee on Appropriations.",7,4,0,0,11
2020770,1561735,2025-04-30,House,"House Appropriations: Adopt amendment J.002",11,0,0,0,11
2020770,1562357,2025-04-30,House,"House Appropriations: Refer Senate Bill 25-276, as amended, to the Committee of the Whole.",6,5,0,0,11
2020770,1564682,2025-05-02,House,"House: Committee of the Whole Amd (h.001)",22,41,0,2,65
2020770,1564683,2025-05-02,House,"House: Committee of the Whole Amd (h.002)",23,39,0,3,65
2020770,1564684,2025-05-02,House,"House: Committee of the Whole Amd (h.003)",23,39,0,3,65
2020770,1564771,2025-05-03,House,"House: Third Reading Bill",42,21,0,2,65
2020770,1564965,2025-05-05,Senate,"Senate: House Amendments Concur",35,0,0,0,35
2020770,1564966,2025-05-05,Senate,"Senate: House Amendments Repass",23,12,0,0,35
2020829,1550240,2025-04-16,Senate,"Senate Transportation & Energy: Adopt amendment L.003",9,0,0,0,9
2020829,1552171,2025-04-16,Senate,"Senate Transportation & Energy: Adopt amendment L.004",7,2,0,0,9
2020829,1552172,2025-04-16,Senate,"Senate Transportation & Energy: Adopt amendment L.005",9,0,0,0,9
2020829,1552173,2025-04-16,Senate,"Senate Transportation & Energy: Adopt amendment L.006",9,0,0,0,9
2020829,1552174,2025-04-16,Senate,"Senate Transportation & Energy: Adopt amendment L.007",9,0,0,0,9
2020829,1552175,2025-04-16,Senate,"Senate Transportation & Energy: Refer Senate Bill 25-280, as amended, to the Committee on Appropriations.",6,3,0,0,9
2020895,1539570,2025-04-08,House,"House Appropriations: Adopt amendment J.001",11,0,0,0,11
2020895,1545480,2025-04-08,House,"House Appropriations: Refer House Bill 25-1321, as amended, to the Committee of the Whole.",7,4,0,0,11
2020895,1548708,2025-04-15,House,"House: Committee of the Whole Amd (h.001)",24,40,0,1,65
2020895,1548709,2025-04-15,House,"House: Committee of the Whole Amd (h.002)",22,42,0,1,65
2020895,1549861,2025-04-16,House,"House: Third Reading Bill",43,22,0,0,65
2020895,1553431,2025-04-22,Senate,"Senate Appropriations: Adopt amendment L.009",3,4,0,0,7
2020895,1553432,2025-04-22,Senate,"Senate Appropriations: Adopt amendment L.010",3,4,0,0,7
2020895,1553433,2025-04-22,Senate,"Senate Appropriations: Refer House Bill 25-1321 to the Committee of the Whole.",4,3,0,0,7
2020895,1558196,2025-04-25,Senate,"Senate: Third Reading Bill",23,12,0,0,35
2020898,1544673,2025-04-10,House,"House: RESOLUTIONS Res",61,0,0,4,65
2020898,1547241,2025-04-14,Senate,"Senate: Consideration of Resolutions Resolution",33,0,0,2,35
2020901,1555023,2025-04-23,House,"House: RESOLUTIONS Res",63,0,0,2,65
2020901,1564750,2025-05-02,Senate,"Senate: Consideration of Resolutions Resolution",35,0,0,0,35
2020904,1547367,2025-04-14,House,"House Agriculture, Water & Natural Resources: Postpone House Bill 25-1323 indefinitely.",12,0,0,1,13
2020908,1549103,2025-04-15,House,"House Judiciary: Refer House Bill 25-1322, as amended, to the Committee of the Whole.",11,0,0,0,11
2020908,1558284,2025-04-25,House,"House: Third Reading Bill",42,20,0,3,65
2020908,1565389,2025-05-05,Senate,"Senate Judiciary: Refer House Bill 25-1322 to the Committee of the Whole.",5,2,0,0,7
2020908,1565786,2025-05-06,Senate,"Senate: Third Reading Bill",24,11,0,0,35
2020911,1549328,2025-04-15,House,"House Transportation, Housing & Local Government: Refer House Bill 25-1324 to the Committee of the Whole.",12,0,0,1,13
2020911,1558298,2025-04-25,House,"House: Third Reading Bill",62,1,0,2,65
2020911,1564068,2025-05-01,Senate,"Senate State, Veterans, & Military Affairs: Refer House Bill 25-1324 to the Committee of the Whole and with a recommendation that it be placed on the consent calendar.",5,0,0,0,5
2020911,1564505,2025-05-02,Senate,"Senate: Third Reading Bill",34,0,0,1,35
2020914,1549749,2025-04-16,House,"House: RESOLUTIONS Res",64,0,0,1,65
2020914,1564748,2025-05-02,Senate,"Senate: Consideration of Resolutions Resolution",35,0,0,0,35
2020917,1547697,2025-04-14,House,"House: MEMORIALS Mem",64,0,0,1,65
2020917,1550319,2025-04-16,Senate,"Senate: Consideration of Memorials Memorial",31,0,0,4,35
2020920,1538263,2025-04-07,House,"House: RESOLUTIONS Res",59,0,0,6,65
2020920,1546239,2025-04-11,Senate,"Senate: Consideration of Resolutions Resolution",33,0,0,2,35
2020922,1557998,2025-04-25,House,"House: RESOLUTIONS Res",60,1,0,4,65
2020922,1564408,2025-05-01,Senate,"Senate: Consideration of Resolutions Resolution",32,0,0,3,35
2020924,1544568,2025-04-10,Senate,"Senate Business, Labor, & Technology: Adopt amendment L.001",7,0,0,0,7
2020924,1544569,2025-04-10,Senate,"Senate Business, Labor, & Technology: Refer Senate Bill 25-277, as amended, to the Committee of the Whole and with a recommendation that it be placed on the consent calendar.",7,0,0,0,7
2020924,1548926,2025-04-15,Senate,"Senate: Third Reading Bill",34,0,0,1,35
2020924,1557433,2025-04-24,House,"House Business Affairs & Labor: Refer Senate Bill 25-277 to the Committee of the Whole.",10,0,0,3,13
2020924,1558299,2025-04-25,House,"House: Third Reading Bill",60,3,0,2,65
2020925,1543321,2025-04-10,Senate,"Senate State, Veterans, & Military Affairs: Adopt amendment L.001",5,0,0,0,5
2020925,1547621,2025-04-14,Senate,"Senate: Third Reading Amend (l.003)",33,0,0,2,35
2020925,1547622,2025-04-14,Senate,"Senate: Third Reading Bill",33,0,0,2,35
2020925,1560648,2025-04-29,House,"House State, Civic, Military, & Veterans Affairs: Refer Senate Bill 25-279 to the Committee of the Whole.",10,1,0,0,11
2020925,1564043,2025-05-01,House,"House: Third Reading Bill",59,2,0,4,65
2020925,1564678,2025-04-10,Senate,"Senate State, Veterans, & Military Affairs: Refer Senate Bill 25-279, as amended, to the Committee of the Whole and with a recommendation that it be placed on the consent calendar.",5,0,0,0,5
2020926,1543819,2025-04-10,Senate,"Senate Health & Human Services: Refer Senate Bill 25-278 to the Committee on Appropriations.",8,0,0,1,9
2020926,1553378,2025-04-22,Senate,"Senate Appropriations: Refer Senate Bill 25-278 to the Committee of the Whole and with a recommendation that it be placed on the consent calendar.",7,0,0,0,7
2020926,1555077,2025-04-23,Senate,"Senate: Third Reading Bill",35,0,0,0,35
2020926,1558997,2025-04-28,House,"House Health & Human Services: Refer Senate Bill 25-278 to the Committee on Appropriations.",13,0,0,0,13
2020926,1561746,2025-04-30,House,"House Appropriations: Adopt amendment J.002",11,0,0,0,11
2020926,1562343,2025-04-30,House,"House Appropriations: Refer Senate Bill 25-278, as amended, to the Committee of the Whole.",11,0,0,0,11
2020926,1563541,2025-05-01,House,"House: Third Reading Bill",62,0,0,3,65
2020926,1564711,2025-05-02,Senate,"Senate: House Amendments Concur",35,0,0,0,35
2020926,1564712,2025-05-02,Senate,"Senate: House Amendments Repass",35,0,0,0,35
2021241,1553012,2025-04-21,Senate,"Senate Judiciary: Adopt amendment L.013 (Attachment A)",7,0,0,0,7
2021241,1558391,2025-04-21,Senate,"Senate Judiciary: Adopt amendment L.004 (Attachment C)",7,0,0,0,7
2021241,1558392,2025-04-21,Senate,"Senate Judiciary: Adopt amendment L.005 (Attachment F)",7,0,0,0,7
2021241,1558393,2025-04-21,Senate,"Senate Judiciary: Adopt amendment L.008 (Attachment B)",6,1,0,0,7
2021241,1558394,2025-04-21,Senate,"Senate Judiciary: Adopt amendment L.009 (Attachment D)",7,0,0,0,7
2021241,1558395,2025-04-21,Senate,"Senate Judiciary: Adopt amendment L.010 (Attachment E)",7,0,0,0,7
2021241,1558396,2025-04-21,Senate,"Senate Judiciary: Refer Senate Bill 25-281, as amended, to the Committee on Appropriations.",6,1,0,0,7
2021241,1560253,2025-04-29,Senate,"Senate Appropriations: Adopt amendment L.014",7,0,0,0,7
2021241,1560254,2025-04-29,Senate,"Senate Appropriations: Refer Senate Bill 25-281, as amended, to the Committee of the Whole and with a recommendation that it be placed on the consent calendar.",7,0,0,0,7
2021241,1561994,2025-04-30,Senate,"Senate: Third Reading Bill",35,0,0,0,35
2021241,1564769,2025-05-03,House,"House Judiciary: Refer Senate Bill 25-281 to the Committee of the Whole.",11,0,0,0,11
2021241,1565386,2025-05-05,House,"House: Third Reading Bill",59,5,0,1,65
2021243,1544454,2025-04-10,Senate,"Senate: Consideration of Resolutions Resolution",33,0,0,2,35
2021249,1545161,2025-04-10,Senate,"Senate Agriculture & Natural Resources: Refer Senate Bill 25-283 to the Committee on Finance.",6,0,0,1,7
2021249,1549264,2025-04-15,Senate,"Senate Finance: Refer Senate Bill 25-283 to the Committee on Appropriations.",9,0,0,0,9
2021249,1551606,2025-04-17,Senate,"Senate Appropriations: Refer Senate Bill 25-283 to the Committee of the Whole and with a recommendation that it be placed on the consent calendar.",7,0,0,0,7
2021249,1555355,2025-04-23,Senate,"Senate: Third Reading Bill",33,2,0,0,35
2021249,1560988,2025-04-29,House,"House Finance: Refer Senate Bill 25-283 to the Committee on Appropriations.",11,2,0,0,13
2021249,1564004,2025-05-01,House,"House Appropriations: Refer Senate Bill 25-283 to the Committee of the Whole.",9,2,0,0,11
2021249,1564665,2025-05-02,House,"House: Third Reading Bill",57,7,0,1,65
2021252,1543539,2025-04-10,Senate,"Senate State, Veterans, & Military Affairs: Adopt amendment L.001 (Attachment B).",5,0,0,0,5
2021252,1548894,2025-04-15,Senate,"Senate: Third Reading Bill",33,1,0,1,35
2021252,1560647,2025-04-29,House,"House State, Civic, Military, & Veterans Affairs: Refer Senate Bill 25-282 to the Committee of the Whole.",9,2,0,0,11
2021252,1563677,2025-05-01,House,"House: Third Reading Bill",52,11,0,2,65
2021252,1564630,2025-04-10,Senate,"Senate State, Veterans, & Military Affairs: Refer Senate Bill 25-282, as amended, to the Committee of the Whole.",4,1,0,0,5
2021259,1544459,2025-04-10,Senate,"Senate: Consideration of Resolutions Resolution",33,0,0,2,35
2021265,1555698,2025-04-23,Senate,"Senate Education: Refer Senate Bill 25-284, as amended, to the Committee of the Whole.",4,3,0,0,7
2021265,1560326,2025-04-29,Senate,"Senate: Third Reading Bill",20,12,0,3,35
2021272,1549274,2025-04-15,Senate,"Senate Finance: Refer Senate Bill 25-285 to the Committee on Appropriations.",8,0,0,1,9
2021272,1558034,2025-04-25,Senate,"Senate Appropriations: Adopt amendment L.004",7,0,0,0,7
2021272,1558841,2025-04-28,Senate,"Senate: Third Reading Bill",26,8,0,1,35
2021272,1559805,2025-04-25,Senate,"Senate Appropriations: Adopt amendment L.005",7,0,0,0,7
2021272,1559806,2025-04-25,Senate,"Senate Appropriations: Refer Senate Bill 25-285, as amended, to the Committee of the Whole.",5,2,0,0,7
2021272,1560478,2025-04-29,House,"House Finance: Refer Senate Bill 25-285 to the Committee on Appropriations.",11,2,0,0,13
2021272,1563536,2025-05-01,House,"House Appropriations: Refer Senate Bill 25-285 to the Committee of the Whole.",7,4,0,0,11
2021272,1564753,2025-05-03,House,"House: Third Reading Bill",45,17,0,3,65
2021290,1553101,2025-04-21,House,"House State, Civic, Military, & Veterans Affairs: Referred to Full House for final action.",8,3,0,0,11
2021299,1549067,2025-04-15,House,"House Health & Human Services: Refer House Bill 25-1326 to the Committee of the Whole.",13,0,0,0,13
2021299,1559253,2025-04-28,House,"House: Third Reading Bill",64,0,0,1,65
2021299,1564051,2025-05-01,Senate,"Senate State, Veterans, & Military Affairs: Refer House Bill 25-1326 to the Committee of the Whole and with a recommendation that it be placed on the consent calendar.",5,0,0,0,5
2021299,1564508,2025-05-02,Senate,"Senate: Third Reading Bill",34,0,0,1,35
2021310,1549694,2025-04-16,Senate,"Senate: Consideration of Resolutions Resolution",27,5,0,3,35
2021320,1547490,2025-04-14,House,"House State, Civic, Military, & Veterans Affairs: Refer House Bill 25-1325 to the Committee of the Whole.",8,0,0,3,11
2021320,1558288,2025-04-25,House,"House: Third Reading Bill",62,1,0,2,65
2021320,1563750,2025-05-01,Senate,"Senate State, Veterans, & Military Affairs: Refer House Bill 25-1325 to the Committee of the Whole and with a recommendation that it be placed on the consent calendar.",3,0,0,2,5
2021320,1564503,2025-05-02,Senate,"Senate: Third Reading Bill",34,0,0,1,35
2021329,1553032,2025-04-21,House,"House: RESOLUTIONS Res",64,0,0,1,65
2021329,1564434,2025-05-01,Senate,"Senate: Consideration of Resolutions Resolution",32,0,0,3,35
2021334,1553205,2025-04-21,Senate,"Senate: Consideration of Resolutions Resolution",35,0,0,0,35
2021334,1562669,2025-04-30,House,"House: RESOLUTIONS Amd (l.002)",63,0,0,2,65
2021334,1562670,2025-04-30,House,"House: RESOLUTIONS Res",63,0,0,2,65
2021334,1564431,2025-05-01,Senate,"Senate: House Amendments Concur",32,0,0,3,35
2021334,1564432,2025-05-01,Senate,"Senate: House Amendments Repass",32,0,0,3,35
2021813,1563693,2025-05-01,Senate,"Senate State, Veterans, & Military Affairs: Postpone SR25-009 indefinitely using a reversal of the previous roll call. There was no objection to the use of the reverse roll call, therefore, the bill was postponed indefinitely.",3,2,0,0,5
2021813,1567325,2025-05-01,Senate,"Senate State, Veterans, & Military Affairs: Postpone SR25-009 indefinitely using a reversal of the previous roll call. There was no objection to the use of the reverse roll call, therefore, the bill was postponed indefinitely.",3,2,0,0,5
2022323,1554004,2025-04-21,Senate,"Senate Judiciary: Adopt amendment L.001 (Attachment G)",7,0,0,0,7
2022323,1558292,2025-04-21,Senate,"Senate Judiciary: Adopt amendment L.002 (Attachment H)",7,0,0,0,7
2022323,1558293,2025-04-21,Senate,"Senate Judiciary: Adopt amendment L.003 (Attachment I)",7,0,0,0,7
2022323,1558294,2025-04-21,Senate,"Senate Judiciary: Refer Senate Bill 25-288, as amended, to the Committee of the Whole.",7,0,0,0,7
2022323,1560032,2025-04-29,Senate,"Senate: Third Reading Bill",31,0,0,4,35
2022323,1564781,2025-05-03,House,"House Judiciary: Refer Senate Bill 25-288, as amended, to the Committee of the Whole.",8,3,0,0,11
2022323,1565069,2025-05-05,House,"House: Committee of the Whole Amd (h.001)",28,36,0,1,65
2022323,1565070,2025-05-05,House,"House: Committee of the Whole Amd (h.002)",14,50,0,1,65
2022323,1565874,2025-05-06,House,"House: Third Reading Bill",43,22,0,0,65
2022323,1565875,2025-05-06,Senate,"Senate: House Amendments Concur",35,0,0,0,35
2022323,1565876,2025-05-06,Senate,"Senate: House Amendments Repass",35,0,0,0,35
2022364,1550229,2025-04-16,Senate,"Senate Transportation & Energy: Adopt amendment L.002",9,0,0,0,9
2022364,1552149,2025-04-16,Senate,"Senate Transportation & Energy: Adopt amendment L.004",9,0,0,0,9
2022364,1552150,2025-04-16,Senate,"Senate Transportation & Energy: Refer Senate Bill 25-286, as amended, to the Committee on Appropriations.",9,0,0,0,9
2022364,1559829,2025-04-29,Senate,"Senate Appropriations: Adopt amendment L.005",6,1,0,0,7
2022364,1559830,2025-04-29,Senate,"Senate Appropriations: Refer Senate Bill 25-286, as amended, to the Committee of the Whole.",5,2,0,0,7
2022364,1562259,2025-04-30,Senate,"Senate: Third Reading Bill",28,7,0,0,35
2022364,1563992,2025-05-01,House,"House Finance: Refer Senate Bill 25-286 to the Committee of the Whole.",7,4,0,2,13
2022364,1564757,2025-05-03,House,"House: Third Reading Bill",43,20,0,2,65
2022364,1565399,2025-05-05,Senate,"Senate: House Amendments Concur",35,0,0,0,35
2022364,1565400,2025-05-05,Senate,"Senate: House Amendments Not Concur Appt Cc",35,0,0,0,35
2022364,1565401,2025-05-05,Senate,"Senate: House Amendments Repass",26,9,0,0,35
2022396,1551421,2025-04-17,Senate,"Senate State, Veterans, & Military Affairs: Refer Senate Bill 25-287 to the Committee of the Whole and with a recommendation that it be placed on the consent calendar.",5,0,0,0,5
2022396,1555622,2025-04-23,Senate,"Senate: Third Reading Bill",32,3,0,0,35
2022396,1560650,2025-04-29,House,"House State, Civic, Military, & Veterans Affairs: Refer Senate Bill 25-287 to the Committee of the Whole.",8,3,0,0,11
2022396,1564064,2025-05-01,House,"House: Third Reading Bill",43,20,0,2,65
2022415,1554876,2025-04-22,House,"House Health & Human Services: Refer House Bill 25-1328, as amended, to the Committee on Appropriations.",10,3,0,0,13
2022415,1558212,2025-04-25,House,"House Appropriations: Adopt amendment J.001",11,0,0,0,11
2022415,1558912,2025-04-28,House,"House: Third Reading Bill",43,22,0,0,65
2022415,1560461,2025-04-25,House,"House Appropriations: Refer House Bill 25-1328, as amended, to the Committee of the Whole.",7,4,0,0,11
2022415,1564060,2025-05-01,Senate,"Senate Business, Labor, & Technology: Refer House Bill 25-1328 to the Committee on Appropriations.",4,3,0,0,7
2022415,1564484,2025-05-02,Senate,"Senate Appropriations: Refer House Bill 25-1328 to the Committee of the Whole.",4,3,0,0,7
2022415,1566775,2025-04-22,House,"House Health & Human Services: Adopt amendment L.002 (Attachment D).",13,0,0,0,13
2022415,1566776,2025-04-22,House,"House Health & Human Services: Adopt amendment L.003 (Attachment E).",13,0,0,0,13
2022415,1566777,2025-04-22,House,"House Health & Human Services: Adopt amendment L.004 (Attachment F).",13,0,0,0,13
2022415,1566778,2025-04-22,House,"House Health & Human Services: Refer House Bill 25-1328, as amended, to the Committee on Appropriations.",10,3,0,0,13
2022415,1566779,2025-05-06,Senate,"Senate: Third Reading Bill",23,12,0,0,35
2022416,1547851,2025-04-14,House,"House State, Civic, Military, & Veterans Affairs: Adopt amendment L.001 (Attachment M).",11,0,0,0,11
2022416,1551349,2025-04-14,House,"House State, Civic, Military, & Veterans Affairs: Refer House Bill 25-1327, as amended, to the Committee of the Whole.",8,3,0,0,11
2022416,1552583,2025-04-21,House,"House: Committee of the Whole Amd (h.001)",25,38,0,2,65
2022416,1552584,2025-04-21,House,"House: Committee of the Whole Amd (h.002)",23,40,0,2,65
2022416,1555518,2025-04-23,House,"House: Third Reading Bill",42,22,0,1,65
2022416,1555519,2025-04-23,House,"House: Third Reading Perm",22,43,0,0,65
2022416,1557248,2025-04-24,Senate,"Senate State, Veterans, & Military Affairs: Adopt amendment L.010 (Attachment F).",2,3,0,0,5
2022416,1564498,2025-05-02,Senate,"Senate: Third Reading Bill",22,12,0,1,35
2022416,1564735,2025-04-24,Senate,"Senate State, Veterans, & Military Affairs: Refer House Bill 25-1327 to the Committee of the Whole.",3,2,0,0,5
2022416,1564736,2025-05-02,House,"House: Senate Amendments Concur",43,18,0,4,65
2022416,1564737,2025-05-02,House,"House: Senate Amendments Repass",42,19,0,4,65
2023018,1556227,2025-04-23,Senate,"Senate Health & Human Services: Adopt amendment L.001 (Attachment H).",9,0,0,0,9
2023018,1560241,2025-04-29,Senate,"Senate: Third Reading Amend (l.008)",32,0,0,3,35
2023018,1560242,2025-04-29,Senate,"Senate: Third Reading Bill",29,3,0,3,35
2023018,1563283,2025-04-30,House,"House Health & Human Services: Refer Senate Bill 25-289, as amended, to the Committee of the Whole.",11,2,0,0,13
2023018,1563686,2025-04-23,Senate,"Senate Health & Human Services: Adopt amendment L.002 (Attachment I).",9,0,0,0,9
2023018,1563687,2025-04-23,Senate,"Senate Health & Human Services: Adopt amendment L.003 (Attachment J).",9,0,0,0,9
2023018,1563688,2025-04-23,Senate,"Senate Health & Human Services: Refer Senate Bill 25-289, as amended, to the Committee of the Whole and with a recommendation that it be placed on the consent calendar.",8,0,0,1,9
2023018,1564672,2025-05-02,House,"House: Third Reading Bill",48,15,0,2,65
2023018,1565796,2025-05-06,Senate,"Senate: House Amendments Concur",35,0,0,0,35
2023018,1565797,2025-05-06,Senate,"Senate: House Amendments Repass",30,5,0,0,35
2023022,1555470,2025-04-23,Senate,"Senate: Consideration of Resolutions Resolution",35,0,0,0,35
2023022,1557284,2025-04-24,House,"House: RESOLUTIONS Res",63,0,0,2,65
2023025,1553070,2025-04-21,House,"House State, Civic, Military, & Veterans Affairs: Postpone HCR25-1003 indefinitely using a reversal of the previous roll call. There was no objection to the use of the reverse roll call, therefore, the bill was postponed indefinitely.",8,3,0,0,11
2023025,1566824,2025-04-21,House,"House State, Civic, Military, & Veterans Affairs: Postpone HCR25-1003 indefinitely using a reversal of the previous roll call. There was no objection to the use of the reverse roll call, therefore, the bill was postponed indefinitely.",8,3,0,0,11
2023558,1550886,2025-04-16,House,"House Business Affairs & Labor: Postpone House Bill 25-1331 indefinitely.",10,0,0,3,13
2023559,1549190,2025-04-15,House,"House Judiciary: Refer House Bill 25-1329, as amended, to the Committee of the Whole.",11,0,0,0,11
2023559,1558175,2025-04-25,House,"House: Third Reading Bill",46,16,0,3,65
2023559,1564955,2025-05-05,Senate,"Senate Appropriations: Refer House Bill 25-1329 to the Committee of the Whole and with a recommendation that it be placed on the consent calendar.",7,0,0,0,7
2023559,1564956,2025-05-05,Senate,"Senate Judiciary: Refer House Bill 25-1329 to the Committee on Appropriations.",6,1,0,0,7
2023559,1565668,2025-05-06,Senate,"Senate: Third Reading Bill",32,3,0,0,35
2023560,1550283,2025-04-16,House,"House Business Affairs & Labor: Refer House Bill 25-1330 to the Committee of the Whole.",12,0,0,1,13
2023560,1552638,2025-04-21,House,"House: Third Reading Bill",63,1,0,1,65
2023560,1557260,2025-04-24,Senate,"Senate Business, Labor, & Technology: Refer House Bill 25-1330 to the Committee of the Whole.",6,0,0,1,7
2023560,1564698,2025-05-02,Senate,"Senate: Third Reading Bill",34,0,0,1,35
2023560,1567271,2025-05-07,House,"House: Senate Amendments Concur",62,2,0,1,65
2023560,1567272,2025-05-07,House,"House: Senate Amendments Repass",63,1,0,1,65
2023620,1549483,2025-04-15,Senate,"Senate State, Veterans, & Military Affairs: Adopt amendment L.001 (Attachment B).",2,3,0,0,5
2023620,1556444,2025-04-24,Senate,"Senate: Third Reading Concurrent Resolution",23,12,0,0,35
2023620,1558320,2025-04-15,Senate,"Senate State, Veterans, & Military Affairs: Refer SCR25-002 to the Committee of the Whole.",3,2,0,0,5
2023852,1551990,2025-04-17,Senate,"Senate Health & Human Services: Refer Senate Bill 25-290 to the Committee on Finance.",8,0,0,1,9
2023852,1554882,2025-04-22,Senate,"Senate Finance: Adopt amendment L.003 (Attachment A)",9,0,0,0,9
2023852,1558036,2025-04-25,Senate,"Senate Appropriations: Adopt amendment L.006",7,0,0,0,7
2023852,1558266,2025-04-22,Senate,"Senate Finance: Adopt amendment L.004 (Attachment B)",9,0,0,0,9
2023852,1558267,2025-04-22,Senate,"Senate Finance: Refer Senate Bill 25-290, as amended, to the Committee on Appropriations.",9,0,0,0,9
2023852,1558803,2025-04-28,Senate,"Senate: Third Reading Amend (l.010)",31,3,0,1,35
2023852,1558804,2025-04-28,Senate,"Senate: Third Reading Bill",33,1,0,1,35
2023852,1560060,2025-04-25,Senate,"Senate Appropriations: Adopt amendment J.001",7,0,0,0,7
2023852,1560061,2025-04-25,Senate,"Senate Appropriations: Adopt amendment L.008",7,0,0,0,7
2023852,1560062,2025-04-25,Senate,"Senate Appropriations: Refer Senate Bill 25-290, as amended, to the Committee of the Whole.",7,0,0,0,7
2023852,1562560,2025-04-30,House,"House Health & Human Services: Refer Senate Bill 25-290, as amended, to the Committee on Appropriations.",12,1,0,0,13
2023852,1564804,2025-05-05,House,"House Appropriations: Adopt amendment L.017",11,0,0,0,11
2023852,1565030,2025-05-05,House,"House Appropriations: Adopt amendment L.021",2,8,0,1,11
2023852,1565031,2025-05-05,House,"House Appropriations: Refer Senate Bill 25-290, as amended, to the Committee of the Whole.",6,4,0,1,11
2023852,1566233,2025-05-06,House,"House: Committee of the Whole Amd (h.001)",19,38,0,8,65
2023852,1567709,2025-05-07,House,"House: Third Reading Bill",54,11,0,0,65
2023852,1567710,2025-05-07,Senate,"Senate: House Amendments Concur",34,1,0,0,35
2023852,1567711,2025-05-07,Senate,"Senate: House Amendments Repass",34,1,0,0,35
2024227,1556205,2025-04-23,Senate,"Senate Health & Human Services: Adopt amendment L.001 (Attachment F).",9,0,0,0,9
2024227,1559989,2025-04-29,Senate,"Senate Appropriations: Adopt amendment J.001",7,0,0,0,7
2024227,1559990,2025-04-29,Senate,"Senate Appropriations: Adopt amendment L.002",7,0,0,0,7
2024227,1559991,2025-04-29,Senate,"Senate Appropriations: Refer Senate Bill 25-297, as amended, to the Committee of the Whole.",5,2,0,0,7
2024227,1562074,2025-04-30,Senate,"Senate: Third Reading Bill",23,12,0,0,35
2024227,1564013,2025-04-23,Senate,"Senate Health & Human Services: Refer Senate Bill 25-297, as amended, to the Committee on Appropriations.",7,2,0,0,9
2024227,1564014,2025-05-01,House,"House Finance: Refer Senate Bill 25-297 to the Committee on Appropriations.",10,2,0,1,13
2024227,1564777,2025-05-03,House,"House Appropriations: Refer Senate Bill 25-297 to the Committee of the Whole.",7,4,0,0,11
2024227,1565883,2025-05-06,House,"House: Third Reading Bill",43,22,0,0,65
2024228,1553521,2025-04-22,Senate,"Senate Appropriations: Refer Senate Bill 25-292 to the Committee of the Whole.",6,1,0,0,7
2024228,1558309,2025-04-25,Senate,"Senate: Third Reading Bill",25,10,0,0,35
2024228,1560657,2025-04-29,House,"House Appropriations: Refer Senate Bill 25-292 to the Committee of the Whole.",9,2,0,0,11
2024228,1564760,2025-05-03,House,"House: Third Reading Bill",43,20,0,2,65
2024230,1554115,2025-04-22,Senate,"Senate Appropriations: Refer Senate Bill 25-294 to the Committee of the Whole and with a recommendation that it be placed on the consent calendar.",7,0,0,0,7
2024230,1555647,2025-04-23,Senate,"Senate: Third Reading Bill",33,2,0,0,35
2024230,1559922,2025-04-29,House,"House Appropriations: Refer Senate Bill 25-294 to the Committee of the Whole.",8,3,0,0,11
2024230,1562590,2025-04-30,House,"House: Third Reading Bill",53,12,0,0,65
2024232,1554113,2025-04-22,Senate,"Senate Appropriations: Refer Senate Bill 25-295 to the Committee of the Whole.",6,1,0,0,7
2024232,1558297,2025-04-25,Senate,"Senate: Third Reading Bill",28,7,0,0,35
2024232,1560644,2025-04-29,House,"House Appropriations: Refer Senate Bill 25-295 to the Committee of the Whole.",8,3,0,0,11
2024232,1564762,2025-05-03,House,"House: Third Reading Bill",43,20,0,2,65
2024234,1553207,2025-04-22,Senate,"Senate Appropriations: Refer Senate Bill 25-291 to the Committee of the Whole and with a recommendation that it be placed on the consent calendar.",7,0,0,0,7
2024234,1555563,2025-04-23,Senate,"Senate: Third Reading Bill",27,8,0,0,35
2024234,1559865,2025-04-29,House,"House Appropriations: Refer Senate Bill 25-291 to the Committee of the Whole.",9,2,0,0,11
2024234,1562577,2025-04-30,House,"House: Third Reading Bill",46,19,0,0,65
2024236,1554107,2025-04-22,Senate,"Senate Appropriations: Refer Senate Bill 25-293 to the Committee of the Whole.",7,0,0,0,7
2024236,1554108,2025-04-22,Senate,"Senate: Committee of the Whole Adopt Report",35,0,0,0,35
2024236,1555609,2025-04-23,Senate,"Senate: Third Reading Bill",28,7,0,0,35
2024236,1559851,2025-04-29,House,"House Appropriations: Refer Senate Bill 25-293 to the Committee of the Whole.",8,3,0,0,11
2024236,1562579,2025-04-30,House,"House: Third Reading Bill",44,21,0,0,65
2024237,1557590,2025-04-24,Senate,"Senate Health & Human Services: Refer Senate Bill 25-296 to the Committee of the Whole and with a recommendation that it be placed on the consent calendar.",9,0,0,0,9
2024237,1558815,2025-04-28,Senate,"Senate: Third Reading Bill",33,1,0,1,35
2024237,1562661,2025-04-30,House,"House Health & Human Services: Refer Senate Bill 25-296 to the Committee of the Whole.",12,0,0,1,13
2024237,1564551,2025-05-02,House,"House: Third Reading Bill",59,5,0,1,65
2024679,1553170,2025-04-21,Senate,"Senate Judiciary: Refer Senate Bill 25-298 to the Committee of the Whole and with a recommendation that it be placed on the consent calendar.",7,0,0,0,7
2024679,1558286,2025-04-25,Senate,"Senate: Third Reading Bill",35,0,0,0,35
2024679,1562627,2025-04-30,House,"House Judiciary: Refer Senate Bill 25-298 to the Committee of the Whole.",11,0,0,0,11
2024679,1564677,2025-05-02,House,"House: Third Reading Bill",64,0,0,1,65
2025034,1555467,2025-04-23,Senate,"Senate Transportation & Energy: Adopt amendment L.001",9,0,0,0,9
2025034,1558790,2025-04-28,Senate,"Senate: Third Reading Bill",23,11,0,1,35
2025034,1560408,2025-04-23,Senate,"Senate Transportation & Energy: Adopt amendment L.002",9,0,0,0,9
2025034,1560409,2025-04-23,Senate,"Senate Transportation & Energy: Adopt amendment L.003",9,0,0,0,9
2025034,1560410,2025-04-23,Senate,"Senate Transportation & Energy: Refer Senate Bill 25-299, as amended, to the Committee of the Whole.",8,1,0,0,9
2025034,1563958,2025-05-01,House,"House Energy & Environment: Adopt amendment L.005",13,0,0,0,13
2025034,1565190,2025-05-01,House,"House Energy & Environment: Adopt amendment L.008",3,10,0,0,13
2025034,1565191,2025-05-01,House,"House Energy & Environment: Refer Senate Bill 25-299, as amended, to the Committee of the Whole.",9,4,0,0,13
2025034,1565192,2025-05-05,House,"House: Committee of the Whole Amd (h.001)",22,42,0,1,65
2025034,1565789,2025-05-06,House,"House: Third Reading Bill",43,22,0,0,65
2025034,1565790,2025-05-06,Senate,"Senate: House Amendments Concur",35,0,0,0,35
2025034,1565791,2025-05-06,Senate,"Senate: House Amendments Repass",24,11,0,0,35
2025035,1553203,2025-04-21,House,"House Agriculture, Water & Natural Resources: Adopt amendment L.002",13,0,0,0,13
2025035,1559801,2025-04-21,House,"House Agriculture, Water & Natural Resources: Adopt amendment L.001, as amended",13,0,0,0,13
2025035,1559802,2025-04-21,House,"House Agriculture, Water & Natural Resources: Refer House Bill 25-1332, as amended, to the Committee on Appropriations.",9,4,0,0,13
2025035,1559803,2025-04-29,House,"House Appropriations: Adopt amendment J.001",11,0,0,0,11
2025035,1561707,2025-04-29,House,"House Appropriations: Refer House Bill 25-1332, as amended, to the Committee of the Whole.",8,3,0,0,11
2025035,1561708,2025-04-30,House,"House: Third Reading Bill",43,22,0,0,65
2025035,1564007,2025-05-01,Senate,"Senate Agriculture & Natural Resources: Refer House Bill 25-1332, as amended, to the Committee on Appropriations.",5,2,0,0,7
2025035,1564655,2025-05-02,Senate,"Senate Appropriations: Refer House Bill 25-1332 to the Committee of the Whole.",5,2,0,0,7
2025035,1564741,2025-05-02,Senate,"Senate: Committee of the Whole Adopt Report",35,0,0,0,35
2025035,1565794,2025-05-06,Senate,"Senate: Third Reading Bill",26,9,0,0,35
2025035,1567639,2025-05-07,House,"House: Senate Amendments Concur",49,16,0,0,65
2025035,1567640,2025-05-07,House,"House: Senate Amendments Repass",43,22,0,0,65
2025378,1555648,2025-04-23,Senate,"Senate Judiciary: Refer Senate Bill 25-300 to the Committee of the Whole and with a recommendation that it be placed on the consent calendar.",7,0,0,0,7
2025378,1559195,2025-04-28,Senate,"Senate: Third Reading Bill",34,0,0,1,35
2025378,1562614,2025-04-30,House,"House Judiciary: Refer Senate Bill 25-300 to the Committee of the Whole.",11,0,0,0,11
2025378,1564670,2025-05-02,House,"House: Third Reading Bill",63,1,0,1,65
2025379,1554861,2025-04-22,Senate,"Senate Finance: Refer Senate Bill 25-302 to the Committee on Appropriations.",9,0,0,0,9
2025379,1560673,2025-04-29,Senate,"Senate Appropriations: Refer Senate Bill 25-302 to the Committee of the Whole and with a recommendation that it be placed on the consent calendar.",7,0,0,0,7
2025379,1562586,2025-04-30,Senate,"Senate: Third Reading Bill",35,0,0,0,35
2025379,1564749,2025-05-03,House,"House Appropriations: Refer Senate Bill 25-302 to the Committee of the Whole.",11,0,0,0,11
2025379,1565182,2025-05-05,House,"House: Third Reading Bill",50,14,0,1,65
2025380,1556777,2025-04-24,House,"House State, Civic, Military, & Veterans Affairs: Refer House Bill 25-1333 to the Committee of the Whole.",10,0,0,1,11
2025380,1557985,2025-04-25,House,"House: Third Reading Bill",43,20,0,2,65
2025380,1564087,2025-05-01,Senate,"Senate State, Veterans, & Military Affairs: Refer House Bill 25-1333 to the Committee of the Whole.",3,2,0,0,5
2025380,1566771,2025-05-06,Senate,"Senate: Third Reading Bill",24,11,0,0,35
2025381,1557472,2025-04-24,Senate,"Senate Health & Human Services: Adopt amendment L.003 (Attachment J).",9,0,0,0,9
2025381,1559183,2025-04-28,Senate,"Senate: Third Reading Bill",34,0,0,1,35
2025381,1562653,2025-04-30,House,"House Health & Human Services: Refer Senate Bill 25-301 to the Committee of the Whole.",11,2,0,0,13
2025381,1564017,2025-04-24,Senate,"Senate Health & Human Services: Refer Senate Bill 25-301, as amended, to the Committee of the Wholeand with a recommendation that it be placed on the consent calendar.",9,0,0,0,9
2025381,1564541,2025-05-02,House,"House: Third Reading Amd (l.005)",61,3,0,1,65
2025381,1564542,2025-05-02,House,"House: Third Reading Bill",58,6,0,1,65
2025381,1564543,2025-05-02,House,"House: Third Reading Perm",62,2,0,1,65
2025381,1565382,2025-05-05,Senate,"Senate: House Amendments Concur",35,0,0,0,35
2025381,1565383,2025-05-05,Senate,"Senate: House Amendments Repass",35,0,0,0,35
2025689,1558265,2025-04-25,Senate,"Senate Appropriations: Refer Senate Bill 25-303 to the Committee of the Whole.",6,1,0,0,7
2025689,1558966,2025-04-28,Senate,"Senate: Third Reading Bill",34,0,0,1,35
2025689,1562554,2025-04-30,House,"House Appropriations: Refer Senate Bill 25-303 to the Committee of the Whole.",9,2,0,0,11
2025689,1564052,2025-05-01,House,"House: Third Reading Bill",56,8,0,1,65
2025741,1553917,2025-04-22,Senate,"Senate: Consideration of Resolutions Resolution",35,0,0,0,35
2025802,1556375,2025-04-23,Senate,"Senate Judiciary: Adopt amendment L.002 (Attachment D)",7,0,0,0,7
2025802,1562528,2025-04-23,Senate,"Senate Judiciary: Refer Senate Bill 25-304, as amended, to the Committee on Appropriations.",7,0,0,0,7
2025802,1564048,2025-05-01,Senate,"Senate Appropriations: Adopt amendment J.002",7,0,0,0,7
2025802,1564049,2025-05-01,Senate,"Senate Appropriations: Adopt amendment L.004",7,0,0,0,7
2025802,1564050,2025-05-01,Senate,"Senate Appropriations: Refer Senate Bill 25-304, as amended, to the Committee of the Whole and with a recommendation that it be placed on the consent calendar.",7,0,0,0,7
2025802,1564688,2025-05-02,Senate,"Senate: Third Reading Bill",33,1,0,1,35
2025802,1564774,2025-05-03,House,"House Judiciary: Refer Senate Bill 25-304 to the Committee on Appropriations.",10,0,0,1,11
2025802,1564801,2025-05-05,House,"House Appropriations: Adopt amendment J.004",7,3,0,1,11
2025802,1565166,2025-05-05,House,"House Appropriations: Refer Senate Bill 25-304, as amended, to the Committee of the Whole.",7,3,0,1,11
2025802,1566452,2025-05-06,House,"House: Third Reading Bill",61,4,0,0,65
2025802,1566453,2025-05-06,Senate,"Senate: House Amendments Concur",35,0,0,0,35
2025802,1566454,2025-05-06,Senate,"Senate: House Amendments Repass",34,1,0,0,35
2025873,1558953,2025-04-28,House,"House Transportation, Housing & Local Government: Postpone House Bill 25-1334 indefinitely.",10,0,0,3,13
2026154,1560658,2025-04-29,Senate,"Senate Appropriations: Adopt amendment J.001",7,0,0,0,7
2026154,1560659,2025-04-29,Senate,"Senate Appropriations: Refer Senate Bill 25-308, as amended, to the Committee of the Whole and with a recommendation that it be placed on the consent calendar.",7,0,0,0,7
2026154,1562552,2025-04-30,Senate,"Senate: Third Reading Bill",30,5,0,0,35
2026154,1564021,2025-05-01,House,"House Appropriations: Refer Senate Bill 25-308 to the Committee of the Whole.",8,3,0,0,11
2026154,1564759,2025-05-03,House,"House: Third Reading Bill",44,19,0,2,65
2026184,1558030,2025-04-25,Senate,"Senate Appropriations: Refer Senate Bill 25-307 to the Committee of the Whole.",6,1,0,0,7
2026184,1558796,2025-04-28,Senate,"Senate: Third Reading Bill",27,7,0,1,35
2026184,1561710,2025-04-30,House,"House Appropriations: Refer Senate Bill 25-307 to the Committee of the Whole.",8,3,0,0,11
2026184,1563551,2025-05-01,House,"House: Third Reading Bill",43,20,0,2,65
2026211,1558012,2025-04-25,Senate,"Senate Appropriations: Adopt amendment J.001",7,0,0,0,7
2026211,1558832,2025-04-28,Senate,"Senate: Third Reading Bill",34,0,0,1,35
2026211,1559926,2025-04-25,Senate,"Senate Appropriations: Refer Senate Bill 25-305, as amended, to the Committee of the Whole and with a recommendation that it be placed on the consent calendar.",7,0,0,0,7
2026211,1561725,2025-04-30,House,"House Appropriations: Refer Senate Bill 25-305 to the Committee of the Whole.",9,2,0,0,11
2026211,1563481,2025-05-01,House,"House: Third Reading Bill",59,5,0,1,65
2026233,1560569,2025-04-29,Senate,"Senate Finance: Adopt amendment L.005 (Attachment A)",9,0,0,0,9
2026233,1563507,2025-05-01,Senate,"Senate: Third Reading Amend (l.008)",35,0,0,0,35
2026233,1563508,2025-05-01,Senate,"Senate: Third Reading Bill",35,0,0,0,35
2026233,1564768,2025-05-03,House,"House Finance: Adopt amendment L.009 (Attachment B).",13,0,0,0,13
2026233,1564875,2025-04-29,Senate,"Senate Finance: Adopt amendment L.003 (Attachment B)",9,0,0,0,9
2026233,1564876,2025-04-29,Senate,"Senate Finance: Adopt amendment L.007 (Attachment C)",9,0,0,0,9
2026233,1564877,2025-04-29,Senate,"Senate Finance: Refer Senate Bill 25-306, as amended, to the Committee of the Whole and with a recommendation that it be placed on the consent calendar.",8,0,0,1,9
2026233,1564878,2025-05-03,House,"House Finance: Refer Senate Bill 25-306, as amended, to the Committee of the Whole.",12,0,0,1,13
2026233,1565829,2025-05-06,House,"House: Third Reading Bill",65,0,0,0,65
2026233,1565830,2025-05-06,Senate,"Senate: House Amendments Concur",35,0,0,0,35
2026233,1565831,2025-05-06,Senate,"Senate: House Amendments Repass",35,0,0,0,35
2026447,1560700,2025-04-29,Senate,"Senate Appropriations: Refer Senate Bill 25-311 to the Committee of the Whole and with a recommendation that it be placed on the consent calendar.",7,0,0,0,7
2026447,1562566,2025-04-30,Senate,"Senate: Third Reading Bill",33,2,0,0,35
2026447,1564029,2025-05-01,House,"House Appropriations: Refer Senate Bill 25-311 to the Committee of the Whole.",9,2,0,0,11
2026447,1564761,2025-05-03,House,"House: Third Reading Bill",46,17,0,2,65
2026453,1560649,2025-04-29,Senate,"Senate Appropriations: Refer Senate Bill 25-313 to the Committee of the Whole.",5,2,0,0,7
2026453,1562216,2025-04-30,Senate,"Senate: Third Reading Bill",28,7,0,0,35
2026453,1563658,2025-05-01,House,"House Appropriations: Refer Senate Bill 25-313 to the Committee of the Whole.",8,3,0,0,11
2026453,1564674,2025-05-02,House,"House: Third Reading Bill",43,21,0,1,65
2026463,1560668,2025-04-29,Senate,"Senate Appropriations: Refer Senate Bill 25-312 to the Committee of the Whole and with a recommendation that it be placed on the consent calendar.",7,0,0,0,7
2026463,1562553,2025-04-30,Senate,"Senate: Third Reading Bill",34,1,0,0,35
2026463,1564020,2025-05-01,House,"House Appropriations: Refer Senate Bill 25-312 to the Committee of the Whole.",9,2,0,0,11
2026463,1564673,2025-05-02,House,"House: Third Reading Bill",53,11,0,1,65
2026478,1560026,2025-04-29,Senate,"Senate Appropriations: Adopt amendment J.001",7,0,0,0,7
2026478,1560027,2025-04-29,Senate,"Senate Appropriations: Adopt amendment L.001",7,0,0,0,7
2026478,1560028,2025-04-29,Senate,"Senate Appropriations: Refer Senate Bill 25-310, as amended, to the Committee of the Whole and with a recommendation that it be placed on the consent calendar.",7,0,0,0,7
2026478,1562532,2025-04-30,Senate,"Senate: Third Reading Amend (l.003)",35,0,0,0,35
2026478,1562533,2025-04-30,Senate,"Senate: Third Reading Amend (l.004)",35,0,0,0,35
2026478,1562534,2025-04-30,Senate,"Senate: Third Reading Bill",35,0,0,0,35
2026478,1563622,2025-05-01,House,"House Appropriations: Adopt amendment L.005",11,0,0,0,11
2026478,1563623,2025-05-01,House,"House Appropriations: Adopt amendment L.006",11,0,0,0,11
2026478,1563624,2025-05-01,House,"House Appropriations: Refer Senate Bill 25-310, as amended, to the Committee of the Whole.",9,2,0,0,11
2026478,1565175,2025-05-05,House,"House: Third Reading Amd (l.018)",64,0,0,1,65
2026478,1565176,2025-05-05,House,"House: Third Reading Amd (l.019)",64,0,0,1,65
2026478,1565177,2025-05-05,House,"House: Third Reading Bill",55,9,0,1,65
2026478,1565178,2025-05-05,House,"House: Third Reading Perm",63,1,0,1,65
2026478,1565179,2025-05-05,House,"House: Third Reading Perm",63,1,0,1,65
2026478,1566111,2025-05-06,Senate,"Senate: House Amendments Concur",35,0,0,0,35
2026478,1566112,2025-05-06,Senate,"Senate: House Amendments Repass",35,0,0,0,35
2026490,1560691,2025-04-29,Senate,"Senate State, Veterans, & Military Affairs: Refer Senate Bill 25-309 to the Committee of the Whole and with a recommendation that it be placed on the consent calendar.",3,0,0,2,5
2026490,1564001,2025-05-01,Senate,"Senate: Third Reading Bill",34,1,0,0,35
2026490,1564772,2025-05-03,House,"House Finance: Refer Senate Bill 25-309 to the Committee of the Whole.",9,3,0,1,13
2026490,1566029,2025-05-06,House,"House: Committee of the Whole Amd (h.002)",63,0,0,2,65
2026490,1567292,2025-05-07,House,"House: Third Reading Bill",44,20,0,1,65
2026490,1568282,2025-05-07,Senate,"Senate: House Amendments Concur",35,0,0,0,35
2026490,1568283,2025-05-07,Senate,"Senate: House Amendments Repass",34,1,0,0,35
2026737,1560567,2025-04-29,Senate,"Senate Appropriations: Refer Senate Bill 25-316 to the Committee of the Whole.",6,1,0,0,7
2026737,1564313,2025-05-01,Senate,"Senate: Committee of the Whole Adopt Report",34,0,0,1,35
2026737,1564692,2025-05-02,Senate,"Senate: Third Reading Bill",31,3,0,1,35
2026737,1564784,2025-05-03,House,"House Appropriations: Refer Senate Bill 25-316 to the Committee of the Whole.",9,2,0,0,11
2026737,1565414,2025-05-05,House,"House: Third Reading Bill",46,18,0,1,65
2026739,1560661,2025-04-29,Senate,"Senate Appropriations: Adopt amendment J.002",7,0,0,0,7
2026739,1560662,2025-04-29,Senate,"Senate Appropriations: Adopt amendment L.001",7,0,0,0,7
2026739,1560663,2025-04-29,Senate,"Senate Appropriations: Adopt amendment L.002",7,0,0,0,7
2026739,1560664,2025-04-29,Senate,"Senate Appropriations: Adopt amendment L.003",7,0,0,0,7
2026739,1560665,2025-04-29,Senate,"Senate Appropriations: Refer Senate Bill 25-315, as amended, to the Committee of the Whole.",5,2,0,0,7
2026739,1562457,2025-04-30,Senate,"Senate: Third Reading Bill",33,2,0,0,35
2026739,1563656,2025-05-01,House,"House Appropriations: Adopt amendment J.003",11,0,0,0,11
2026739,1563657,2025-05-01,House,"House Appropriations: Refer Senate Bill 25-315, as amended, to the Committee of the Whole.",8,3,0,0,11
2026739,1564639,2025-05-02,House,"House: Third Reading Bill",50,14,0,1,65
2026739,1565494,2025-05-05,Senate,"Senate: House Amendments Concur",35,0,0,0,35
2026739,1565495,2025-05-05,Senate,"Senate: House Amendments Repass",33,2,0,0,35
2026741,1560693,2025-04-29,Senate,"Senate Appropriations: Adopt amendment L.001",7,0,0,0,7
2026741,1560694,2025-04-29,Senate,"Senate Appropriations: Refer Senate Bill 25-314, as amended, to the Committee of the Whole.",7,0,0,0,7
2026741,1562535,2025-04-30,Senate,"Senate: Third Reading Bill",34,1,0,0,35
2026741,1564000,2025-05-01,House,"House Appropriations: Refer Senate Bill 25-314 to the Committee of the Whole.",8,3,0,0,11
2026741,1564604,2025-05-02,House,"House: Third Reading Bill",53,11,0,1,65
2026742,1560480,2025-04-29,Senate,"Senate Appropriations: Adopt amendment L.001",7,0,0,0,7
2026742,1560481,2025-04-29,Senate,"Senate Appropriations: Refer Senate Bill 25-317, as amended, to the Committee of the Whole and with a recommendation that it be placed on the consent calendar.",7,0,0,0,7
2026742,1562538,2025-04-30,Senate,"Senate: Third Reading Bill",32,3,0,0,35
2026742,1563999,2025-05-01,House,"House Appropriations: Refer Senate Bill 25-317 to the Committee of the Whole.",8,3,0,0,11
2026742,1564676,2025-05-02,House,"House: Third Reading Bill",43,21,0,1,65
2026977,1564907,2025-05-05,Senate,"Senate Business, Labor, & Technology: Postpone Senate Bill 25-318 indefinitely.",5,2,0,0,7
2027182,1563497,2025-05-01,Senate,"Senate Appropriations: Adopt amendment J.002",7,0,0,0,7
2027182,1563498,2025-05-01,Senate,"Senate Appropriations: Adopt amendment L.001",7,0,0,0,7
2027182,1563499,2025-05-01,Senate,"Senate Appropriations: Adopt amendment L.002",7,0,0,0,7
2027182,1563500,2025-05-01,Senate,"Senate Appropriations: Refer Senate Bill 25-320, as amended, to the Committee of the Whole and with a recommendation that it be placed on the consent calendar.",7,0,0,0,7
2027182,1564491,2025-05-02,Senate,"Senate: Third Reading Bill",34,0,0,1,35
2027182,1564751,2025-05-03,House,"House Appropriations: Refer Senate Bill 25-320 to the Committee of the Whole.",8,3,0,0,11
2027182,1565220,2025-05-05,House,"House: Third Reading Bill",44,20,0,1,65
2027221,1562454,2025-04-30,Senate,"Senate Transportation & Energy: Refer Senate Bill 25-321 to the Committee on Finance.",7,0,0,2,9
2027221,1563502,2025-05-01,Senate,"Senate Finance: Adopt amendment L.003 (Attachment D)",9,0,0,0,9
2027221,1564473,2025-05-02,Senate,"Senate Appropriations: Refer Senate Bill 25-321 to the Committee of the Whole and with a recommendation that it be placed on the consent calendar.",7,0,0,0,7
2027221,1564840,2025-05-01,Senate,"Senate Finance: Refer Senate Bill 25-321, as amended, to the Committee on Appropriations.",9,0,0,0,9
2027221,1565081,2025-05-05,Senate,"Senate: Third Reading Amend (l.008)",35,0,0,0,35
2027221,1565082,2025-05-05,Senate,"Senate: Third Reading Bill",31,4,0,0,35
2027221,1565451,2025-05-06,House,"House Appropriations: Refer Senate Bill 25-321 to the Committee of the Whole.",8,3,0,0,11
2027221,1567586,2025-05-07,House,"House: Third Reading Bill",44,20,0,1,65
2027266,1563457,2025-05-01,Senate,"Senate Appropriations: Refer Senate Bill 25-319 to the Committee of the Whole and with a recommendation that it be placed on the consent calendar.",7,0,0,0,7
2027266,1564478,2025-05-02,Senate,"Senate: Third Reading Bill",34,0,0,1,35
2027266,1564752,2025-05-03,House,"House Appropriations: Refer Senate Bill 25-319 to the Committee of the Whole.",8,3,0,0,11
2027266,1565064,2025-05-05,House,"House: Third Reading Bill",44,20,0,1,65
2027313,1564008,2025-05-01,House,"House Appropriations: Adopt amendment L.001",11,0,0,0,11
2027313,1564009,2025-05-01,House,"House Appropriations: Refer House Bill 25-1335, as amended, to the Committee of the Whole.",10,1,0,0,11
2027313,1564668,2025-05-02,House,"House: Third Reading Bill",56,7,0,2,65
2027313,1564669,2025-05-02,Senate,"Senate Appropriations: Refer House Bill 25-1335 to the Committee of the Whole and with a recommendation that it be placed on the consent calendar.",7,0,0,0,7
2027313,1564813,2025-05-05,Senate,"Senate: Third Reading Bill",34,1,0,0,35
2028340,1565165,2025-05-05,Senate,"Senate: Consideration of Resolutions Resolution",35,0,0,0,35
2028359,1564989,2025-05-05,Senate,"Senate Business, Labor, & Technology: Refer Senate Bill 25-322, as amended, to the Committee of the Whole and with a recommendation that it be placed on the consent calendar.",7,0,0,0,7
2028359,1565456,2025-05-06,Senate,"Senate: Third Reading Amend (l.004)",19,16,0,0,35
2028359,1565457,2025-05-06,Senate,"Senate: Third Reading Bill",35,0,0,0,35
2028359,1566321,2025-05-06,House,"House Finance: Refer Senate Bill 25-322 to the Committee of the Whole.",11,2,0,0,13
2028359,1566879,2025-05-06,House,"House: Committee of the Whole Amd (h.001)",18,46,0,1,65
2028359,1566880,2025-05-06,House,"House: Committee of the Whole Amd (h.002)",12,52,0,1,65
2028359,1566881,2025-05-06,House,"House: Committee of the Whole Prev ?",30,34,0,1,65
2028438,1567794,2025-05-07,Senate,"Senate: Consideration of Resolutions Resolution",35,0,0,0,35
2028513,1568230,2025-05-07,Senate,"Senate: Consideration of Resolutions Resolution",35,0,0,0,35
