bill_id,roll_call_id,date,chamber,description,yea,nay,nv,absent,total
1893344,1535026,2025-04-02,Assembly,"Do pass and be re-referred to the Committee on [Appropriations]",17,0,0,0,17
1893346,1558358,2025-04-24,Assembly,"Do pass and be re-referred to the Committee on [Appropriations]",7,3,0,2,12
1893348,1528312,2025-03-26,Assembly,"Do pass and be re-referred to the Committee on [Appropriations]",18,0,0,0,18
1893349,1526958,2025-03-25,Assembly,"Do pass and be re-referred to the Committee on [Natural Resources] with recommendation: To Consent Calendar",13,0,0,0,13
1893349,1538900,2025-04-07,Assembly,"Do pass and be re-referred to the Committee on [Appropriations] with recommendation: To Consent Calendar",14,0,0,0,14
1893349,1555969,2025-04-23,Assembly,"Do pass. To Consent Calendar",15,0,0,0,15
1893349,1564261,2025-05-01,Assembly,"AB 14 Hart Consent Calendar Second Day Regular Session",76,0,0,3,79
1893350,1505308,2025-03-04,Assembly,"Do pass and be re-referred to the Committee on [Appropriations]",9,0,0,0,9
1893351,1542868,2025-04-09,Assembly,"Do pass as amended and be re-referred to the Committee on [Appropriations]",7,0,0,0,7
1893351,1565317,2025-05-05,Assembly,"AB 16 Alanis Assembly Third Reading",75,0,0,4,79
1893352,1528316,2025-03-26,Assembly,"Do pass and be re-referred to the Committee on [Appropriations] with recommendation: To Consent Calendar",7,0,0,0,7
1893352,1542731,2025-04-09,Assembly,"Do pass. To Consent Calendar",14,0,0,1,15
1893352,1557486,2025-04-24,Assembly,"AB 17 Alanis Consent Calendar Second Day Regular Session",75,0,0,4,79
1893355,1535143,2025-04-01,Assembly,"Do pass as amended and be re-referred to the Committee on [Judiciary]",9,0,0,6,15
1893355,1540876,2025-04-08,Assembly,"Do pass",9,0,0,3,12
1893356,1558353,2025-04-24,Assembly,"Do pass and be re-referred to the Committee on [Human Services]",2,7,0,3,12
1893357,1558374,2025-04-24,Assembly,"Do pass and be re-referred to the Committee on [Judiciary]",5,2,0,5,12
1893357,1558375,2025-04-24,Assembly,Reconsideration,5,2,0,5,12
1893361,1542906,2025-04-09,Assembly,"Do pass and be re-referred to the Committee on [Judiciary]",2,5,0,0,7
1893361,1542907,2025-04-09,Assembly,Reconsideration,2,5,0,0,7
1893363,1566682,2025-05-05,Assembly,"Do pass and be re-referred to the Committee on [Appropriations]",7,0,0,0,7
1893364,1559478,2025-04-28,Assembly,"Do pass as amended and be re-referred to the Committee on [Appropriations]",11,3,0,0,14
1893365,1533476,2025-04-01,Assembly,"Do pass and be re-referred to the Committee on [Appropriations]",15,0,0,0,15
1893367,1525455,2025-03-24,Assembly,"Do pass as amended and be re-referred to the Committee on [Appropriations]",12,0,0,2,14
1893368,1505298,2025-03-04,Assembly,"Do pass and be re-referred to the Committee on [Appropriations] with recommendation: To Consent Calendar",9,0,0,0,9
1893369,1505311,2025-03-04,Assembly,"Do pass and be re-referred to the Committee on [Transportation] with recommendation: To Consent Calendar",9,0,0,0,9
1893369,1525418,2025-03-24,Assembly,"Do pass and be re-referred to the Committee on [Appropriations] with recommendation: To Consent Calendar",16,0,0,0,16
1893370,1554642,2025-04-21,Assembly,"Do pass and be re-referred to the Committee on [Appropriations]",12,2,0,2,16
1893373,1542683,2025-04-09,Assembly,"Do pass and be re-referred to the Committee on [Local Government] with recommendation: To Consent Calendar",12,0,0,0,12
1893373,1556030,2025-04-23,Assembly,"Do pass and be re-referred to the Committee on [Appropriations] with recommendation: To Consent Calendar",10,0,0,0,10
1893373,1562918,2025-04-30,Assembly,"Do pass. To Consent Calendar",14,0,0,1,15
1893373,1568676,2025-05-08,Assembly,"AB 36 Soria Consent Calendar Second Day Regular Session",69,0,0,10,79
1893376,1542830,2025-04-09,Assembly,"Do pass and be re-referred to the Committee on [Utilities and Energy]",10,0,0,0,10
1893376,1564296,2025-04-30,Assembly,"Do pass and be re-referred to the Committee on [Appropriations]",16,0,0,2,18
1893377,1533584,2025-04-01,Assembly,"Do pass and be re-referred to the Committee on [Appropriations]",11,2,0,2,15
1893378,1526967,2025-03-25,Assembly,"Do pass and be re-referred to the Committee on [Appropriations]",12,0,0,3,15
1893378,1542691,2025-04-09,Assembly,"Do pass",10,3,0,2,15
1893378,1552883,2025-04-21,Assembly,"AB 40 Bonta Third Reading Urgency",58,9,0,12,79
1893380,1526962,2025-03-25,Assembly,"Do pass and be re-referred to the Committee on [Appropriations]",7,0,0,0,7
1893381,1525415,2025-03-24,Assembly,"Do pass and be re-referred to the Committee on [Appropriations]",11,0,0,3,14
1893382,1556198,2025-04-23,Assembly,"Do pass and be re-referred to the Committee on [Appropriations] with recommendation: To Consent Calendar",18,0,0,0,18
1893383,1555919,2025-04-22,Assembly,"Do pass and be re-referred to the Committee on [Judiciary]",10,2,0,3,15
1893383,1561190,2025-04-29,Assembly,"Do pass and be re-referred to the Committee on [Appropriations]",9,2,0,1,12
1893384,1562748,2025-04-29,Assembly,"Do pass as amended and be re-referred to the Committee on [Appropriations]",8,0,0,1,9
1893385,1554585,2025-04-22,Assembly,"Do pass as amended and be re-referred to the Committee on [Appropriations]",8,0,0,1,9
1893386,1555914,2025-04-22,Assembly,"Do pass and be re-referred to the Committee on [Housing and Community Development]",6,2,0,2,10
1893386,1562859,2025-04-30,Assembly,"Do pass and be re-referred to the Committee on [Appropriations]",9,1,0,2,12
1893387,1544955,2025-04-09,Assembly,"Do pass as amended and be re-referred to the Committee on [Judiciary]",7,2,0,0,9
1893387,1561047,2025-04-29,Assembly,"Do pass and be re-referred to the Committee on [Appropriations]",8,2,0,2,12
1893388,1542735,2025-04-09,Assembly,"Do pass and be re-referred to the Committee on [Appropriations]",7,0,0,0,7
1893389,1533523,2025-04-01,Assembly,"Do pass as amended and be re-referred to the Committee on [Health]",17,0,0,1,18
1893389,1556061,2025-04-23,Assembly,"Do pass",15,0,0,0,15
1893389,1559381,2025-04-28,Assembly,"AB 50 Bonta Third Reading Urgency",73,0,0,6,79
1893390,1564175,2025-04-30,Assembly,"Do pass as amended and be re-referred to the Committee on [Appropriations]",6,2,0,1,9
1893392,1566726,2025-05-05,Assembly,"Do pass and be re-referred to the Committee on [Appropriations]",7,0,0,0,7
1893393,1540847,2025-04-08,Assembly,"Do pass and be re-referred to the Committee on [Judiciary]",12,0,0,3,15
1893393,1561153,2025-04-29,Assembly,"Do pass and be re-referred to the Committee on [Appropriations]",8,1,0,3,12
1893393,1567875,2025-05-07,Assembly,"Do pass",11,1,0,3,15
1893394,1540944,2025-04-08,Assembly,"Do pass as amended and be re-referred to the Committee on [Appropriations]",15,0,0,0,15
1893394,1555939,2025-04-23,Assembly,"Do pass",15,0,0,0,15
1893394,1559378,2025-04-28,Assembly,"AB 55 Bonta Assembly Third Reading",75,0,0,4,79
1893395,1556035,2025-04-22,Assembly,"Do pass and be re-referred to the Committee on [Judiciary]",11,1,0,3,15
1893395,1561004,2025-04-29,Assembly,"Do pass as amended and be re-referred to the Committee on [Appropriations]",10,1,0,1,12
1893396,1528248,2025-03-26,Assembly,"Do pass as amended and be re-referred to the Committee on [Judiciary]",8,0,0,3,11
1893396,1554631,2025-04-22,Assembly,"Do pass as amended and be re-referred to the Committee on [Appropriations]",9,2,0,1,12
1893397,1561095,2025-04-29,Assembly,"Do pass and be re-referred to the Committee on [Appropriations] with recommendation: To Consent Calendar",10,0,0,0,10
1893398,1528314,2025-03-26,Assembly,"Do pass as amended",8,0,0,2,10
1893398,1533521,2025-04-01,Assembly,"AB 59 Aguiar-Curry Assembly Third Reading",77,0,0,3,80
1893399,1562772,2025-04-30,Assembly,"Do pass as amended and be re-referred to the Committee on [Appropriations]",11,0,0,1,12
1893400,1528321,2025-03-25,Assembly,"Do pass",5,1,0,1,7
1893400,1565242,2025-05-05,Assembly,"AB 60 Papan Assembly Third Reading",63,4,0,12,79
1893401,1528242,2025-03-26,Assembly,"Do pass as amended, and be re-referred to the Committee on [Appropriations] with recommendation: To Consent Calendar",18,0,0,0,18
1893402,1561134,2025-04-29,Assembly,"Do pass and be re-referred to the Committee on [Appropriations]",9,1,0,2,12
1893404,1555947,2025-04-22,Assembly,"Do pass and be re-referred to the Committee on [Judiciary]",6,3,0,1,10
1893404,1561200,2025-04-29,Assembly,"Do pass and be re-referred to the Committee on [Appropriations]",8,2,0,2,12
1893405,1554551,2025-04-22,Assembly,"Do pass and be re-referred to the Committee on [Revenue and Taxation]",17,0,0,1,18
1893405,1561131,2025-04-28,Assembly,"Do pass as amended and be re-referred to the Committee on [Appropriations]",6,1,0,0,7
1893410,1511429,2025-03-10,Assembly,"Be adopted. To third reading",9,0,0,2,11
1893415,1470866,2024-12-03,Assembly,"HR 1 PACHECO Assembly Third Reading",58,19,0,2,79
1893415,1564795,2024-12-02,Assembly,"HR 1 PACHECO Assembly Third Reading",58,19,0,2,79
1893416,1470867,2024-12-03,Assembly,"HR 2 RIVAS Assembly Third Reading By AGUIAR-CURRY",78,0,0,1,79
1893416,1564794,2024-12-02,Assembly,"HR 2 RIVAS Assembly Third Reading By AGUIAR-CURRY",78,0,0,1,79
1893417,1470868,2024-12-03,Assembly,"HR 3 RIVAS Assembly Third Reading By AGUIAR-CURRY",77,0,0,2,79
1893417,1564797,2024-12-02,Assembly,"HR 3 RIVAS Assembly Third Reading By AGUIAR-CURRY",77,0,0,2,79
1893418,1470869,2024-12-03,Assembly,"HR 4 ESSAYLI Assembly Third Reading Motion to Lay on the Table By AGUIAR-CURRY",58,19,0,2,79
1893418,1564793,2024-12-02,Assembly,"HR 4 ESSAYLI Assembly Third Reading Motion to Lay on the Table By AGUIAR-CURRY",58,19,0,2,79
1893420,1474061,2025-01-23,Assembly,"Be adopted. To Consent Calendar",10,0,0,1,11
1893420,1477873,2025-01-30,Assembly,"HR 6 Connolly Consent Calendar Second Day Regular Session",69,0,0,10,79
1893421,1516577,2025-03-12,Senate,"Do pass, but first be re-referred to the Committee on [Military and Veterans Affairs]",5,0,0,0,5
1893421,1559469,2025-04-28,Senate,"Do pass, but first be re-referred to the Committee on [Appropriations]",4,0,0,1,5
1893422,1526886,2025-03-25,Senate,"Do pass, but first be re-referred to the Committee on [Appropriations]",11,3,0,1,15
1893422,1552820,2025-04-21,Senate,"Placed on suspense file",6,0,0,1,7
1893423,1535095,2025-04-01,Senate,"Do pass, but first be re-referred to the Committee on [Public Safety]",12,0,0,1,13
1893423,1554574,2025-04-22,Senate,"Do pass, but first be re-referred to the Committee on [Appropriations]",6,0,0,0,6
1893423,1565260,2025-05-05,Senate,"Placed on suspense file",7,0,0,0,7
1893424,1515256,2025-03-11,Senate,"Do pass as amended, but first amend, and re-refer to the Committee on [Judiciary]",11,1,0,3,15
1893424,1556135,2025-04-22,Senate,"Do pass, but first be re-referred to the Committee on [Appropriations]",11,0,0,2,13
1893424,1565314,2025-05-05,Senate,"Placed on suspense file",7,0,0,0,7
1893425,1521950,2025-03-19,Senate,"Do pass, but first be re-referred to the Committee on [Energy, Utilities and Communications] with the recommendation: To Consent Calendar",8,0,0,0,8
1893425,1538973,2025-04-07,Senate,"Do pass as amended, but first amend, and re-refer to the Committee on [Appropriations]",16,0,0,1,17
1893425,1559404,2025-04-28,Senate,"Placed on suspense file",7,0,0,0,7
1893426,1554581,2025-04-22,Senate,"Do pass as amended, but first amend, and re-refer to the Committee on [Environmental Quality]",8,5,0,2,15
1893426,1562896,2025-04-30,Senate,"Do pass as amended, but first amend, and re-refer to the Committee on [Appropriations]",5,2,0,1,8
1893427,1526945,2025-03-25,Senate,"Do pass, but first be re-referred to the Committee on [Rules]",4,1,0,1,6
1893427,1538950,2025-04-07,Senate,"Placed on suspense file",7,0,0,0,7
1893428,1556156,2025-04-22,Senate,"Do pass as amended, but first amend, and re-refer to the Committee on [Health]",10,0,0,1,11
1893429,1555910,2025-04-23,Senate,"Do pass as amended, but first amend, and re-refer to the Committee on [Labor, Public Employment and Retirement ]",5,0,0,0,5
1893430,1561202,2025-04-29,Senate,"Do pass as amended, but first amend, and re-refer to the Committee on [Appropriations]",4,0,0,1,5
1893431,1526968,2025-03-25,Senate,"Do pass, but first be re-referred to the Committee on [Appropriations]",6,0,0,0,6
1893431,1538923,2025-04-07,Senate,"Placed on suspense file",7,0,0,0,7
1893432,1522002,2025-03-19,Senate,"Do pass, but first be re-referred to the Committee on [Appropriations]",3,2,0,3,8
1893432,1522003,2025-03-19,Senate,"[First] hearing set for [03-19-2025]: Failed passage in Committee. Reconsideration granted",8,0,0,0,8
1893433,1528273,2025-03-26,Senate,"Do pass as amended, but first amend, and re-refer to the Committee on [Health]",5,0,0,0,5
1893433,1552843,2025-04-21,Senate,"Placed on suspense file",6,0,0,1,7
1893434,1555981,2025-04-23,Senate,"Do pass, but first be re-referred to the Committee on [Housing]",7,0,0,0,7
1893434,1562866,2025-04-29,Senate,"Do pass, but first be re-referred to the Committee on [Appropriations]",11,0,0,0,11
1893435,1542756,2025-04-08,Senate,"Do pass as amended",11,2,0,0,13
1893436,1516569,2025-03-12,Senate,"Do pass, but first be re-referred to the Committee on [Military and Veterans Affairs]",5,0,0,0,5
1893437,1554468,2025-04-21,Senate,"Do pass, but first be re-referred to the Committee on [Judiciary]",13,4,0,0,17
1893437,1565273,2025-05-05,Senate,"Placed on suspense file",7,0,0,0,7
1893438,1542879,2025-04-08,Senate,"Do pass as amended, but first amend, and re-refer to the Committee on [Appropriations]",12,0,0,1,13
1893438,1559465,2025-04-28,Senate,"Placed on suspense file",7,0,0,0,7
1893439,1487029,2025-02-11,Senate,"Do pass, but first be re-referred to the Committee on [Business, Professions and Economic Development]",10,1,0,2,13
1893439,1503908,2025-03-03,Senate,"Do pass as amended, but first amend, and re-refer to the Committee on [Appropriations]",8,0,0,3,11
1893439,1517828,2025-03-13,Senate,"Senate 3rd Reading SB26 Umberg et al. Urgency Clause",35,0,0,5,40
1893439,1528286,2025-03-26,Assembly,"Do pass",9,0,0,3,12
1893439,1533497,2025-04-01,Senate,"Unfinished Business SB26 Umberg et al. Urgency Clause Concurrence",38,1,0,1,40
1893439,1533498,2025-04-01,Assembly,"SB 26 Umberg Third Reading Urgency By Kalra",77,0,0,3,80
1893440,1542742,2025-04-08,Senate,"Do pass",12,0,0,1,13
1893441,1526889,2025-03-25,Senate,"Do pass, but first be re-referred to the Committee on [Appropriations]",6,0,0,0,6
1893441,1538866,2025-04-07,Senate,"Placed on suspense file",7,0,0,0,7
1893442,1535054,2025-04-01,Senate,"Do pass, but first be re-referred to the Committee on [Appropriations]",9,2,0,2,13
1893442,1552909,2025-04-21,Senate,"Placed on suspense file",6,0,0,1,7
1893443,1561090,2025-04-29,Senate,"Do pass, but first be re-referred to the Committee on [Appropriations]",5,0,0,0,5
1893444,1542877,2025-04-08,Senate,"Do pass, but first be re-referred to the Committee on [Environmental Quality]",11,3,0,1,15
1893444,1562815,2025-04-30,Senate,"Do pass as amended, but first amend, and re-refer to the Committee on [Appropriations]",6,0,0,2,8
1893445,1526905,2025-03-25,Senate,"Do pass as amended, but first amend, and re-refer to the Committee on [Environmental Quality]",7,0,0,0,7
1893445,1563095,2025-04-30,Senate,"Do pass, but first be re-referred to the Committee on [Appropriations]",8,0,0,0,8
1893446,1564259,2025-04-30,Senate,"Do pass, but first be re-referred to the Committee on [Appropriations]",9,0,0,2,11
1893447,1521980,2025-03-19,Senate,"Do pass, but first be re-referred to the Committee on [Human Services]",6,1,0,0,7
1893447,1552831,2025-04-21,Senate,"Do pass, but first be re-referred to the Committee on [Appropriations]",5,0,0,0,5
1893447,1565227,2025-05-05,Senate,"Placed on suspense file",7,0,0,0,7
1893448,1556165,2025-04-23,Senate,"Do pass, but first be re-referred to the Committee on [Transportation]",8,0,0,0,8
1893448,1561019,2025-04-28,Senate,"Do pass as amended, but first amend, and re-refer to the Committee on [Appropriations]",14,0,0,1,15
1893449,1526955,2025-03-25,Senate,"Do pass, but first be re-referred to the Committee on [Appropriations] with the recommendation: To Consent Calendar",6,0,0,0,6
1893449,1538909,2025-04-07,Senate,"Placed on suspense file",7,0,0,0,7
1893450,1555964,2025-04-23,Senate,"Do pass as amended",5,2,0,0,7
1893451,1526911,2025-03-25,Senate,"Do pass, but first be re-referred to the Committee on [Appropriations]",6,0,0,0,6
1893451,1538940,2025-04-07,Senate,"Placed on suspense file",7,0,0,0,7
1893452,1542930,2025-04-09,Senate,"Do pass, but first be re-referred to the Committee on [Judiciary]",4,1,0,0,5
1893452,1562926,2025-04-29,Senate,"Do pass as amended, but first amend, and re-refer to the Committee on [Appropriations]",11,2,0,0,13
1893453,1528292,2025-03-26,Senate,"Do pass as amended",5,0,0,0,5
1893454,1556076,2025-04-22,Senate,"Do pass as amended, but first amend, and re-refer to the Committee on [Local Government]",10,1,0,0,11
1893454,1567866,2025-05-07,Senate,"Do pass as amended",5,0,0,2,7
1893455,1469564,2024-12-02,Senate,"W/O REF. TO FILE SCR1 McGuire",29,9,0,1,39
1893455,1536784,2025-04-03,Assembly,"SCR 1 McGuire Senate Third Reading By Pacheco",56,19,0,4,79
1893456,1469565,2024-12-02,Senate,"W/O REF. TO FILE SCR2 Umberg",37,1,0,1,39
1893456,1470870,2024-12-03,Assembly,"SCR 2 Umberg Senate Third Reading By AGUIAR-CURRY",78,0,0,1,79
1893456,1564798,2024-12-02,Assembly,"SCR 2 Umberg Senate Third Reading By AGUIAR-CURRY",78,0,0,1,79
1893457,1483663,2025-02-06,Senate,"Senate 3rd Reading SCR3 Laird",33,0,0,6,39
1893458,1559377,2025-04-28,Senate,"Senate 3rd Reading SCR4 Umberg et al",39,0,0,1,40
1893462,1469566,2024-12-02,Senate,"W/O REF. TO FILE SR4 Gonzalez",29,9,0,1,39
1893465,1477878,2025-01-30,Senate,"Senate 3rd Reading SR7 Ochoa Bogh et al",36,0,0,3,39
1894276,1473353,2025-01-22,Senate,"Do pass",8,2,0,0,10
1894276,1474135,2025-01-23,Senate,"Senate 3rd Reading SB1 Wiener et al",27,9,0,3,39
1894276,1479278,2025-02-03,Assembly,"SB 1 Wiener Senate Third Reading By GABRIEL Amend By DEMAIO Set #1 Motion to Lay on the Table By AGUIAR-CURRY First Extraordinary Session",56,17,0,6,79
1894276,1479279,2025-02-03,Assembly,"SB 1 Wiener Senate Third Reading By GABRIEL Motion First Extraordinary Session",59,3,0,17,79
1894276,1479280,2025-02-03,Assembly,"SB 1 Wiener Senate Third Reading By GABRIEL First Extraordinary Session",58,17,0,4,79
1894442,1526932,2025-03-25,Assembly,"Do pass and be re-referred to the Committee on [Appropriations]",15,0,0,0,15
1894443,1516570,2025-03-12,Assembly,"Do pass and be re-referred to the Committee on [Higher Education]",8,0,0,1,9
1894443,1556129,2025-04-22,Assembly,"Do pass and be re-referred to the Committee on [Appropriations]",8,0,0,2,10
1894444,1525416,2025-03-24,Assembly,"Do pass and be re-referred to the Committee on [Appropriations]",10,0,0,4,14
1894445,1557476,2025-04-23,Senate,"Do pass, but first be re-referred to the Committee on [Judiciary]",11,0,0,0,11
1894445,1562905,2025-04-29,Senate,"Do pass as amended, but first amend, and re-refer to the Committee on [Appropriations]",13,0,0,0,13
1894446,1542913,2025-04-08,Senate,"Do pass, but first be re-referred to the Committee on [Public Safety]",10,0,0,3,13
1894446,1554634,2025-04-22,Senate,"Do pass, but first be re-referred to the Committee on [Appropriations]",5,1,0,0,6
1894446,1565225,2025-05-05,Senate,"Placed on suspense file",7,0,0,0,7
1894447,1562961,2025-04-29,Senate,"Do pass, but first be re-referred to the Committee on [Appropriations]",13,0,0,0,13
1894448,1540941,2025-04-08,Senate,"Do pass as amended, but first amend, and re-refer to the Committee on [Appropriations]",6,0,0,0,6
1894448,1559418,2025-04-28,Senate,"Placed on suspense file",7,0,0,0,7
1894449,1521988,2025-03-19,Senate,"Do pass and be ordered to the Consent Calendar",8,0,0,0,8
1894449,1530385,2025-03-28,Senate,"Consent Calendar 2nd SB39 Weber Pierson Urgency Clause",34,0,0,6,40
1894450,1535046,2025-04-02,Senate,"Do pass as amended, but first amend, and re-refer to the Committee on [Appropriations]",11,0,0,0,11
1894450,1552932,2025-04-21,Senate,"Placed on suspense file",6,0,0,1,7
1894451,1557473,2025-04-23,Senate,"Do pass, but first be re-referred to the Committee on [Judiciary]",11,0,0,0,11
1894451,1562835,2025-04-29,Senate,"Do pass, but first be re-referred to the Committee on [Appropriations]",13,0,0,0,13
1894656,1540905,2025-04-08,Assembly,"Do pass and be re-referred to the Committee on [Privacy and Consumer Protection]",9,3,0,0,12
1894656,1564149,2025-05-01,Assembly,"Do pass and be re-referred to the Committee on [Appropriations]",10,2,0,3,15
1894817,1533573,2025-04-01,Senate,"Do pass as amended, but first amend, and re-refer to the Committee on [Appropriations]",4,1,0,0,5
1894817,1552862,2025-04-21,Senate,"Placed on suspense file",6,0,0,1,7
1894818,1563057,2025-04-29,Senate,"Do pass, but first be re-referred to the Committee on [Appropriations]",13,0,0,0,13
1894819,1555943,2025-04-22,Senate,"Do pass, but first be re-referred to the Committee on [Appropriations] with the recommendation: To Consent Calendar",13,0,0,0,13
1894819,1565311,2025-05-05,Senate,"Placed on suspense file",7,0,0,0,7
1894820,1472238,2025-01-17,Senate,"Senate 3rd Reading SCR5 Ochoa Bogh",32,0,0,7,39
1894820,1485621,2025-02-10,Assembly,"Be adopted. To Consent Calendar",9,0,0,2,11
1895841,1534990,2025-04-02,Assembly,"Do pass and be re-referred to the Committee on [Appropriations] with recommendation: To Consent Calendar",17,0,0,0,17
1896226,1525474,2025-03-24,Assembly,"Do pass and be re-referred to the Committee on [Appropriations]",13,0,0,1,14
1896227,1505321,2025-03-04,Assembly,"Do pass as amended and be re-referred to the Committee on [Appropriations]",9,0,0,0,9
1896625,1526906,2025-03-25,Assembly,"Do pass and be re-referred to the Committee on [Appropriations]",14,0,0,1,15
1896626,1530375,2025-03-28,Assembly,"Be adopted. To third reading",7,0,0,4,11
1896626,1557516,2025-04-24,Senate,"Special Consent ACR6 Ta et al. By Cortese",37,0,0,3,40
1896627,1483686,2025-02-06,Senate,"Special Consent ACR7 Bryan et al",37,0,0,2,39
1896628,1521970,2025-03-19,Senate,"Do pass, but first be re-referred to the Committee on [Appropriations]",5,2,0,1,8
1896628,1538944,2025-04-07,Senate,"Placed on suspense file",7,0,0,0,7
1896630,1567904,2025-05-06,Senate,"Do pass",12,0,0,1,13
1896850,1477881,2025-01-30,Senate,"Special Consent ACR8 Wallis et al",36,0,0,3,39
1897055,1535008,2025-04-02,Assembly,"Do pass and be re-referred to the Committee on [Privacy and Consumer Protection]",15,0,0,2,17
1897055,1564246,2025-05-01,Assembly,"Do pass and be re-referred to the Committee on [Appropriations]",13,0,0,2,15
1897056,1542900,2025-04-09,Assembly,"Do pass as amended and be re-referred to the Committee on [Housing and Community Development]",8,1,0,1,10
1897056,1562856,2025-04-30,Assembly,"Do pass",10,1,0,1,12
1897056,1568666,2025-05-08,Assembly,"AB 76 Alvarez Assembly Third Reading",66,0,0,13,79
1897057,1483666,2025-02-06,Senate,"Special Consent ACR9 Pellerin et al",37,0,0,2,39
1897058,1534991,2025-04-02,Senate,"Do pass, but first be re-referred to the Committee on [Public Safety]",6,1,0,0,7
1897058,1562974,2025-04-29,Senate,"Do pass, but first be re-referred to the Committee on [Appropriations]",11,1,0,1,13
1897059,1519121,2025-03-17,Senate,"Senate 3rd Reading SB49 Grove et al. Urgency Clause",37,0,0,3,40
1897060,1535070,2025-04-01,Senate,"Do pass, but first be re-referred to the Committee on [Appropriations] with the recommendation: To Consent Calendar",13,0,0,0,13
1897060,1552946,2025-04-21,Senate,"Placed on suspense file",6,0,0,1,7
1897061,1535032,2025-04-01,Senate,"Be adopted. Ordered to third reading",12,0,0,1,13
1897215,1521999,2025-03-19,Assembly,"Do pass and be re-referred to the Committee on [Appropriations] with recommendation: To Consent Calendar",19,0,0,3,22
1897215,1556148,2025-04-23,Assembly,"Do pass. To Consent Calendar",15,0,0,0,15
1897215,1564224,2025-05-01,Assembly,"AB 77 Aguiar-Curry Consent Calendar Second Day Regular Session",76,0,0,3,79
1897216,1471321,2025-01-13,Senate,"Senate 3rd Reading SCR6 Choi",32,0,0,7,39
1897216,1479231,2025-02-03,Assembly,"Be adopted. To Consent Calendar",11,0,0,0,11
1897216,1483668,2025-02-06,Assembly,"SCR 6 Choi Consent Calendar Second Day Regular Session",72,0,0,7,79
1897437,1505310,2025-03-04,Assembly,"Do pass. To Consent Calendar",12,0,0,0,12
1897437,1511453,2025-03-10,Assembly,"AB 78 Chen Consent Calendar Second Day",72,0,0,8,80
1897438,1515291,2025-03-11,Assembly,"Do pass and be re-referred to the Committee on [Higher Education] with recommendation: To Consent Calendar",6,0,0,1,7
1897438,1556181,2025-04-22,Assembly,"Do pass and be re-referred to the Committee on [Appropriations] with recommendation: To Consent Calendar",10,0,0,0,10
1897439,1554546,2025-04-21,Senate,"Do pass, but first be re-referred to the Committee on [Appropriations]",9,2,0,6,17
1897439,1565321,2025-05-05,Senate,"Placed on suspense file",7,0,0,0,7
1897440,1503924,2025-03-03,Senate,"Senate 3rd Reading SCR7 Niello",24,6,0,9,39
1897818,1538951,2025-04-07,Assembly,"Do pass and be re-referred to the Committee on [Appropriations]",11,0,0,3,14
1897819,1545043,2025-04-08,Assembly,"Do pass and be re-referred to the Committee on [Appropriations]",7,0,0,1,8
1897820,1472237,2025-01-17,Senate,"Senate 3rd Reading SCR8 Weber Pierson et al",32,0,0,7,39
1897820,1485616,2025-02-10,Assembly,"Be adopted. To Consent Calendar",9,0,0,2,11
1898368,1554517,2025-04-22,Assembly,"Do pass and be re-referred to the Committee on [Judiciary]",8,0,0,1,9
1898368,1561195,2025-04-29,Assembly,"Do pass and be re-referred to the Committee on [Appropriations]",9,0,0,3,12
1898370,1564299,2025-04-30,Assembly,"Do pass as amended and be re-referred to the Committee on [Appropriations]",7,2,0,0,9
1898372,1477876,2025-01-30,Senate,"Special Consent ACR10 Mark González et al",36,0,0,3,39
1898373,1555940,2025-04-22,Senate,"Do pass as amended, but first amend, and re-refer to the Committee on [Appropriations]",11,0,0,2,13
1898373,1565332,2025-05-05,Senate,"Placed on suspense file",7,0,0,0,7
1903331,1516568,2025-03-12,Assembly,"Do pass and be re-referred to the Committee on [Appropriations]",8,0,0,1,9
1903332,1558367,2025-04-24,Assembly,"Do pass and be re-referred to the Committee on [Local Government]",10,0,0,2,12
1903332,1564216,2025-04-30,Assembly,"Do pass",9,0,0,1,10
1903333,1521944,2025-03-18,Assembly,"Do pass and be re-referred to the Committee on [Appropriations] with recommendation: To Consent Calendar",9,0,0,1,10
1903334,1533525,2025-04-01,Assembly,"Do pass and be re-referred to the Committee on [Education]",2,7,0,0,9
1903334,1533526,2025-04-01,Assembly,Reconsideration,2,6,0,1,9
1903335,1522012,2025-03-18,Assembly,"Do pass as amended and be re-referred to the Committee on [Appropriations]",6,2,0,2,10
1903336,1540858,2025-04-08,Assembly,"Do pass and be re-referred to the Committee on [Appropriations] with recommendation: To Consent Calendar",12,0,0,0,12
1903338,1485612,2025-02-10,Assembly,"Be adopted. To Consent Calendar",9,0,0,2,11
1903338,1492773,2025-02-18,Assembly,"HR 7 Ta Consent Calendar Second Day",70,0,0,9,79
1903339,1475144,2025-01-27,Senate,"Senate 3rd Reading SCR9 Weber Pierson",36,0,0,3,39
1903339,1485614,2025-02-10,Assembly,"Be adopted. To Consent Calendar",9,0,0,2,11
1904793,1540939,2025-04-08,Assembly,"Do pass as amended and be re-referred to the Committee on [Local Government]",10,1,0,2,13
1904793,1564300,2025-04-30,Assembly,"Do pass as amended and be re-referred to the Committee on [Appropriations]",8,1,0,1,10
1904794,1528278,2025-03-26,Assembly,"Do pass. To Consent Calendar",7,0,0,0,7
1904794,1533556,2025-04-01,Assembly,"AB 94 Bennett Consent Calendar Second Day Regular Session",76,0,0,4,80
1904795,1561097,2025-04-29,Assembly,"Do pass and be re-referred to the Committee on [Appropriations]",10,0,0,0,10
1904797,1566721,2025-05-05,Assembly,"Do pass and be re-referred to the Committee on [Appropriations]",7,0,0,0,7
1904799,1474058,2025-01-23,Assembly,"Be adopted. To third reading",10,0,0,1,11
1904799,1490594,2025-02-14,Senate,"Special Consent ACR11 Ahrens et al",34,0,0,5,39
1904800,1526976,2025-03-25,Senate,"Do pass as amended, but first amend, and re-refer to the Committee on [Judiciary]",13,0,0,2,15
1904800,1542818,2025-04-08,Senate,"Do pass, but first be re-referred to the Committee on [Appropriations] with the recommendation: To Consent Calendar",13,0,0,0,13
1904800,1552907,2025-04-21,Senate,"Placed on suspense file",6,0,0,1,7
1904801,1542886,2025-04-08,Senate,"Do pass, but first be re-referred to the Committee on [Military and Veterans Affairs] with the recommendation: To Consent Calendar",13,0,0,0,13
1904801,1559407,2025-04-28,Senate,"Do pass, but first be re-referred to the Committee on [Appropriations] with the recommendation: To Consent Calendar",4,0,0,1,5
1904802,1526939,2025-03-25,Senate,"Do pass as amended, but first amend, and re-refer to the Committee on [Military and Veterans Affairs] with the recommendation: To Consent Calendar",7,0,0,0,7
1904802,1559373,2025-04-28,Senate,"Do pass, but first be re-referred to the Committee on [Appropriations] with the recommendation: To Consent Calendar",4,0,0,1,5
1904803,1516571,2025-03-12,Senate,"Do pass, but first be re-referred to the Committee on [Military and Veterans Affairs] with the recommendation: To Consent Calendar",5,0,0,0,5
1904803,1559386,2025-04-28,Senate,"Do pass, but first be re-referred to the Committee on [Appropriations] with the recommendation: To Consent Calendar",4,0,0,1,5
1904804,1477866,2025-01-30,Senate,"Senate 3rd Reading SR9 Gonzalez",36,0,0,3,39
1908085,1523499,2025-03-20,Assembly,"AB 100 Gabriel Assembly Third Reading",53,17,0,10,80
1908085,1542899,2025-04-09,Senate,"Do pass",14,4,0,0,18
1908085,1544985,2025-04-10,Senate,"Assembly 3rd Reading AB100 Gabriel By Wiener",29,7,0,4,40
1908085,1544986,2025-04-10,Assembly,"AB 100 GABRIEL Concurrence in Senate Amendments Appeal the Decision of the Speaker By DEMAIO",18,53,0,8,79
1908085,1544987,2025-04-10,Assembly,"AB 100 GABRIEL Concurrence in Senate Amendments",56,7,0,16,79
1908086,1523669,2025-03-20,Assembly,"AB 101 Gabriel Assembly Third Reading",53,17,0,10,80
1908087,1523502,2025-03-20,Assembly,"AB 102 Gabriel Assembly Third Reading",53,17,0,10,80
1908088,1523587,2025-03-20,Assembly,"AB 103 Gabriel Assembly Third Reading",53,17,0,10,80
1908089,1523503,2025-03-20,Assembly,"AB 104 Gabriel Assembly Third Reading",53,17,0,10,80
1908090,1523658,2025-03-20,Assembly,"AB 105 Gabriel Assembly Third Reading",53,17,0,10,80
1908091,1523618,2025-03-20,Assembly,"AB 106 Gabriel Assembly Third Reading",53,17,0,10,80
1908092,1523528,2025-03-20,Assembly,"AB 107 Gabriel Assembly Third Reading",53,17,0,10,80
1908093,1523579,2025-03-20,Assembly,"AB 108 Gabriel Assembly Third Reading",53,17,0,10,80
1908094,1523672,2025-03-20,Assembly,"AB 109 Gabriel Assembly Third Reading",53,17,0,10,80
1908095,1523612,2025-03-20,Assembly,"AB 110 Gabriel Assembly Third Reading",53,17,0,10,80
1908096,1523601,2025-03-20,Assembly,"AB 111 Gabriel Assembly Third Reading",53,17,0,10,80
1908097,1523577,2025-03-20,Assembly,"AB 112 Gabriel Assembly Third Reading",53,17,0,10,80
1908098,1523536,2025-03-20,Assembly,"AB 113 Gabriel Assembly Third Reading",53,17,0,10,80
1908099,1523498,2025-03-20,Assembly,"AB 114 Gabriel Assembly Third Reading",53,17,0,10,80
1908100,1523717,2025-03-20,Assembly,"AB 115 Gabriel Assembly Third Reading",53,17,0,10,80
1908101,1523469,2025-03-20,Assembly,"AB 116 Gabriel Assembly Third Reading",53,17,0,10,80
1908102,1523644,2025-03-20,Assembly,"AB 117 Gabriel Assembly Third Reading",53,17,0,10,80
1908103,1523600,2025-03-20,Assembly,"AB 118 Gabriel Assembly Third Reading",53,17,0,10,80
1908104,1523646,2025-03-20,Assembly,"AB 119 Gabriel Assembly Third Reading",53,17,0,10,80
1908105,1523467,2025-03-20,Assembly,"AB 120 Gabriel Assembly Third Reading",53,17,0,10,80
1908106,1523624,2025-03-20,Assembly,"AB 121 Gabriel Assembly Third Reading",53,17,0,10,80
1908107,1523656,2025-03-20,Assembly,"AB 122 Gabriel Assembly Third Reading",53,17,0,10,80
1908108,1523698,2025-03-20,Assembly,"AB 123 Gabriel Assembly Third Reading",53,17,0,10,80
1908109,1523671,2025-03-20,Assembly,"AB 124 Gabriel Assembly Third Reading",53,17,0,10,80
1908110,1523650,2025-03-20,Assembly,"AB 125 Gabriel Assembly Third Reading",53,17,0,10,80
1908111,1523485,2025-03-20,Assembly,"AB 126 Gabriel Assembly Third Reading",53,17,0,10,80
1908112,1523512,2025-03-20,Assembly,"AB 127 Gabriel Assembly Third Reading",53,17,0,10,80
1908113,1523592,2025-03-20,Assembly,"AB 128 Gabriel Assembly Third Reading",53,17,0,10,80
1908114,1523522,2025-03-20,Assembly,"AB 129 Gabriel Assembly Third Reading",53,17,0,10,80
1908115,1523663,2025-03-20,Assembly,"AB 130 Gabriel Assembly Third Reading",53,17,0,10,80
1908116,1523674,2025-03-20,Assembly,"AB 131 Gabriel Assembly Third Reading",53,17,0,10,80
1908117,1523697,2025-03-20,Assembly,"AB 132 Gabriel Assembly Third Reading",53,17,0,10,80
1908118,1523682,2025-03-20,Assembly,"AB 133 Gabriel Assembly Third Reading",53,17,0,10,80
1908119,1523688,2025-03-20,Assembly,"AB 134 Gabriel Assembly Third Reading",53,17,0,10,80
1908120,1523478,2025-03-20,Assembly,"AB 135 Gabriel Assembly Third Reading",53,17,0,10,80
1908121,1523709,2025-03-20,Assembly,"AB 136 Gabriel Assembly Third Reading",53,17,0,10,80
1908122,1523719,2025-03-20,Assembly,"AB 137 Gabriel Assembly Third Reading",53,17,0,10,80
1908123,1523483,2025-03-20,Assembly,"AB 138 Gabriel Assembly Third Reading",53,17,0,10,80
1908124,1523497,2025-03-20,Assembly,"AB 139 Gabriel Assembly Third Reading",53,17,0,10,80
1908125,1523445,2025-03-20,Assembly,"AB 140 Gabriel Assembly Third Reading",53,17,0,10,80
1908126,1523465,2025-03-20,Assembly,"AB 141 Gabriel Assembly Third Reading",53,17,0,10,80
1908127,1523565,2025-03-20,Assembly,"AB 142 Gabriel Assembly Third Reading",53,17,0,10,80
1908128,1523508,2025-03-20,Assembly,"AB 143 Gabriel Assembly Third Reading",53,17,0,10,80
1908129,1523628,2025-03-20,Assembly,"AB 144 Gabriel Assembly Third Reading",53,17,0,10,80
1908130,1523456,2025-03-20,Assembly,"AB 145 Gabriel Assembly Third Reading",53,17,0,10,80
1908131,1523513,2025-03-20,Assembly,"AB 146 Gabriel Assembly Third Reading",53,17,0,10,80
1908132,1523720,2025-03-20,Assembly,"AB 147 Gabriel Assembly Third Reading",53,17,0,10,80
1908133,1523514,2025-03-20,Assembly,"AB 148 Gabriel Assembly Third Reading",53,17,0,10,80
1908134,1523439,2025-03-20,Assembly,"AB 149 Gabriel Assembly Third Reading",53,17,0,10,80
1908135,1523583,2025-03-20,Assembly,"AB 150 Gabriel Assembly Third Reading",53,17,0,10,80
1908136,1523648,2025-03-20,Assembly,"AB 151 Gabriel Assembly Third Reading",53,17,0,10,80
1908137,1523633,2025-03-20,Assembly,"AB 152 Gabriel Assembly Third Reading",53,17,0,10,80
1908138,1523598,2025-03-20,Assembly,"AB 153 Gabriel Assembly Third Reading",53,17,0,10,80
1908139,1523617,2025-03-20,Assembly,"AB 154 Gabriel Assembly Third Reading",53,17,0,10,80
1908140,1523676,2025-03-20,Assembly,"AB 155 Gabriel Assembly Third Reading",53,17,0,10,80
1908141,1523486,2025-03-20,Assembly,"AB 156 Gabriel Assembly Third Reading",53,17,0,10,80
1908142,1523572,2025-03-20,Assembly,"AB 157 Gabriel Assembly Third Reading",53,17,0,10,80
1908143,1523702,2025-03-20,Assembly,"AB 158 Gabriel Assembly Third Reading",53,17,0,10,80
1908144,1523447,2025-03-20,Assembly,"AB 159 Gabriel Assembly Third Reading",53,17,0,10,80
1908145,1523477,2025-03-20,Assembly,"AB 160 Gabriel Assembly Third Reading",53,17,0,10,80
1908146,1523491,2025-03-20,Assembly,"AB 161 Gabriel Assembly Third Reading",53,17,0,10,80
1908147,1523463,2025-03-20,Assembly,"AB 162 Gabriel Assembly Third Reading",53,17,0,10,80
1908148,1523473,2025-03-20,Assembly,"AB 163 Gabriel Assembly Third Reading",53,17,0,10,80
1908149,1523666,2025-03-20,Assembly,"AB 164 Gabriel Assembly Third Reading",53,17,0,10,80
1908150,1523442,2025-03-20,Assembly,"AB 165 Gabriel Assembly Third Reading",53,17,0,10,80
1908151,1523683,2025-03-20,Assembly,"AB 166 Gabriel Assembly Third Reading",53,17,0,10,80
1908152,1523471,2025-03-20,Assembly,"AB 167 Gabriel Assembly Third Reading",53,17,0,10,80
1908153,1523608,2025-03-20,Assembly,"AB 168 Gabriel Assembly Third Reading",53,17,0,10,80
1908154,1523679,2025-03-20,Assembly,"AB 169 Gabriel Assembly Third Reading",53,17,0,10,80
1908155,1523621,2025-03-20,Assembly,"AB 170 Gabriel Assembly Third Reading",53,17,0,10,80
1908156,1523647,2025-03-20,Assembly,"AB 171 Gabriel Assembly Third Reading",53,17,0,10,80
1908157,1523541,2025-03-20,Assembly,"AB 172 Gabriel Assembly Third Reading",53,17,0,10,80
1908158,1523476,2025-03-20,Assembly,"AB 173 Gabriel Assembly Third Reading",53,17,0,10,80
1908159,1523451,2025-03-20,Assembly,"AB 174 Gabriel Assembly Third Reading",53,17,0,10,80
1908160,1523517,2025-03-20,Assembly,"AB 175 Gabriel Assembly Third Reading",53,17,0,10,80
1908161,1523542,2025-03-20,Assembly,"AB 176 Gabriel Assembly Third Reading",53,17,0,10,80
1908162,1523440,2025-03-20,Assembly,"AB 177 Gabriel Assembly Third Reading",53,17,0,10,80
1908163,1523700,2025-03-20,Assembly,"AB 178 Gabriel Assembly Third Reading",53,17,0,10,80
1908164,1523588,2025-03-20,Assembly,"AB 179 Gabriel Assembly Third Reading",53,17,0,10,80
1908165,1523454,2025-03-20,Assembly,"AB 180 Gabriel Assembly Third Reading",53,17,0,10,80
1908166,1523461,2025-03-20,Assembly,"AB 181 Gabriel Assembly Third Reading",53,17,0,10,80
1908167,1523681,2025-03-20,Assembly,"AB 182 Gabriel Assembly Third Reading",53,17,0,10,80
1908168,1523655,2025-03-20,Assembly,"AB 183 Gabriel Assembly Third Reading",53,17,0,10,80
1908169,1523532,2025-03-20,Assembly,"AB 184 Gabriel Assembly Third Reading",53,17,0,10,80
1908170,1523718,2025-03-20,Assembly,"AB 185 Gabriel Assembly Third Reading",53,17,0,10,80
1908171,1523667,2025-03-20,Assembly,"AB 186 Gabriel Assembly Third Reading",53,17,0,10,80
1908172,1523678,2025-03-20,Assembly,"AB 187 Gabriel Assembly Third Reading",53,17,0,10,80
1908173,1523580,2025-03-20,Assembly,"AB 188 Gabriel Assembly Third Reading",53,17,0,10,80
1908174,1523540,2025-03-20,Assembly,"AB 189 Gabriel Assembly Third Reading",53,17,0,10,80
1908175,1523707,2025-03-20,Assembly,"AB 190 Gabriel Assembly Third Reading",53,17,0,10,80
1908176,1523639,2025-03-20,Assembly,"AB 191 Gabriel Assembly Third Reading",53,17,0,10,80
1908177,1523680,2025-03-20,Assembly,"AB 192 Gabriel Assembly Third Reading",53,17,0,10,80
1908178,1523609,2025-03-20,Assembly,"AB 193 Gabriel Assembly Third Reading",53,17,0,10,80
1908179,1523616,2025-03-20,Assembly,"AB 194 Gabriel Assembly Third Reading",53,17,0,10,80
1908180,1523526,2025-03-20,Assembly,"AB 195 Gabriel Assembly Third Reading",53,17,0,10,80
1908181,1523569,2025-03-20,Assembly,"AB 196 Gabriel Assembly Third Reading",53,17,0,10,80
1908182,1523552,2025-03-20,Assembly,"AB 197 Gabriel Assembly Third Reading",53,17,0,10,80
1908183,1523643,2025-03-20,Assembly,"AB 198 Gabriel Assembly Third Reading",53,17,0,10,80
1908184,1523561,2025-03-20,Assembly,"AB 199 Gabriel Assembly Third Reading",53,17,0,10,80
1908185,1523488,2025-03-20,Assembly,"AB 200 Gabriel Assembly Third Reading",53,17,0,10,80
1908186,1523533,2025-03-20,Assembly,"AB 201 Gabriel Assembly Third Reading",53,17,0,10,80
1908187,1523706,2025-03-20,Assembly,"AB 202 Gabriel Assembly Third Reading",53,17,0,10,80
1908188,1523563,2025-03-20,Assembly,"AB 203 Gabriel Assembly Third Reading",53,17,0,10,80
1908189,1523627,2025-03-20,Assembly,"AB 204 Gabriel Assembly Third Reading",53,17,0,10,80
1908190,1523641,2025-03-20,Assembly,"AB 205 Gabriel Assembly Third Reading",53,17,0,10,80
1908191,1523668,2025-03-20,Assembly,"AB 206 Gabriel Assembly Third Reading",53,17,0,10,80
1908192,1523444,2025-03-20,Assembly,"AB 207 Gabriel Assembly Third Reading",53,17,0,10,80
1908193,1523543,2025-03-20,Assembly,"AB 208 Gabriel Assembly Third Reading",53,17,0,10,80
1908194,1523475,2025-03-20,Assembly,"AB 209 Gabriel Assembly Third Reading",53,17,0,10,80
1908195,1523638,2025-03-20,Assembly,"AB 210 Gabriel Assembly Third Reading",53,17,0,10,80
1908196,1523452,2025-03-20,Assembly,"AB 211 Gabriel Assembly Third Reading",53,17,0,10,80
1908197,1523481,2025-03-20,Assembly,"AB 212 Gabriel Assembly Third Reading",53,17,0,10,80
1908198,1523548,2025-03-20,Assembly,"AB 213 Gabriel Assembly Third Reading",53,17,0,10,80
1908199,1523455,2025-03-20,Assembly,"AB 214 Gabriel Assembly Third Reading",53,17,0,10,80
1908200,1523559,2025-03-20,Assembly,"AB 215 Gabriel Assembly Third Reading",53,17,0,10,80
1908201,1523584,2025-03-20,Assembly,"AB 216 Gabriel Assembly Third Reading",53,17,0,10,80
1908202,1523558,2025-03-20,Assembly,"AB 217 Gabriel Assembly Third Reading",53,17,0,10,80
1908203,1523595,2025-03-20,Assembly,"AB 218 Gabriel Assembly Third Reading",53,17,0,10,80
1908204,1523539,2025-03-20,Assembly,"AB 219 Gabriel Assembly Third Reading",53,17,0,10,80
1908205,1556052,2025-04-22,Assembly,"Do pass and be re-referred to the Committee on [Appropriations]",16,0,0,0,16
1908206,1556154,2025-04-23,Assembly,"Do pass and be re-referred to the Committee on [Appropriations]",22,0,0,0,22
1908207,1535033,2025-04-02,Assembly,"Do pass as amended and be re-referred to the Committee on [Privacy and Consumer Protection]",13,5,0,0,18
1908207,1564262,2025-05-01,Assembly,"Do pass as amended and be re-referred to the Committee on [Appropriations]",10,1,0,4,15
1908208,1528263,2025-03-26,Assembly,"Do pass as amended and be re-referred to the Committee on [Appropriations]",12,1,0,5,18
1908209,1474060,2025-01-23,Assembly,"Be adopted. To third reading",10,0,0,1,11
1908210,1538904,2025-04-07,Senate,"Do pass as amended, but first amend, and re-refer to the Committee on [Appropriations]",12,3,0,2,17
1908210,1559464,2025-04-28,Senate,"Placed on suspense file",7,0,0,0,7
1908212,1555936,2025-04-22,Senate,"Do pass as amended, but first amend, and re-refer to the Committee on [Appropriations]",11,2,0,0,13
1908212,1565264,2025-05-05,Senate,"Placed on suspense file",7,0,0,0,7
1908213,1521969,2025-03-19,Senate,"Do pass, but first be re-referred to the Committee on [Military and Veterans Affairs]",7,0,0,0,7
1908213,1559498,2025-04-28,Senate,"Do pass, but first be re-referred to the Committee on [Appropriations]",4,0,0,1,5
1908214,1473359,2025-01-22,Senate,"Do pass",8,2,0,0,10
1908214,1474139,2025-01-23,Senate,"Senate 3rd Reading SB2 Wiener et al",28,8,0,3,39
1908214,1479314,2025-02-03,Assembly,"SB 2 Wiener Senate Third Reading By GABRIEL Amend By CASTILLO Set #1 Motion to Lay on the Table By AGUIAR-CURRY First Extraordinary Session",55,18,0,6,79
1908214,1479315,2025-02-03,Assembly,"SB 2 Wiener Senate Third Reading By GABRIEL First Extraordinary Session",58,17,0,4,79
1909884,1505302,2025-03-04,Assembly,"Do pass. To Consent Calendar",12,0,0,0,12
1909884,1511454,2025-03-10,Assembly,"AB 223 Pacheco Consent Calendar Second Day Regular Session",72,0,0,8,80
1909885,1563112,2025-04-29,Assembly,"Do pass and be re-referred to the Committee on [Appropriations]",14,0,0,2,16
1909886,1526937,2025-03-25,Assembly,"Do pass and be re-referred to the Committee on [Appropriations] with recommendation: To Consent Calendar",15,0,0,0,15
1909886,1542797,2025-04-09,Assembly,"Do pass. To Consent Calendar",14,0,0,1,15
1909886,1557565,2025-04-24,Assembly,"AB 225 Bonta Consent Calendar Second Day Regular Session",75,0,0,4,79
1909887,1506678,2025-03-05,Assembly,"Do pass and be re-referred to the Committee on [Appropriations]",12,0,0,5,17
1909887,1521983,2025-03-19,Assembly,"Do pass",15,0,0,0,15
1909887,1533554,2025-04-01,Assembly,"AB 226 Calderon Third Reading Urgency",77,0,0,3,80
1909888,1520436,2025-03-18,Assembly,"Be adopted as amended. To Consent Calendar",9,0,0,0,9
1909889,1542720,2025-04-08,Senate,"Do pass and be ordered to the Consent Calendar",13,0,0,0,13
1909889,1557497,2025-04-24,Senate,"Consent Calendar 2nd SB61 Cortese",37,0,0,3,40
1909890,1564227,2025-04-30,Senate,"Do pass, but first be re-referred to the Committee on [Appropriations]",11,0,0,0,11
1909891,1554639,2025-04-22,Senate,"Do pass, but first be re-referred to the Committee on [Revenue and Taxation]",11,3,0,1,15
1909891,1556186,2025-04-23,Senate,"Do pass as amended, but first amend, and re-refer to the Committee on [Appropriations]",4,1,0,0,5
1909892,1522024,2025-03-19,Senate,"Do pass, but first be re-referred to the Committee on [Revenue and Taxation]",2,5,0,0,7
1909892,1522025,2025-03-19,Senate,"[First] hearing set for [03-19-2025]: Failed passage in Committee. Reconsideration granted",7,0,0,0,7
1909893,1475142,2025-01-27,Senate,"Senate 3rd Reading SCR10 Grove",36,0,0,3,39
1909893,1479229,2025-02-03,Assembly,"Be adopted. To Consent Calendar",11,0,0,0,11
1909893,1483665,2025-02-06,Assembly,"SCR 10 Grove Consent Calendar Second Day Regular Session",72,0,0,7,79
1909896,1475145,2025-01-27,Senate,"Senate 3rd Reading SR11 Alvarado-Gil et al",36,0,0,3,39
1916608,1516580,2025-03-12,Assembly,"Do pass and be re-referred to the Committee on [Appropriations]",8,0,0,1,9
1916609,1505301,2025-03-04,Assembly,"Do pass and be re-referred to the Committee on [Appropriations]",8,0,0,1,9
1916611,1566698,2025-05-05,Assembly,"Do pass and be re-referred to the Committee on [Appropriations]",7,0,0,0,7
1916612,1503922,2025-03-03,Assembly,"Do pass and be re-referred to the Committee on [Revenue and Taxation]",8,0,0,1,9
1916612,1566717,2025-05-05,Assembly,"Do pass and be re-referred to the Committee on [Appropriations]",7,0,0,0,7
1916613,1521949,2025-03-19,Assembly,"Do pass and be re-referred to the Committee on [Appropriations] with recommendation: To Consent Calendar",19,0,0,3,22
1916613,1542777,2025-04-09,Assembly,"Do pass. To Consent Calendar",14,0,0,1,15
1916613,1557512,2025-04-24,Assembly,"AB 233 Gipson Consent Calendar Second Day Regular Session",75,0,0,4,79
1916614,1535029,2025-04-02,Assembly,"Do pass",16,0,0,1,17
1916614,1538952,2025-04-07,Assembly,"AB 234 Calderon Third Reading Urgency",66,0,0,13,79
1916615,1545049,2025-04-09,Assembly,"Do pass as amended and be re-referred to the Committee on [Appropriations]",7,1,0,1,9
1916616,1503910,2025-03-03,Assembly,"Do pass and be re-referred to the Committee on [Appropriations]",8,0,0,1,9
1916617,1505304,2025-03-04,Assembly,"Do pass as amended and be re-referred to the Committee on [Appropriations]",9,0,0,0,9
1916618,1503911,2025-03-03,Assembly,"Do pass and be re-referred to the Committee on [Judiciary]",6,0,0,3,9
1916618,1505306,2025-03-04,Assembly,"Do pass and be re-referred to the Committee on [Appropriations]",11,0,0,1,12
1916618,1522001,2025-03-19,Assembly,"Do pass",13,0,0,2,15
1916618,1538987,2025-04-07,Assembly,"AB 238 Harabedian Third Reading Urgency",70,0,0,9,79
1916619,1528264,2025-03-26,Assembly,"Do pass as amended and be re-referred to the Committee on [Emergency Management]",11,0,0,0,11
1916619,1540975,2025-04-07,Assembly,"Do pass and be re-referred to the Committee on [Appropriations]",7,0,0,0,7
1916621,1535140,2025-04-01,Senate,"Do pass and be ordered to the Consent Calendar",13,0,0,0,13
1916621,1545050,2025-04-10,Senate,"Consent Calendar 2nd SB66 Umberg",35,0,0,5,40
1916622,1521973,2025-03-19,Senate,"Do pass, but first be re-referred to the Committee on [Military and Veterans Affairs]",7,0,0,0,7
1916622,1559481,2025-04-28,Senate,"Do pass, but first be re-referred to the Committee on [Appropriations] with the recommendation: To Consent Calendar",4,0,0,1,5
1916623,1545025,2025-04-09,Senate,"Do pass, but first be re-referred to the Committee on [Appropriations]",11,0,0,0,11
1916623,1559493,2025-04-28,Senate,"Placed on suspense file",7,0,0,0,7
1916624,1474057,2025-01-23,Senate,"Senate 3rd Reading SCR12 Umberg",36,0,0,3,39
1916624,1565339,2025-05-05,Assembly,"Be adopted. To Consent Calendar",9,0,0,2,11
1916624,1568600,2025-05-08,Assembly,"SCR 12 Umberg Consent Calendar Second Day Regular Session",69,0,0,10,79
1916625,1477880,2025-01-30,Senate,"Senate 3rd Reading SCR13 Grayson et al",36,0,0,3,39
1916625,1485609,2025-02-10,Assembly,"Be adopted. To Consent Calendar",9,0,0,2,11
1916626,1479226,2025-02-03,Senate,"Senate 3rd Reading SR12 Wahab et al",38,0,0,1,39
1919265,1521971,2025-03-18,Assembly,"Do pass and be re-referred to the Committee on [Appropriations] with recommendation: To Consent Calendar",9,0,0,1,10
1919267,1533594,2025-04-01,Assembly,"Do pass and be re-referred to the Committee on [Appropriations] with recommendation: To Consent Calendar",15,0,0,0,15
1919268,1522017,2025-03-18,Assembly,"Do pass and be re-referred to the Committee on [Judiciary]",8,0,0,2,10
1919268,1540794,2025-04-08,Assembly,"Do pass and be re-referred to the Committee on [Appropriations] with recommendation: To Consent Calendar",12,0,0,0,12
1919268,1556187,2025-04-23,Assembly,"Do pass. To Consent Calendar",15,0,0,0,15
1919268,1564264,2025-05-01,Assembly,"AB 243 Ahrens Consent Calendar Second Day Regular Session",76,0,0,3,79
1919270,1561107,2025-04-28,Assembly,"Do pass as amended and be re-referred to the Committee on [Appropriations]",7,0,0,0,7
1919271,1490596,2025-02-14,Senate,"Special Consent ACR14 Michelle Rodriguez",34,0,0,5,39
1919272,1511440,2025-03-10,Assembly,"Be adopted. To Consent Calendar",9,0,0,2,11
1919272,1517611,2025-03-13,Assembly,"HR 9 Lackey Consent Calendar Second Day Regular Session",68,0,0,12,80
1919273,1556178,2025-04-23,Senate,"Do pass as amended, but first amend, and re-refer to the Committee on [Appropriations] with the recommendation: To Consent Calendar",8,0,0,0,8
1919273,1565230,2025-05-05,Senate,"Placed on suspense file",7,0,0,0,7
1919274,1515275,2025-03-11,Senate,"Do pass, but first be re-referred to the Committee on [Appropriations] with the recommendation: To Consent Calendar",14,0,0,1,15
1919274,1538918,2025-04-07,Senate,"Placed on suspense file",7,0,0,0,7
1919275,1521967,2025-03-19,Senate,"Do pass as amended, but first amend, and re-refer to the Committee on [Transportation]",8,0,0,0,8
1919275,1542849,2025-04-08,Senate,"Do pass, but first be re-referred to the Committee on [Appropriations]",12,0,0,3,15
1919275,1559409,2025-04-28,Senate,"Placed on suspense file",7,0,0,0,7
1922275,1505320,2025-03-04,Assembly,"Do pass as amended",8,3,0,1,12
1922275,1561136,2025-04-29,Assembly,"Do pass as amended and be re-referred to the Committee on [Appropriations]",8,3,0,1,12
1922276,1515250,2025-03-11,Assembly,"Do pass and be re-referred to the Committee on [Appropriations]",8,0,0,1,9
1922277,1515248,2025-03-11,Assembly,"Do pass",6,0,0,3,9
1922277,1523727,2025-03-20,Assembly,"AB 248 Bryan Assembly Third Reading",51,12,0,17,80
1922278,1528250,2025-03-26,Assembly,"Do pass as amended and be re-referred to the Committee on [Human Services]",11,0,0,0,11
1922278,1540897,2025-04-08,Assembly,"Do pass and be re-referred to the Committee on [Appropriations] with recommendation: To Consent Calendar",6,0,0,0,6
1922279,1515264,2025-03-11,Assembly,"Do pass and be re-referred to the Committee on [Appropriations]",9,2,0,1,12
1922280,1526883,2025-03-25,Assembly,"Do pass",8,2,0,2,12
1922280,1533524,2025-04-01,Assembly,"AB 251 Kalra Assembly Third Reading",57,8,0,15,80
1922281,1538939,2025-04-07,Assembly,"Do pass and be re-referred to the Committee on [Appropriations]",14,0,0,0,14
1922282,1516581,2025-03-12,Assembly,"Do pass as amended and be re-referred to the Committee on [Appropriations]",10,0,0,0,10
1922282,1516582,2025-03-12,Assembly,"Do pass and be re-referred to the Committee on [Local Government]",11,0,0,1,12
1922282,1522023,2025-03-19,Assembly,"Do pass",13,0,0,2,15
1922282,1533547,2025-04-01,Assembly,"AB 253 Ward Third Reading Urgency",76,0,0,4,80
1922283,1554433,2025-04-22,Assembly,"Do pass and be re-referred to the Committee on [Appropriations] with recommendation: To Consent Calendar",8,0,0,0,8
1922284,1530386,2025-03-28,Assembly,"Be adopted. To third reading",7,0,0,4,11
1922285,1540816,2025-04-08,Senate,"Do pass as amended, but first amend, and re-refer to the Committee on [Appropriations]",6,0,0,1,7
1922285,1559451,2025-04-28,Senate,"Placed on suspense file",7,0,0,0,7
1922287,1536767,2025-04-02,Senate,"Do pass as amended, but first amend, and re-refer to the Committee on [Appropriations]",7,0,0,0,7
1922287,1552888,2025-04-21,Senate,"Placed on suspense file",6,0,0,1,7
1922288,1555908,2025-04-23,Senate,"Do pass, but first be re-referred to the Committee on [Public Safety]",5,0,0,0,5
1922288,1562764,2025-04-29,Senate,"Do pass, but first be re-referred to the Committee on [Appropriations]",6,0,0,0,6
1922289,1526941,2025-03-25,Senate,"Do pass, but first be re-referred to the Committee on [Appropriations]",14,0,0,1,15
1922289,1538892,2025-04-07,Senate,"Placed on suspense file",7,0,0,0,7
1922290,1515269,2025-03-11,Senate,"Do pass as amended, but first amend, and re-refer to the Committee on [Appropriations]",13,0,0,2,15
1922290,1538899,2025-04-07,Senate,"Placed on suspense file",7,0,0,0,7
1922291,1542883,2025-04-08,Senate,"Do pass, but first be re-referred to the Committee on [Appropriations] with the recommendation: To Consent Calendar",15,0,0,0,15
1922291,1552891,2025-04-21,Senate,"Placed on suspense file",6,0,0,1,7
1922292,1556032,2025-04-22,Senate,"Do pass, but first be re-referred to the Committee on [Local Government]",6,2,0,3,11
1922292,1562872,2025-04-30,Senate,"Do pass, but first be re-referred to the Committee on [Appropriations]",4,3,0,0,7
1926272,1558387,2025-04-24,Assembly,"Do pass and be re-referred to the Committee on [Health]",12,0,0,0,12
1926272,1562934,2025-04-29,Assembly,"Do pass and be re-referred to the Committee on [Appropriations]",15,0,0,1,16
1926274,1526999,2025-03-25,Assembly,"Do pass as amended and be re-referred to the Committee on [Appropriations]",15,0,0,0,15
1926275,1561065,2025-04-28,Assembly,"Do pass as amended and be re-referred to the Committee on [Appropriations]",6,1,0,0,7
1926276,1542896,2025-04-09,Assembly,"Do pass as amended",9,0,0,1,10
1926276,1565255,2025-05-05,Assembly,"AB 259 Blanca Rubio Assembly Third Reading",73,0,0,6,79
1926277,1540981,2025-04-08,Assembly,"Do pass and be re-referred to the Committee on [Business and Professions]",12,1,0,2,15
1926277,1561028,2025-04-29,Assembly,"Do pass and be re-referred to the Committee on [Appropriations]",14,1,0,3,18
1926279,1525460,2025-03-24,Assembly,"Do pass as amended, and be re-referred to the Committee on [Emergency Management] with recommendation: To Consent Calendar",13,0,0,1,14
1926279,1561115,2025-04-28,Assembly,"Do pass and be re-referred to the Committee on [Appropriations] with recommendation: To Consent Calendar",7,0,0,0,7
1926280,1540856,2025-04-07,Assembly,"Do pass and be re-referred to the Committee on [Appropriations]",5,2,0,0,7
1926281,1540982,2025-04-08,Assembly,"Do pass as amended and be re-referred to the Committee on [Appropriations]",9,3,0,1,13
1926281,1556180,2025-04-23,Assembly,"Do pass",11,4,0,0,15
1926281,1565233,2025-05-05,Assembly,"AB 263 Rogers Assembly Third Reading",56,17,0,6,79
1926282,1544966,2025-04-08,Assembly,"Do pass and be re-referred to the Committee on [Appropriations]",7,0,0,1,8
1926283,1558361,2025-04-24,Assembly,"Be adopted and re-referred to the Committee on [Higher Education]",10,0,0,2,12
1926283,1561105,2025-04-29,Assembly,"Be adopted and re-referred to the Committee on [Appropriations]",7,3,0,0,10
1926284,1561130,2025-04-28,Assembly,"Be adopted. To Consent Calendar",16,0,0,0,16
1926284,1564159,2025-05-01,Assembly,"ACR 16 Gallagher Consent Calendar Second Day Regular Session",76,0,0,3,79
1926285,1554584,2025-04-21,Senate,"Do pass as amended, but first amend, and re-refer to the Committee on [Appropriations]",16,0,0,1,17
1929337,1554471,2025-04-22,Assembly,"Do pass and be re-referred to the Committee on [Appropriations]",8,0,0,0,8
1929338,1525470,2025-03-24,Assembly,"Do pass. To Consent Calendar",16,0,0,0,16
1929338,1530389,2025-03-28,Assembly,"AB 266 Davies Consent Calendar Second Day Regular Session",62,0,0,18,80
1929340,1535065,2025-04-02,Assembly,"Do pass and be re-referred to the Committee on [Public Employment and Retirement]",19,0,0,3,22
1929340,1556077,2025-04-23,Assembly,"Do pass and be re-referred to the Committee on [Appropriations]",7,0,0,0,7
1929342,1474062,2025-01-23,Assembly,"Be adopted. To Consent Calendar",10,0,0,1,11
1929342,1477877,2025-01-30,Assembly,"ACR 17 Hadwick Consent Calendar Second Day",69,0,0,10,79
1929342,1517820,2025-03-13,Senate,"Special Consent ACR17 Hadwick et al",36,0,0,4,40
1929343,1557592,2025-04-23,Senate,"Do pass, but first be re-referred to the Committee on [Judiciary]",9,1,0,1,11
1929343,1562817,2025-04-29,Senate,"Do pass as amended, but first amend, and re-refer to the Committee on [Appropriations]",11,0,0,2,13
1929344,1555915,2025-04-22,Senate,"Do pass, but first be re-referred to the Committee on [Appropriations]",11,2,0,0,13
1929344,1565324,2025-05-05,Senate,"Placed on suspense file",7,0,0,0,7
1929345,1557478,2025-04-23,Senate,"Do pass, but first be re-referred to the Committee on [Appropriations]",11,0,0,0,11
1929346,1556009,2025-04-22,Senate,"Do pass, but first be re-referred to the Committee on [Appropriations]",11,0,0,2,13
1929346,1565266,2025-05-05,Senate,"Placed on suspense file",7,0,0,0,7
1929347,1479233,2025-02-03,Senate,"Senate 3rd Reading SCR14 Caballero et al",33,0,0,6,39
1929347,1485617,2025-02-10,Assembly,"Be adopted. To Consent Calendar",9,0,0,2,11
1929348,1477882,2025-01-30,Senate,"Senate 3rd Reading SCR15 Umberg",36,0,0,3,39
1929348,1492765,2025-02-18,Assembly,"Be adopted. To Consent Calendar",10,0,0,1,11
1929348,1498297,2025-02-24,Assembly,"SCR 15 Umberg Consent Calendar Second Day",67,0,0,12,79
1930767,1473420,2025-01-22,Senate,"Do pass",10,0,0,0,10
1930775,1473424,2025-01-22,Senate,"Do pass",10,0,0,0,10
1930775,1474136,2025-01-23,Senate,"Senate 3rd Reading SB3 Wiener et al",36,0,0,3,39
1930775,1474137,2025-01-23,Assembly,"SB 3 Wiener Senate Third Reading By GABRIEL First Extraordinary Session",79,0,0,0,79
1930793,1474131,2025-01-23,Senate,"Assembly 2nd Reading AB4 Gabriel et al. By Wiener",36,0,0,3,39
1930793,1474132,2025-01-23,Assembly,"AB 4 Gabriel Assembly Third Reading Amend By GALLAGHER Set #1 Motion to Lay on the Table By AGUIAR-CURRY First Extraordinary Session",59,19,0,1,79
1930793,1474133,2025-01-23,Assembly,"AB 4 Gabriel Assembly Third Reading First Extraordinary Session",79,0,0,0,79
1933291,1540848,2025-04-07,Assembly,"Do pass and be re-referred to the Committee on [Privacy and Consumer Protection]",7,0,0,0,7
1933291,1564271,2025-05-01,Assembly,"Do pass as amended and be re-referred to the Committee on [Appropriations]",11,0,0,4,15
1933293,1525421,2025-03-24,Assembly,"Do pass and be re-referred to the Committee on [Appropriations] with recommendation: To Consent Calendar",16,0,0,0,16
1933293,1556147,2025-04-23,Assembly,"Do pass. To Consent Calendar",15,0,0,0,15
1933293,1564182,2025-05-01,Assembly,"AB 272 Aguiar-Curry Consent Calendar Second Day Regular Session",76,0,0,3,79
1933295,1525467,2025-03-24,Assembly,"Do pass as amended, and be re-referred to the Committee on [Appropriations] with recommendation: To Consent Calendar",13,0,0,1,14
1933297,1515283,2025-03-11,Assembly,"Do pass and be re-referred to the Committee on [Public Safety]",6,0,0,1,7
1933297,1535131,2025-04-01,Assembly,"Do pass and be re-referred to the Committee on [Appropriations] with recommendation: To Consent Calendar",9,0,0,0,9
1933300,1516559,2025-03-12,Assembly,"Do pass as amended and be re-referred to the Committee on [Appropriations]",8,0,0,1,9
1933301,1533533,2025-04-01,Assembly,"Do pass and be re-referred to the Committee on [Appropriations]",11,0,0,4,15
1933302,1567895,2025-05-06,Senate,"Do pass and be ordered to the Consent Calendar",12,0,0,1,13
1933303,1528249,2025-03-26,Senate,"Do pass, but first be re-referred to the Committee on [Appropriations]",5,0,0,0,5
1933303,1538970,2025-04-07,Senate,"Placed on suspense file",7,0,0,0,7
1933304,1516585,2025-03-12,Senate,"Do pass, but first be re-referred to the Committee on [Appropriations] with the recommendation: To Consent Calendar",5,0,0,0,5
1933304,1538996,2025-04-07,Senate,"Placed on suspense file",7,0,0,0,7
1936622,1516573,2025-03-12,Assembly,"Do pass and be re-referred to the Committee on [Appropriations]",4,3,0,2,9
1936622,1544973,2025-04-09,Assembly,"Do pass",5,3,0,1,9
1936623,1528284,2025-03-26,Assembly,"Do pass and be re-referred to the Committee on [Judiciary]",8,2,0,1,11
1936623,1540906,2025-04-08,Assembly,"Do pass as amended and be re-referred to the Committee on [Appropriations]",9,3,0,0,12
1936623,1556043,2025-04-23,Assembly,"Do pass",11,4,0,0,15
1936623,1568633,2025-05-08,Assembly,"AB 282 Pellerin Assembly Third Reading",53,13,0,13,79
1936624,1522022,2025-03-19,Assembly,"Do pass and be re-referred to the Committee on [Appropriations]",7,0,0,0,7
1936625,1563088,2025-04-29,Assembly,"Do pass as amended and be re-referred to the Committee on [Appropriations]",7,1,0,1,9
1936626,1505300,2025-03-04,Assembly,"Do pass and be re-referred to the Committee on [Appropriations] with recommendation: To Consent Calendar",9,0,0,0,9
1936627,1564156,2025-04-30,Assembly,"Do pass and be re-referred to the Committee on [Appropriations] with recommendation: To Consent Calendar",18,0,0,0,18
1936628,1528287,2025-03-26,Assembly,"Do pass",7,0,0,0,7
1936628,1538947,2025-04-07,Assembly,"AB 287 Lackey Assembly Third Reading",72,0,0,7,79
1936629,1534982,2025-04-02,Assembly,"Do pass and be re-referred to the Committee on [Labor and Employment]",6,0,0,1,7
1936629,1557510,2025-04-23,Assembly,"Do pass and be re-referred to the Committee on [Appropriations]",7,0,0,0,7
1936630,1538931,2025-04-07,Assembly,"Do pass and be re-referred to the Committee on [Privacy and Consumer Protection]",15,0,0,1,16
1936630,1564189,2025-05-01,Assembly,"Do pass as amended and be re-referred to the Committee on [Appropriations]",11,2,0,2,15
1936631,1563011,2025-04-30,Assembly,"Do pass as amended and be re-referred to the Committee on [Appropriations]",16,0,0,1,17
1936632,1545022,2025-04-09,Assembly,"Do pass as amended and be re-referred to the Committee on [Labor and Employment]",9,0,0,0,9
1936632,1557561,2025-04-23,Assembly,"Do pass and be re-referred to the Committee on [Appropriations]",7,0,0,0,7
1936634,1526971,2025-03-25,Assembly,"Do pass",11,2,0,0,13
1936634,1533530,2025-04-01,Assembly,"AB 293 Bennett Assembly Third Reading",62,5,0,13,80
1936635,1474059,2025-01-23,Assembly,"Be adopted. To third reading",10,0,0,1,11
1936635,1490597,2025-02-14,Senate,"Special Consent ACR18 Sharp-Collins et al",34,0,0,5,39
1936636,1521959,2025-03-19,Senate,"Do pass as amended, but first amend, and re-refer to the Committee on [Natural Resources and Water]",8,0,0,0,8
1936636,1554474,2025-04-22,Senate,"Do pass, but first be re-referred to the Committee on [Appropriations]",6,0,0,1,7
1936636,1565353,2025-05-05,Senate,"Placed on suspense file",7,0,0,0,7
1936638,1515255,2025-03-11,Senate,"Do pass as amended, but first amend, and re-refer to the Committee on [Natural Resources and Water]",13,0,0,2,15
1936638,1554529,2025-04-22,Senate,"Do pass, but first be re-referred to the Committee on [Appropriations] with the recommendation: To Consent Calendar",6,0,0,1,7
1936638,1565367,2025-05-05,Senate,"Placed on suspense file",7,0,0,0,7
1936639,1561165,2025-04-29,Senate,"Do pass and be ordered to the Consent Calendar",5,0,0,0,5
1936639,1565246,2025-05-05,Senate,"Consent Calendar 2nd SB91 Cervantes",38,0,0,2,40
1936640,1520438,2025-03-18,Senate,"Do pass, but first be re-referred to the Committee on [Local Government]",9,1,0,1,11
1936640,1562921,2025-04-30,Senate,"Do pass as amended, but first amend, and re-refer to the Committee on [Appropriations]",6,0,0,1,7
1936641,1533510,2025-04-01,Senate,"Do pass as amended, but first amend, and re-refer to the Committee on [Appropriations]",6,0,0,0,6
1936641,1552895,2025-04-21,Senate,"Placed on suspense file",6,0,0,1,7
1939170,1540815,2025-04-07,Assembly,"Do pass and be re-referred to the Committee on [Appropriations]",7,0,0,0,7
1939172,1536796,2025-04-02,Assembly,"Do pass and be re-referred to the Committee on [Education]",5,2,0,0,7
1939173,1505297,2025-03-04,Assembly,"Do pass and be re-referred to the Committee on [Appropriations]",2,4,0,3,9
1939175,1516584,2025-03-12,Assembly,"Do pass",11,0,0,1,12
1939175,1533543,2025-04-01,Assembly,"AB 299 Gabriel Third Reading Urgency",77,0,0,3,80
1939176,1525446,2025-03-24,Assembly,"Do pass as amended, and be re-referred to the Committee on [Emergency Management] with recommendation: To Consent Calendar",13,0,0,1,14
1939176,1561086,2025-04-28,Assembly,"Do pass as amended and be re-referred to the Committee on [Appropriations]",7,0,0,0,7
1939176,1562836,2025-04-28,Assembly,"Amendments (Committee's)",7,0,0,0,7
1939177,1516576,2025-03-12,Assembly,"Do pass and be re-referred to the Committee on [Appropriations]",11,0,0,1,12
1939177,1521966,2025-03-19,Assembly,"Do pass",15,0,0,0,15
1939177,1533542,2025-04-01,Assembly,"AB 301 Schiavo Third Reading Urgency",76,0,0,4,80
1939178,1556047,2025-04-22,Assembly,"Do pass and be re-referred to the Committee on [Judiciary]",12,2,0,2,16
1939178,1561205,2025-04-29,Assembly,"Do pass as amended and be re-referred to the Committee on [Appropriations]",9,3,0,0,12
1939180,1526979,2025-03-25,Assembly,"Do pass and be re-referred to the Committee on [Appropriations] with recommendation: To Consent Calendar",15,0,0,0,15
1939183,1516574,2025-03-12,Assembly,"Do pass and be re-referred to the Committee on [Appropriations]",12,0,0,0,12
1939183,1521974,2025-03-19,Assembly,"Do pass",14,0,0,1,15
1939183,1533473,2025-04-01,Assembly,"AB 306 Schultz Third Reading Urgency",71,0,0,9,80
1939185,1562828,2025-04-29,Assembly,"Do pass. To Consent Calendar",7,0,0,0,7
1939185,1568609,2025-05-08,Assembly,"AB 308 Ramos Consent Calendar Second Day Regular Session",69,0,0,10,79
1939186,1540875,2025-04-08,Assembly,"Do pass and be re-referred to the Committee on [Appropriations]",12,1,0,2,15
1939186,1555962,2025-04-23,Assembly,"Do pass",11,3,0,1,15
1939187,1520416,2025-03-18,Assembly,"Do pass",9,0,0,0,9
1939187,1530384,2025-03-28,Assembly,"AB 310 Alanis Assembly Third Reading",61,0,0,19,80
1939188,1505319,2025-03-04,Assembly,"Do pass",12,0,0,0,12
1939188,1533482,2025-04-01,Assembly,"AB 311 McKinnor Third Reading Urgency",77,0,0,3,80
1939189,1528317,2025-03-26,Assembly,"Do pass",7,0,0,1,8
1939189,1533472,2025-04-01,Assembly,"AB 312 Alanis Assembly Third Reading",75,0,0,5,80
1939190,1522016,2025-03-18,Assembly,"Do pass and be re-referred to the Committee on [Appropriations] with recommendation: To Consent Calendar",9,0,0,1,10
1939190,1555968,2025-04-23,Assembly,"Do pass. To Consent Calendar",15,0,0,0,15
1939190,1564251,2025-05-01,Assembly,"AB 313 Ortega Consent Calendar Second Day Regular Session",76,0,0,3,79
1939191,1561135,2025-04-28,Assembly,"Do pass as amended and be re-referred to the Committee on [Appropriations]",12,4,0,0,16
1939192,1526985,2025-03-25,Assembly,"Do pass and be re-referred to the Committee on [Appropriations]",14,0,0,1,15
1939193,1485619,2025-02-10,Assembly,"Be adopted. To third reading",9,0,0,2,11
1939193,1517821,2025-03-13,Senate,"Special Consent ACR19 Macedo et al",36,0,0,4,40
1939194,1479230,2025-02-03,Assembly,"Be adopted. To third reading",11,0,0,0,11
1939194,1517822,2025-03-13,Senate,"Special Consent ACR20 Macedo et al",36,0,0,4,40
1939195,1479232,2025-02-03,Assembly,"Be adopted. To Consent Calendar",11,0,0,0,11
1939195,1483667,2025-02-06,Assembly,"HR 10 Bennett Consent Calendar Second Day Regular Session",72,0,0,7,79
1939196,1523472,2025-03-20,Senate,"Senate 3rd Reading SB100 B. & F.R. (Wiener)",28,10,0,2,40
1939197,1523459,2025-03-20,Senate,"Senate 3rd Reading SB101 B. & F.R. (Wiener)",28,10,0,2,40
1939198,1523599,2025-03-20,Senate,"Senate 3rd Reading SB102 B. & F.R. (Wiener)",28,10,0,2,40
1939199,1523661,2025-03-20,Senate,"Senate 3rd Reading SB103 B. & F.R. (Wiener)",28,10,0,2,40
1939200,1523578,2025-03-20,Senate,"Senate 3rd Reading SB104 B. & F.R. (Wiener)",28,10,0,2,40
1939201,1523622,2025-03-20,Senate,"Senate 3rd Reading SB105 B. & F.R. (Wiener)",28,10,0,2,40
1939202,1523573,2025-03-20,Senate,"Senate 3rd Reading SB106 B. & F.R. (Wiener)",28,10,0,2,40
1939203,1523470,2025-03-20,Senate,"Senate 3rd Reading SB107 B. & F.R. (Wiener)",28,10,0,2,40
1939204,1523581,2025-03-20,Senate,"Senate 3rd Reading SB108 B. & F.R. (Wiener)",28,10,0,2,40
1939205,1523645,2025-03-20,Senate,"Senate 3rd Reading SB109 B. & F.R. (Wiener)",28,10,0,2,40
1939206,1523449,2025-03-20,Senate,"Senate 3rd Reading SB110 B. & F.R. (Wiener)",28,10,0,2,40
1939207,1523538,2025-03-20,Senate,"Senate 3rd Reading SB111 B. & F.R. (Wiener)",28,10,0,2,40
1939208,1523555,2025-03-20,Senate,"Senate 3rd Reading SB112 B. & F.R. (Wiener)",28,10,0,2,40
1939209,1523631,2025-03-20,Senate,"Senate 3rd Reading SB113 B. & F.R. (Wiener)",28,10,0,2,40
1939210,1523699,2025-03-20,Senate,"Senate 3rd Reading SB114 B. & F.R. (Wiener)",28,10,0,2,40
1939211,1523511,2025-03-20,Senate,"Senate 3rd Reading SB115 B. & F.R. (Wiener)",28,10,0,2,40
1939212,1523692,2025-03-20,Senate,"Senate 3rd Reading SB116 B. & F.R. (Wiener)",28,10,0,2,40
1939213,1523523,2025-03-20,Senate,"Senate 3rd Reading SB117 B. & F.R. (Wiener)",28,10,0,2,40
1939214,1523589,2025-03-20,Senate,"Senate 3rd Reading SB118 B. & F.R. (Wiener)",28,10,0,2,40
1939215,1523585,2025-03-20,Senate,"Senate 3rd Reading SB119 B. & F.R. (Wiener)",28,10,0,2,40
1939216,1523610,2025-03-20,Senate,"Senate 3rd Reading SB120 B. & F.R. (Wiener)",28,10,0,2,40
1939217,1523554,2025-03-20,Senate,"Senate 3rd Reading SB121 B. & F.R. (Wiener)",28,10,0,2,40
1939219,1523604,2025-03-20,Senate,"Senate 3rd Reading SB122 B. & F.R. (Wiener)",28,10,0,2,40
1939220,1523708,2025-03-20,Senate,"Senate 3rd Reading SB123 B. & F.R. (Wiener)",28,10,0,2,40
1939221,1523450,2025-03-20,Senate,"Senate 3rd Reading SB124 B. & F.R. (Wiener)",28,10,0,2,40
1939222,1523711,2025-03-20,Senate,"Senate 3rd Reading SB125 B. & F.R. (Wiener)",28,10,0,2,40
1939223,1523464,2025-03-20,Senate,"Senate 3rd Reading SB126 B. & F.R. (Wiener)",28,10,0,2,40
1939224,1523479,2025-03-20,Senate,"Senate 3rd Reading SB127 B. & F.R. (Wiener)",28,10,0,2,40
1939225,1523582,2025-03-20,Senate,"Senate 3rd Reading SB128 B. & F.R. (Wiener)",28,10,0,2,40
1939226,1523519,2025-03-20,Senate,"Senate 3rd Reading SB129 B. & F.R. (Wiener)",28,10,0,2,40
1939227,1523437,2025-03-20,Senate,"Senate 3rd Reading SB130 B. & F.R. (Wiener)",28,10,0,2,40
1939228,1523615,2025-03-20,Senate,"Senate 3rd Reading SB131 B. & F.R. (Wiener)",28,10,0,2,40
1939229,1523640,2025-03-20,Senate,"Senate 3rd Reading SB132 B. & F.R. (Wiener)",28,10,0,2,40
1939230,1523489,2025-03-20,Senate,"Senate 3rd Reading SB133 B. & F.R. (Wiener)",28,10,0,2,40
1939231,1523553,2025-03-20,Senate,"Senate 3rd Reading SB134 B. & F.R. (Wiener)",28,10,0,2,40
1939232,1523675,2025-03-20,Senate,"Senate 3rd Reading SB135 B. & F.R. (Wiener)",28,10,0,2,40
1939233,1523660,2025-03-20,Senate,"Senate 3rd Reading SB136 B. & F.R. (Wiener)",28,10,0,2,40
1939234,1523531,2025-03-20,Senate,"Senate 3rd Reading SB137 B. & F.R. (Wiener)",28,10,0,2,40
1939235,1523597,2025-03-20,Senate,"Senate 3rd Reading SB138 B. & F.R. (Wiener)",28,10,0,2,40
1939236,1523576,2025-03-20,Senate,"Senate 3rd Reading SB139 B. & F.R. (Wiener)",28,10,0,2,40
1939237,1523534,2025-03-20,Senate,"Senate 3rd Reading SB140 B. & F.R. (Wiener)",28,10,0,2,40
1939238,1523590,2025-03-20,Senate,"Senate 3rd Reading SB141 B. & F.R. (Wiener)",28,10,0,2,40
1939239,1523446,2025-03-20,Senate,"Senate 3rd Reading SB142 B. & F.R. (Wiener)",28,10,0,2,40
1939240,1523620,2025-03-20,Senate,"Senate 3rd Reading SB143 B. & F.R. (Wiener)",28,10,0,2,40
1939241,1523507,2025-03-20,Senate,"Senate 3rd Reading SB144 B. & F.R. (Wiener)",28,10,0,2,40
1939242,1523596,2025-03-20,Senate,"Senate 3rd Reading SB145 B. & F.R. (Wiener)",28,10,0,2,40
1939243,1523686,2025-03-20,Senate,"Senate 3rd Reading SB146 B. & F.R. (Wiener)",28,10,0,2,40
1939244,1523544,2025-03-20,Senate,"Senate 3rd Reading SB147 B. & F.R. (Wiener)",28,10,0,2,40
1939245,1523703,2025-03-20,Senate,"Senate 3rd Reading SB148 B. & F.R. (Wiener)",28,10,0,2,40
1939246,1523560,2025-03-20,Senate,"Senate 3rd Reading SB149 B. & F.R. (Wiener)",28,10,0,2,40
1939247,1523687,2025-03-20,Senate,"Senate 3rd Reading SB150 B. & F.R. (Wiener)",28,10,0,2,40
1939248,1523527,2025-03-20,Senate,"Senate 3rd Reading SB151 B. & F.R. (Wiener)",28,10,0,2,40
1939249,1523547,2025-03-20,Senate,"Senate 3rd Reading SB152 B. & F.R. (Wiener)",28,10,0,2,40
1939250,1523613,2025-03-20,Senate,"Senate 3rd Reading SB153 B. & F.R. (Wiener)",28,10,0,2,40
1939252,1523637,2025-03-20,Senate,"Senate 3rd Reading SB154 B. & F.R. (Wiener)",28,10,0,2,40
1939253,1523714,2025-03-20,Senate,"Senate 3rd Reading SB155 B. & F.R. (Wiener)",28,10,0,2,40
1939254,1523557,2025-03-20,Senate,"Senate 3rd Reading SB156 B. & F.R. (Wiener)",28,10,0,2,40
1939255,1523509,2025-03-20,Senate,"Senate 3rd Reading SB157 B. & F.R. (Wiener)",28,10,0,2,40
1939256,1523677,2025-03-20,Senate,"Senate 3rd Reading SB158 B. & F.R. (Wiener)",28,10,0,2,40
1939257,1523568,2025-03-20,Senate,"Senate 3rd Reading SB159 B. & F.R. (Wiener)",28,10,0,2,40
1939258,1523564,2025-03-20,Senate,"Senate 3rd Reading SB160 B. & F.R. (Wiener)",28,10,0,2,40
1939259,1523673,2025-03-20,Senate,"Senate 3rd Reading SB161 B. & F.R. (Wiener)",28,10,0,2,40
1939260,1523654,2025-03-20,Senate,"Senate 3rd Reading SB162 B. & F.R. (Wiener)",28,10,0,2,40
1939261,1523545,2025-03-20,Senate,"Senate 3rd Reading SB163 B. & F.R. (Wiener)",28,10,0,2,40
1939262,1523636,2025-03-20,Senate,"Senate 3rd Reading SB164 B. & F.R. (Wiener)",28,10,0,2,40
1939263,1523462,2025-03-20,Senate,"Senate 3rd Reading SB165 B. & F.R. (Wiener)",28,10,0,2,40
1939264,1523619,2025-03-20,Senate,"Senate 3rd Reading SB166 B. & F.R. (Wiener)",28,10,0,2,40
1939265,1523482,2025-03-20,Senate,"Senate 3rd Reading SB167 B. & F.R. (Wiener)",28,10,0,2,40
1939266,1523632,2025-03-20,Senate,"Senate 3rd Reading SB168 B. & F.R. (Wiener)",28,10,0,2,40
1939267,1523586,2025-03-20,Senate,"Senate 3rd Reading SB169 B. & F.R. (Wiener)",28,10,0,2,40
1939268,1523448,2025-03-20,Senate,"Senate 3rd Reading SB170 B. & F.R. (Wiener)",28,10,0,2,40
1939269,1523665,2025-03-20,Senate,"Senate 3rd Reading SB171 B. & F.R. (Wiener)",28,10,0,2,40
1939270,1523657,2025-03-20,Senate,"Senate 3rd Reading SB172 B. & F.R. (Wiener)",28,10,0,2,40
1939271,1523501,2025-03-20,Senate,"Senate 3rd Reading SB173 B. & F.R. (Wiener)",28,10,0,2,40
1939272,1523571,2025-03-20,Senate,"Senate 3rd Reading SB174 B. & F.R. (Wiener)",28,10,0,2,40
1939273,1523546,2025-03-20,Senate,"Senate 3rd Reading SB175 B. & F.R. (Wiener)",28,10,0,2,40
1939274,1523684,2025-03-20,Senate,"Senate 3rd Reading SB176 B. & F.R. (Wiener)",28,10,0,2,40
1939275,1523500,2025-03-20,Senate,"Senate 3rd Reading SB177 B. & F.R. (Wiener)",28,10,0,2,40
1939276,1523611,2025-03-20,Senate,"Senate 3rd Reading SB178 B. & F.R. (Wiener)",28,10,0,2,40
1939277,1523537,2025-03-20,Senate,"Senate 3rd Reading SB179 B. & F.R. (Wiener)",28,10,0,2,40
1939278,1523496,2025-03-20,Senate,"Senate 3rd Reading SB180 B. & F.R. (Wiener)",28,10,0,2,40
1939279,1523570,2025-03-20,Senate,"Senate 3rd Reading SB181 B. & F.R. (Wiener)",28,10,0,2,40
1939280,1523693,2025-03-20,Senate,"Senate 3rd Reading SB182 B. & F.R. (Wiener)",28,10,0,2,40
1939281,1523510,2025-03-20,Senate,"Senate 3rd Reading SB183 B. & F.R. (Wiener)",28,10,0,2,40
1939282,1523602,2025-03-20,Senate,"Senate 3rd Reading SB184 B. & F.R. (Wiener)",28,10,0,2,40
1939283,1523651,2025-03-20,Senate,"Senate 3rd Reading SB185 B. & F.R. (Wiener)",28,10,0,2,40
1939284,1523649,2025-03-20,Senate,"Senate 3rd Reading SB186 B. & F.R. (Wiener)",28,10,0,2,40
1939285,1523484,2025-03-20,Senate,"Senate 3rd Reading SB187 B. & F.R. (Wiener)",28,10,0,2,40
1939286,1523492,2025-03-20,Senate,"Senate 3rd Reading SB188 B. & F.R. (Wiener)",28,10,0,2,40
1939287,1523606,2025-03-20,Senate,"Senate 3rd Reading SB189 B. & F.R. (Wiener)",28,10,0,2,40
1939288,1523460,2025-03-20,Senate,"Senate 3rd Reading SB190 B. & F.R. (Wiener)",28,10,0,2,40
1939289,1523594,2025-03-20,Senate,"Senate 3rd Reading SB191 B. & F.R. (Wiener)",28,10,0,2,40
1939291,1523549,2025-03-20,Senate,"Senate 3rd Reading SB192 B. & F.R. (Wiener)",28,10,0,2,40
1939292,1523566,2025-03-20,Senate,"Senate 3rd Reading SB193 B. & F.R. (Wiener)",28,10,0,2,40
1939293,1523441,2025-03-20,Senate,"Senate 3rd Reading SB194 B. & F.R. (Wiener)",28,10,0,2,40
1939294,1523516,2025-03-20,Senate,"Senate 3rd Reading SB195 B. & F.R. (Wiener)",28,10,0,2,40
1939295,1523529,2025-03-20,Senate,"Senate 3rd Reading SB196 B. & F.R. (Wiener)",28,10,0,2,40
1939296,1523567,2025-03-20,Senate,"Senate 3rd Reading SB197 B. & F.R. (Wiener)",28,10,0,2,40
1939297,1523670,2025-03-20,Senate,"Senate 3rd Reading SB198 B. & F.R. (Wiener)",28,10,0,2,40
1939298,1523591,2025-03-20,Senate,"Senate 3rd Reading SB199 B. & F.R. (Wiener)",28,10,0,2,40
1939299,1523524,2025-03-20,Senate,"Senate 3rd Reading SB200 B. & F.R. (Wiener)",28,10,0,2,40
1939300,1523466,2025-03-20,Senate,"Senate 3rd Reading SB201 B. & F.R. (Wiener)",28,10,0,2,40
1939301,1523518,2025-03-20,Senate,"Senate 3rd Reading SB202 B. & F.R. (Wiener)",28,10,0,2,40
1939302,1523662,2025-03-20,Senate,"Senate 3rd Reading SB203 B. & F.R. (Wiener)",28,10,0,2,40
1939303,1523562,2025-03-20,Senate,"Senate 3rd Reading SB204 B. & F.R. (Wiener)",28,10,0,2,40
1939304,1523626,2025-03-20,Senate,"Senate 3rd Reading SB205 B. & F.R. (Wiener)",28,10,0,2,40
1939305,1523575,2025-03-20,Senate,"Senate 3rd Reading SB206 B. & F.R. (Wiener)",28,10,0,2,40
1939306,1523494,2025-03-20,Senate,"Senate 3rd Reading SB207 B. & F.R. (Wiener)",28,10,0,2,40
1939307,1523515,2025-03-20,Senate,"Senate 3rd Reading SB208 B. & F.R. (Wiener)",28,10,0,2,40
1939308,1523550,2025-03-20,Senate,"Senate 3rd Reading SB209 B. & F.R. (Wiener)",28,10,0,2,40
1939309,1523704,2025-03-20,Senate,"Senate 3rd Reading SB210 B. & F.R. (Wiener)",28,10,0,2,40
1939310,1523490,2025-03-20,Senate,"Senate 3rd Reading SB211 B. & F.R. (Wiener)",28,10,0,2,40
1939311,1523443,2025-03-20,Senate,"Senate 3rd Reading SB212 B. & F.R. (Wiener)",28,10,0,2,40
1939312,1523468,2025-03-20,Senate,"Senate 3rd Reading SB213 B. & F.R. (Wiener)",28,10,0,2,40
1939313,1523705,2025-03-20,Senate,"Senate 3rd Reading SB214 B. & F.R. (Wiener)",28,10,0,2,40
1939314,1523701,2025-03-20,Senate,"Senate 3rd Reading SB215 B. & F.R. (Wiener)",28,10,0,2,40
1939315,1523530,2025-03-20,Senate,"Senate 3rd Reading SB216 B. & F.R. (Wiener)",28,10,0,2,40
1939316,1523457,2025-03-20,Senate,"Senate 3rd Reading SB217 B. & F.R. (Wiener)",28,10,0,2,40
1939317,1523713,2025-03-20,Senate,"Senate 3rd Reading SB218 B. & F.R. (Wiener)",28,10,0,2,40
1939318,1523521,2025-03-20,Senate,"Senate 3rd Reading SB219 B. & F.R. (Wiener)",28,10,0,2,40
1939320,1533471,2025-04-01,Senate,"Do pass, but first be re-referred to the Committee on [Appropriations]",6,0,0,0,6
1939320,1552957,2025-04-21,Senate,"Placed on suspense file",6,0,0,1,7
1939321,1555957,2025-04-23,Senate,"Do pass, but first be re-referred to the Committee on [Environmental Quality]",1,4,0,0,5
1939321,1555958,2025-04-23,Senate,"[First] hearing set for [04-23-2025]: Failed passage in Committee. Reconsideration granted",5,0,0,0,5
1939322,1538912,2025-04-07,Senate,"Do pass, but first be re-referred to the Committee on [Judiciary]",10,0,0,1,11
1939322,1555975,2025-04-22,Senate,"Do pass, but first be re-referred to the Committee on [Appropriations]",13,0,0,0,13
1939322,1565326,2025-05-05,Senate,"Placed on suspense file",7,0,0,0,7
1939324,1535050,2025-04-02,Senate,"Do pass, but first be re-referred to the Committee on [Judiciary] with the recommendation: To Consent Calendar",7,0,0,0,7
1939324,1542920,2025-04-08,Senate,"Do pass as amended, but first amend, and re-refer to the Committee on [Appropriations] with the recommendation: To Consent Calendar",13,0,0,0,13
1939325,1521976,2025-03-19,Senate,"Do pass as amended, but first amend, and re-refer to the Committee on [Judiciary]",6,0,0,1,7
1939325,1542927,2025-04-08,Senate,"Do pass, but first be re-referred to the Committee on [Appropriations]",11,1,0,1,13
1939325,1559487,2025-04-28,Senate,"Placed on suspense file",7,0,0,0,7
1939326,1552950,2025-04-21,Senate,"Do pass as amended, but first amend, and re-refer to the Committee on [Military and Veterans Affairs]",5,0,0,0,5
1939326,1559503,2025-04-28,Senate,"Do pass, but first be re-referred to the Committee on [Appropriations]",4,0,0,1,5
1941749,1526992,2025-03-25,Assembly,"Do pass and be re-referred to the Committee on [Privacy and Consumer Protection]",12,0,0,0,12
1941749,1566702,2025-05-06,Assembly,"Do pass",11,2,0,2,15
1941750,1538941,2025-04-07,Assembly,"Do pass and be re-referred to the Committee on [Revenue and Taxation]",14,0,0,0,14
1941752,1515254,2025-03-11,Assembly,"Do pass as amended and be re-referred to the Committee on [Appropriations]",6,0,0,1,7
1941753,1515293,2025-03-11,Assembly,"Do pass and be re-referred to the Committee on [Appropriations] with recommendation: To Consent Calendar",6,0,0,1,7
1941753,1562928,2025-04-30,Assembly,"Do pass. To Consent Calendar",14,0,0,1,15
1941753,1568664,2025-05-08,Assembly,"AB 320 Bennett Consent Calendar Second Day Regular Session",69,0,0,10,79
1941754,1505322,2025-03-04,Assembly,"Do pass. To Consent Calendar",9,0,0,0,9
1941754,1517623,2025-03-13,Assembly,"AB 321 Schultz Assembly Third Reading",52,6,0,22,80
1941755,1516565,2025-03-12,Assembly,"Do pass and be re-referred to the Committee on [Appropriations] with recommendation: To Consent Calendar",8,0,0,1,9
1941755,1542825,2025-04-09,Assembly,"Do pass",10,0,0,5,15
1941755,1552878,2025-04-21,Assembly,"AB 322 Ward Assembly Third Reading",62,0,0,17,79
1941756,1521968,2025-03-18,Assembly,"Do pass and be re-referred to the Committee on [Appropriations]",7,0,0,3,10
1941757,1562940,2025-04-30,Assembly,"Be adopted and re-referred to the Committee on [Human Services]",8,2,0,2,12
1941757,1564235,2025-05-01,Assembly,"Be adopted as amended, and re-refer to the Committee on [Appropriations]",5,2,0,0,7
1941758,1561094,2025-04-28,Assembly,"Be adopted. To Consent Calendar",16,0,0,0,16
1941758,1564220,2025-05-01,Assembly,"ACR 21 Flora Consent Calendar Second Day Regular Session",76,0,0,3,79
1941759,1479228,2025-02-03,Assembly,"Be adopted. To Consent Calendar",11,0,0,0,11
1941759,1483669,2025-02-06,Assembly,"ACR 22 Muratsuchi Consent Calendar Second Day",72,0,0,7,79
1941759,1517823,2025-03-13,Senate,"Special Consent ACR22 Muratsuchi et al",36,0,0,4,40
1943407,1540940,2025-04-08,Assembly,"Do pass as amended and be re-referred to the Committee on [Privacy and Consumer Protection]",9,3,0,0,12
1943407,1564230,2025-05-01,Assembly,"Do pass and be re-referred to the Committee on [Appropriations]",10,2,0,3,15
1943408,1522000,2025-03-18,Assembly,"Do pass and be re-referred to the Committee on [Appropriations]",7,2,0,1,10
1943409,1505309,2025-03-04,Assembly,"Do pass as amended and be re-referred to the Committee on [Appropriations]",8,0,0,1,9
1943411,1545041,2025-04-09,Assembly,"Do pass and be re-referred to the Committee on [Judiciary]",2,7,0,0,9
1943412,1561111,2025-04-28,Assembly,"Do pass and be re-referred to the Committee on [Appropriations]",5,0,0,2,7
1943413,1528320,2025-03-26,Assembly,"Do pass and be re-referred to the Committee on [Public Safety]",7,0,0,0,7
1943413,1554603,2025-04-22,Assembly,"Do pass and be re-referred to the Committee on [Appropriations]",9,0,0,0,9
1943414,1542889,2025-04-08,Senate,"Do pass, but first be re-referred to the Committee on [Insurance]",5,2,0,6,13
1943414,1542890,2025-04-08,Senate,"[First] hearing set for [04-09-2025]: Failed passage in Committee. Reconsideration granted",10,0,0,3,13
1943415,1535049,2025-04-02,Senate,"Do pass, but first be re-referred to the Committee on [Rules] with the recommendation: To Consent Calendar",11,0,0,0,11
1943415,1554628,2025-04-22,Senate,"Do pass as amended, but first amend, and re-refer to the Committee on [Appropriations] with the recommendation: To Consent Calendar",6,0,0,1,7
1943415,1565298,2025-05-05,Senate,"Placed on suspense file",7,0,0,0,7
1943416,1526990,2025-03-25,Senate,"Do pass as amended, but first amend, and re-refer to the Committee on [Appropriations]",7,0,0,0,7
1943416,1538943,2025-04-07,Senate,"Placed on suspense file",7,0,0,0,7
1943417,1535058,2025-04-02,Senate,"Do pass, but first be re-referred to the Committee on [Appropriations]",6,0,0,1,7
1943417,1552857,2025-04-21,Senate,"Placed on suspense file",6,0,0,1,7
1943418,1492763,2025-02-18,Senate,"Senate 3rd Reading SCR16 Alvarado-Gil",36,0,0,3,39
1943418,1498300,2025-02-24,Assembly,"Be adopted. To Consent Calendar",11,0,0,0,11
1943418,1501961,2025-02-27,Assembly,"SCR 16 Alvarado-Gil Consent Calendar Second Day",66,0,0,13,79
1945196,1525454,2025-03-24,Assembly,"Do pass and be re-referred to the Committee on [Privacy and Consumer Protection] with recommendation: To Consent Calendar",16,0,0,0,16
1945196,1566710,2025-05-06,Assembly,"Do pass as amended. To Consent Calendar",14,0,0,1,15
1945197,1521981,2025-03-18,Assembly,"Do pass as amended and be re-referred to the Committee on [Appropriations]",8,2,0,0,10
1945198,1505323,2025-03-04,Assembly,"Do pass and be re-referred to the Committee on [Appropriations]",2,3,0,4,9
1945199,1525438,2025-03-24,Assembly,"Do pass and be re-referred to the Committee on [Appropriations]",13,0,0,1,14
1945200,1557493,2025-04-23,Assembly,"Do pass and be re-referred to the Committee on [Appropriations]",6,0,0,1,7
1945201,1521954,2025-03-19,Assembly,"Do pass and be re-referred to the Committee on [Appropriations]",4,0,0,3,7
1945202,1522020,2025-03-19,Assembly,"Do pass and be re-referred to the Committee on [Appropriations]",6,0,0,1,7
1945203,1542916,2025-04-08,Assembly,"Do pass and be re-referred to the Committee on [Human Services] with recommendation: To Consent Calendar",10,0,0,0,10
1945203,1563117,2025-04-29,Assembly,"Do pass as amended, and be re-referred to the Committee on [Appropriations] with recommendation: To Consent Calendar",7,0,0,0,7
1945204,1556183,2025-04-23,Assembly,"Do pass as amended and be re-referred to the Committee on [Appropriations]",15,2,0,5,22
1945205,1556188,2025-04-23,Senate,"Do pass, but first be re-referred to the Committee on [Appropriations]",5,0,0,2,7
1945206,1538993,2025-04-07,Senate,"Do pass as amended, but first amend, and re-refer to the Committee on [Local Government]",10,0,0,1,11
1945206,1567896,2025-05-07,Senate,"Do pass",7,0,0,0,7
1945207,1535125,2025-04-02,Senate,"Do pass as amended, but first amend, and re-refer to the Committee on [Appropriations]",11,0,0,0,11
1945207,1552943,2025-04-21,Senate,"Placed on suspense file",6,0,0,1,7
1945208,1526983,2025-03-25,Senate,"Do pass and be ordered to the Consent Calendar",6,0,0,0,6
1945208,1530374,2025-03-28,Senate,"Consent Calendar 2nd SB229 Alvarado-Gil",34,0,0,6,40
1945209,1528310,2025-03-26,Senate,"Do pass and be ordered to the Consent Calendar",5,0,0,0,5
1945209,1533475,2025-04-01,Senate,"Consent Calendar 2nd SB230 Laird et al",39,0,0,1,40
1945210,1521987,2025-03-19,Senate,"Do pass as amended, but first amend, and re-refer to the Committee on [Appropriations]",8,0,0,0,8
1945210,1538880,2025-04-07,Senate,"Placed on suspense file",7,0,0,0,7
1945211,1522010,2025-03-19,Senate,"Do pass as amended, but first amend, and re-refer to the Committee on [Appropriations]",8,0,0,0,8
1945211,1538995,2025-04-07,Senate,"Placed on suspense file",7,0,0,0,7
1945212,1520417,2025-03-18,Senate,"Do pass, but first be re-referred to the Committee on [Appropriations] with the recommendation: To Consent Calendar",10,0,0,1,11
1945212,1544995,2025-04-10,Senate,"Consent Calendar 2nd SB233 Seyarto et al",35,0,0,5,40
1945213,1527003,2025-03-25,Senate,"Do pass, but first be re-referred to the Committee on [Environmental Quality] with the recommendation: To Consent Calendar",7,0,0,0,7
1945213,1563104,2025-04-30,Senate,"Do pass, but first be re-referred to the Committee on [Appropriations] with the recommendation: To Consent Calendar",8,0,0,0,8
1945214,1495956,2025-02-20,Senate,"Senate 3rd Reading SCR17 Niello",35,0,0,4,39
1945214,1511417,2025-03-10,Assembly,"Be adopted. To Consent Calendar",9,0,0,2,11
1945214,1517617,2025-03-13,Assembly,"SCR 17 Niello Consent Calendar Second Day Regular Session",68,0,0,12,80
1947434,1505316,2025-03-04,Assembly,"Do pass and be re-referred to the Committee on [Appropriations] with recommendation: To Consent Calendar",12,0,0,0,12
1947435,1521957,2025-03-19,Assembly,"Do pass and be re-referred to the Committee on [Appropriations]",19,0,0,3,22
1947435,1542872,2025-04-09,Assembly,"Do pass",14,0,0,1,15
1947436,1521994,2025-03-19,Assembly,"Do pass and be re-referred to the Committee on [Appropriations] with recommendation: To Consent Calendar",7,0,0,0,7
1947437,1562771,2025-04-29,Assembly,"Do pass and be re-referred to the Committee on [Appropriations] with recommendation: To Consent Calendar",7,0,0,0,7
1947438,1516566,2025-03-12,Assembly,"Do pass as amended and be re-referred to the Committee on [Appropriations]",8,0,0,1,9
1947439,1555922,2025-04-22,Assembly,"Do pass as amended",16,0,0,0,16
1947440,1564213,2025-05-01,Assembly,"Do pass as amended and be re-referred to the Committee on [Appropriations]",6,0,0,1,7
1947441,1555941,2025-04-22,Assembly,"Do pass as amended and be re-referred to the Committee on [Appropriations]",14,0,0,2,16
1947442,1521975,2025-03-19,Senate,"Do pass as amended, but first amend, and re-refer to the Committee on [Appropriations] with the recommendation: To Consent Calendar",8,0,0,0,8
1947442,1538934,2025-04-07,Senate,"Placed on suspense file",7,0,0,0,7
1947443,1556005,2025-04-23,Senate,"Do pass, but first be re-referred to the Committee on [Judiciary]",8,0,0,0,8
1947443,1562876,2025-04-29,Senate,"Do pass as amended, but first amend, and re-refer to the Committee on [Appropriations] with the recommendation: To Consent Calendar",13,0,0,0,13
1947444,1567911,2025-05-06,Senate,"Do pass as amended, and be ordered to the Consent Calendar",12,0,0,1,13
1947445,1555960,2025-04-23,Senate,"Do pass, but first be re-referred to the Committee on [Judiciary]",4,1,0,0,5
1947445,1562844,2025-04-29,Senate,"Do pass as amended, but first amend, and re-refer to the Committee on [Appropriations]",11,2,0,0,13
1947446,1530377,2025-03-28,Senate,"Senate 3rd Reading SCR18 Archuleta et al",31,0,0,9,40
1947446,1552899,2025-04-21,Assembly,"Be adopted. To Consent Calendar",10,0,0,1,11
1947446,1557509,2025-04-24,Assembly,"SCR 18 Archuleta Consent Calendar Second Day Regular Session",75,0,0,4,79
1947447,1523474,2025-03-20,Senate,"Senate 3rd Reading SR13 Archuleta",38,0,0,2,40
1947448,1559479,2025-04-28,Senate,"Senate 3rd Reading SR14 Cervantes et al",39,0,0,1,40
1949669,1563079,2025-04-30,Assembly,"Do pass and be re-referred to the Committee on [Appropriations]",2,3,0,2,7
1949669,1563080,2025-04-30,Assembly,Reconsideration,4,0,0,3,7
1949670,1526959,2025-03-25,Assembly,"Do pass and be re-referred to the Committee on [Appropriations]",9,0,0,0,9
1949671,1562782,2025-04-30,Assembly,"Do pass as amended and be re-referred to the Committee on [Appropriations]",7,2,0,1,10
1949672,1542754,2025-04-08,Assembly,"Do pass as amended, and be re-referred to the Committee on [Appropriations] with recommendation: To Consent Calendar",9,0,0,0,9
1949672,1562885,2025-04-30,Assembly,"Do pass. To Consent Calendar",14,0,0,1,15
1949672,1568595,2025-05-08,Assembly,"AB 354 Michelle Rodriguez Consent Calendar Second Day Regular Session",69,0,0,10,79
1949673,1505296,2025-03-04,Assembly,"Do pass and be re-referred to the Committee on [Appropriations]",9,0,0,0,9
1949674,1563076,2025-04-29,Assembly,"Do pass and be re-referred to the Committee on [Appropriations]",13,0,0,3,16
1949675,1559459,2025-04-28,Assembly,"Do pass as amended and be re-referred to the Committee on [Appropriations]",12,0,0,2,14
1949676,1515272,2025-03-11,Assembly,"Do pass as amended and be re-referred to the Committee on [Privacy and Consumer Protection]",6,0,0,3,9
1949676,1556003,2025-04-22,Assembly,"Do pass and be re-referred to the Committee on [Appropriations]",10,0,0,5,15
1949676,1563021,2025-04-30,Assembly,"Do pass",14,0,0,1,15
1949677,1528300,2025-03-26,Assembly,"Do pass and be re-referred to the Committee on [Appropriations] with recommendation: To Consent Calendar",7,0,0,0,7
1949678,1540990,2025-04-08,Assembly,"Do pass as amended and be re-referred to the Committee on [Appropriations]",17,0,0,1,18
1949679,1516586,2025-03-12,Assembly,"Do pass as amended",7,0,0,2,9
1949680,1540852,2025-04-08,Assembly,"Do pass and be re-referred to the Committee on [Environmental Safety and Toxic Materials]",9,0,0,4,13
1949680,1561106,2025-04-29,Assembly,"Do pass and be re-referred to the Committee on [Appropriations]",5,0,0,2,7
1949681,1565228,2025-05-05,Assembly,"Be adopted. To Consent Calendar",9,0,0,2,11
1949681,1568617,2025-05-08,Assembly,"ACR 23 Quirk-Silva Consent Calendar Second Day Regular Session",69,0,0,10,79
1949683,1536847,2025-04-02,Senate,"Do pass as amended, but first amend, and re-refer to the Committee on [Judiciary]",5,2,0,0,7
1949683,1567898,2025-05-06,Senate,"Do pass",10,1,0,2,13
1949685,1528272,2025-03-26,Senate,"Do pass and be ordered to the Consent Calendar",7,0,0,0,7
1949685,1533469,2025-04-01,Senate,"Consent Calendar 2nd SB241 Cervantes",39,0,0,1,40
1949686,1564185,2025-04-30,Senate,"Do pass as amended, but first amend, and re-refer to the Committee on [Appropriations]",9,2,0,0,11
1949687,1542766,2025-04-08,Senate,"Do pass, but first be re-referred to the Committee on [Health]",12,0,0,1,13
1949687,1564172,2025-04-30,Senate,"Do pass, but first be re-referred to the Committee on [Appropriations]",8,0,0,3,11
1949688,1535110,2025-04-02,Senate,"Do pass, but first be re-referred to the Committee on [Governmental Organization]",7,0,0,0,7
1949688,1552966,2025-04-21,Senate,"Placed on suspense file",6,0,0,1,7
1949689,1554522,2025-04-22,Senate,"Do pass, but first be re-referred to the Committee on [Appropriations]",5,1,0,0,6
1949689,1565342,2025-05-05,Senate,"Placed on suspense file",7,0,0,0,7
1949690,1535031,2025-04-02,Senate,"Do pass, but first be re-referred to the Committee on [Appropriations] with the recommendation: To Consent Calendar",11,0,0,0,11
1949690,1552913,2025-04-21,Senate,"Placed on suspense file",6,0,0,1,7
1949691,1554579,2025-04-22,Senate,"Do pass, but first be re-referred to the Committee on [Appropriations]",10,4,0,1,15
1949692,1526980,2025-03-25,Senate,"Do pass, but first be re-referred to the Committee on [Appropriations]",5,1,0,0,6
1949692,1538913,2025-04-07,Senate,"Placed on suspense file",7,0,0,0,7
1949693,1542856,2025-04-09,Senate,"Do pass, but first be re-referred to the Committee on [Elections and Constitutional Amendments]",5,2,0,0,7
1949693,1561176,2025-04-29,Senate,"Do pass as amended, but first amend, and re-refer to the Committee on [Appropriations]",3,1,0,1,5
1949694,1528293,2025-03-26,Senate,"Do pass, but first be re-referred to the Committee on [Appropriations] with the recommendation: To Consent Calendar",10,0,0,1,11
1949694,1538862,2025-04-07,Senate,"Placed on suspense file",7,0,0,0,7
1953052,1521953,2025-03-18,Assembly,"Do pass as amended and be re-referred to the Committee on [Human Services]",7,1,0,2,10
1953052,1540861,2025-04-08,Assembly,"Do pass and be re-referred to the Committee on [Appropriations]",5,1,0,0,6
1953054,1528268,2025-03-26,Assembly,"Do pass as amended, and be re-referred to the Committee on [Judiciary] with recommendation: To Consent Calendar",18,0,0,0,18
1953054,1540938,2025-04-08,Assembly,"Do pass and be re-referred to the Committee on [Appropriations] with recommendation: To Consent Calendar",12,0,0,0,12
1953054,1555898,2025-04-23,Assembly,"Do pass. To Consent Calendar",15,0,0,0,15
1953054,1564201,2025-05-01,Assembly,"AB 365 Schiavo Consent Calendar Second Day Regular Session",76,0,0,3,79
1953055,1563098,2025-04-29,Assembly,"Do pass as amended and be re-referred to the Committee on [Appropriations]",9,0,0,0,9
1953056,1540841,2025-04-07,Assembly,"Do pass and be re-referred to the Committee on [Utilities and Energy]",6,1,0,0,7
1953056,1564177,2025-04-30,Assembly,"Do pass as amended and be re-referred to the Committee on [Appropriations]",18,0,0,0,18
1953057,1535089,2025-04-02,Assembly,"Do pass as amended, and be re-referred to the Committee on [Natural Resources] with recommendation: To Consent Calendar",18,0,0,0,18
1953057,1558723,2025-04-21,Assembly,"Do pass and be re-referred to the Committee on [Appropriations] with recommendation: To Consent Calendar",14,0,0,0,14
1953058,1540872,2025-04-08,Assembly,"Do pass as amended. To Consent Calendar",12,0,0,0,12
1953058,1557544,2025-04-24,Assembly,"AB 369 Michelle Rodriguez Consent Calendar Second Day",75,0,0,4,79
1953059,1515265,2025-03-11,Assembly,"Do pass as amended, and be re-referred to the Committee on [Appropriations] with recommendation: To Consent Calendar",12,0,0,0,12
1953059,1542895,2025-04-09,Assembly,"Do pass. To Consent Calendar",14,0,0,1,15
1953059,1557499,2025-04-24,Assembly,"AB 370 Carrillo Consent Calendar Second Day Regular Session",75,0,0,4,79
1953060,1555974,2025-04-22,Assembly,"Do pass as amended and be re-referred to the Committee on [Appropriations]",15,0,0,1,16
1953061,1540953,2025-04-07,Assembly,"Do pass and be re-referred to the Committee on [Environmental Safety and Toxic Materials]",7,0,0,0,7
1953061,1561166,2025-04-29,Assembly,"Do pass and be re-referred to the Committee on [Appropriations] with recommendation: To Consent Calendar",7,0,0,0,7
1953062,1515249,2025-03-11,Assembly,"Do pass and be re-referred to the Committee on [Human Services]",9,0,0,3,12
1953062,1526890,2025-03-25,Assembly,"Do pass",6,0,0,1,7
1953062,1538910,2025-04-07,Assembly,"AB 373 Blanca Rubio Assembly Third Reading",64,0,0,15,79
1953063,1522004,2025-03-19,Assembly,"Do pass and be re-referred to the Committee on [Higher Education]",6,0,0,1,7
1953063,1556167,2025-04-22,Assembly,"Do pass",8,0,0,2,10
1953063,1568665,2025-05-08,Assembly,"AB 374 Nguyen Assembly Third Reading",73,0,0,6,79
1953064,1540796,2025-04-08,Assembly,"Do pass and be re-referred to the Committee on [Appropriations] with recommendation: To Consent Calendar",17,0,0,1,18
1953066,1525431,2025-03-24,Assembly,"Do pass and be re-referred to the Committee on [Appropriations] with recommendation: To Consent Calendar",16,0,0,0,16
1953066,1563050,2025-04-30,Assembly,"Do pass. To Consent Calendar",14,0,0,1,15
1953066,1568650,2025-05-08,Assembly,"AB 377 Tangipa Consent Calendar Second Day Regular Session",69,0,0,10,79
1953067,1522005,2025-03-19,Assembly,"Do pass and be re-referred to the Committee on [Education]",6,0,0,1,7
1953067,1529533,2025-03-26,Assembly,"Do pass and be re-referred to the Committee on [Appropriations]",7,2,0,0,9
1953068,1563116,2025-04-29,Assembly,"Do pass as amended and be re-referred to the Committee on [Appropriations]",7,0,0,2,9
1953068,1564252,2025-05-01,Assembly,"AB 379 Krell Assembly Second Reading Amend By SCHULTZ Set #1 Appeal the Decision of the Speaker By MACEDO",18,50,0,11,79
1953068,1564253,2025-05-01,Assembly,"AB 379 Krell Assembly Second Reading Amend By SCHULTZ Set #1 Motion to Lay on the Table By MACEDO",21,55,0,3,79
1953068,1564254,2025-05-01,Assembly,"AB 379 Krell Assembly Second Reading Amend By SCHULTZ Set #1",56,21,0,2,79
1953068,1567907,2025-05-07,Assembly,"Do pass as amended",15,0,0,0,15
1953069,1515259,2025-03-11,Assembly,"Do pass as amended and be re-referred to the Committee on [Appropriations]",5,0,0,4,9
1953070,1534992,2025-04-02,Assembly,"Do pass and be re-referred to the Committee on [Labor and Employment]",21,0,0,1,22
1953070,1557481,2025-04-23,Assembly,"Do pass and be re-referred to the Committee on [Appropriations] with recommendation: To Consent Calendar",7,0,0,0,7
1953071,1554442,2025-04-21,Assembly,"Do pass and be re-referred to the Committee on [Appropriations]",15,0,0,1,16
1953072,1515261,2025-03-11,Assembly,"Do pass as amended and be re-referred to the Committee on [Appropriations]",8,0,0,1,9
1953073,1556078,2025-04-22,Assembly,"Do pass and be re-referred to the Committee on [Appropriations]",13,0,0,3,16
1953074,1564198,2025-04-30,Assembly,"Do pass and be re-referred to the Committee on [Appropriations] with recommendation: To Consent Calendar",10,0,0,0,10
1953076,1515253,2025-03-11,Assembly,"Do pass",11,1,0,0,12
1953076,1517619,2025-03-13,Assembly,"AB 387 Alanis Assembly Third Reading",67,0,0,13,80
1953077,1564192,2025-04-30,Assembly,"Do pass and be re-referred to the Committee on [Appropriations]",18,0,0,0,18
1953079,1525478,2025-03-24,Assembly,"Do pass and be re-referred to the Committee on [Appropriations]",16,0,0,0,16
1953079,1542737,2025-04-09,Assembly,"Do pass",14,0,0,1,15
1953079,1559468,2025-04-28,Assembly,"AB 390 Wilson Assembly Third Reading",74,0,0,5,79
1953080,1567905,2025-05-07,Assembly,"Do pass as amended. To Consent Calendar",12,0,0,0,12
1953081,1535040,2025-04-01,Assembly,"Do pass and be re-referred to the Committee on [Judiciary]",14,0,0,1,15
1953081,1554608,2025-04-22,Assembly,"Do pass as amended and be re-referred to the Committee on [Appropriations]",12,0,0,0,12
1953082,1521972,2025-03-19,Assembly,"Do pass and be re-referred to the Committee on [Appropriations]",6,0,0,1,7
1953083,1534996,2025-04-01,Assembly,"Do pass and be re-referred to the Committee on [Judiciary]",9,0,0,0,9
1953083,1554500,2025-04-22,Assembly,"Do pass as amended and be re-referred to the Committee on [Appropriations]",12,0,0,0,12
1953084,1545044,2025-04-09,Assembly,"Do pass as amended, and be re-referred to the Committee on [Higher Education] with recommendation: To Consent Calendar",9,0,0,0,9
1953084,1561035,2025-04-29,Assembly,"Do pass as amended, and be re-referred to the Committee on [Appropriations] with recommendation: To Consent Calendar",10,0,0,0,10
1953086,1561057,2025-04-28,Assembly,"Do pass and be re-referred to the Committee on [Appropriations]",5,1,0,1,7
1953089,1552904,2025-04-21,Senate,"Do pass",5,1,0,1,7
1953089,1557492,2025-04-24,Senate,"Senate 3rd Reading SB251 Caballero Urgency Clause",28,0,0,12,40
1953091,1567889,2025-05-06,Senate,"Do pass",12,0,0,1,13
1953092,1563065,2025-04-29,Senate,"Do pass, but first be re-referred to the Committee on [Appropriations]",13,2,0,2,17
1953093,1536809,2025-04-02,Senate,"Do pass, but first be re-referred to the Committee on [Judiciary]",7,0,0,0,7
1953093,1556108,2025-04-22,Senate,"Do pass, but first be re-referred to the Committee on [Appropriations] with the recommendation: To Consent Calendar",13,0,0,0,13
1953093,1568647,2025-05-08,Senate,"Consent Calendar 2nd SB255 Seyarto",36,0,0,4,40
1953094,1563124,2025-04-29,Senate,"Do pass as amended, but first amend, and re-refer to the Committee on [Appropriations]",14,2,0,1,17
1953095,1557484,2025-04-23,Senate,"Do pass, but first be re-referred to the Committee on [Appropriations]",11,0,0,0,11
1953096,1562914,2025-04-29,Senate,"Do pass, but first be re-referred to the Committee on [Appropriations]",6,0,0,0,6
1953097,1556142,2025-04-22,Senate,"Do pass as amended",11,1,0,1,13
1953098,1533560,2025-04-01,Senate,"Do pass as amended, but first amend, and re-refer to the Committee on [Insurance]",6,0,0,0,6
1953098,1556141,2025-04-23,Senate,"Do pass, but first be re-referred to the Committee on [Appropriations]",5,0,0,2,7
1953099,1528323,2025-03-26,Senate,"Do pass as amended, but first amend, and re-refer to the Committee on [Judiciary]",4,1,0,0,5
1953099,1542837,2025-04-08,Senate,"Do pass as amended, but first amend, and re-refer to the Committee on [Appropriations]",11,0,0,2,13
1953099,1559425,2025-04-28,Senate,"Placed on suspense file",7,0,0,0,7
1953100,1520448,2025-03-18,Senate,"Do pass as amended, but first amend, and re-refer to the Committee on [Appropriations]",7,2,0,2,11
1953101,1527004,2025-03-25,Senate,"Do pass, but first be re-referred to the Committee on [Business, Professions and Economic Development]",14,0,0,1,15
1953101,1559466,2025-04-28,Senate,"Do pass, but first be re-referred to the Committee on [Appropriations]",11,0,0,0,11
1953104,1561161,2025-04-29,Senate,"Do pass as amended, but first amend, and re-refer to the Committee on [Appropriations]",5,0,0,0,5
1953108,1533540,2025-04-01,Senate,"Do pass as amended, but first amend, and re-refer to the Committee on [Judiciary]",5,0,0,0,5
1953108,1555977,2025-04-22,Senate,"Do pass, but first be re-referred to the Committee on [Appropriations] with the recommendation: To Consent Calendar",13,0,0,0,13
1953108,1565308,2025-05-05,Senate,"Placed on suspense file",7,0,0,0,7
1953109,1501957,2025-02-27,Senate,"Senate 3rd Reading SCR19 Wahab et al",36,0,0,3,39
1953109,1552861,2025-04-21,Assembly,"Be adopted. To Consent Calendar",10,0,0,1,11
1953109,1557524,2025-04-24,Assembly,"SCR 19 Wahab Consent Calendar Second Day Regular Session",75,0,0,4,79
1955744,1561139,2025-04-28,Assembly,"Do pass and be re-referred to the Committee on [Appropriations]",5,1,0,1,7
1955745,1525476,2025-03-24,Assembly,"Do pass and be re-referred to the Committee on [Appropriations]",9,3,0,2,14
1955746,1515268,2025-03-11,Assembly,"Do pass and be re-referred to the Committee on [Appropriations]",8,0,0,1,9
1955747,1529518,2025-03-26,Assembly,"Do pass and be re-referred to the Committee on [Appropriations]",9,0,0,0,9
1955748,1521985,2025-03-18,Assembly,"Do pass and be re-referred to the Committee on [Appropriations]",9,0,0,1,10
1955749,1526964,2025-03-25,Assembly,"Do pass and be re-referred to the Committee on [Appropriations] with recommendation: To Consent Calendar",15,0,0,0,15
1955751,1542814,2025-04-08,Assembly,"Do pass as amended and be re-referred to the Committee on [Natural Resources]",5,2,0,0,7
1955751,1559467,2025-04-28,Assembly,"Do pass as amended and be re-referred to the Committee on [Appropriations]",10,4,0,0,14
1955752,1528304,2025-03-26,Assembly,"Do pass and be re-referred to the Committee on [Appropriations] with recommendation: To Consent Calendar",18,0,0,0,18
1955752,1556080,2025-04-23,Assembly,"Do pass. To Consent Calendar",15,0,0,0,15
1955752,1564155,2025-05-01,Assembly,"AB 406 Bennett Consent Calendar Second Day Regular Session",76,0,0,3,79
1955753,1552887,2025-04-21,Assembly,"Do pass as amended and be re-referred to the Committee on [Local Government]",9,0,0,0,9
1955753,1564272,2025-04-30,Assembly,"Do pass as amended and be re-referred to the Committee on [Appropriations]",10,0,0,0,10
1955754,1554527,2025-04-22,Assembly,"Do pass and be re-referred to the Committee on [Judiciary]",16,0,0,2,18
1955754,1561055,2025-04-29,Assembly,"Do pass and be re-referred to the Committee on [Appropriations]",10,0,0,2,12
1955755,1542905,2025-04-09,Assembly,"Do pass and be re-referred to the Committee on [Higher Education]",8,0,0,2,10
1955755,1555952,2025-04-22,Assembly,"Do pass",8,1,0,1,10
1955756,1535021,2025-04-01,Assembly,"Do pass as amended and be re-referred to the Committee on [Appropriations]",12,1,0,2,15
1955757,1528270,2025-03-26,Assembly,"Do pass and be re-referred to the Committee on [Natural Resources]",8,0,0,0,8
1955757,1558705,2025-04-21,Assembly,"Do pass as amended and be re-referred to the Committee on [Appropriations]",14,0,0,0,14
1955758,1520437,2025-03-18,Assembly,"Do pass as amended and be re-referred to the Committee on [Judiciary]",10,3,0,2,15
1955758,1566713,2025-05-06,Assembly,"Do pass as amended",9,1,0,2,12
1955759,1558373,2025-04-24,Assembly,"Do pass and be re-referred to the Committee on [Appropriations] with recommendation: To Consent Calendar",11,0,0,1,12
1955760,1515266,2025-03-11,Assembly,"Do pass as amended. To Consent Calendar",12,0,0,0,12
1955760,1523694,2025-03-20,Assembly,"AB 414 Pellerin Consent Calendar Second Day",66,1,0,13,80
1955761,1554624,2025-04-22,Assembly,"Do pass and be re-referred to the Committee on [Appropriations] with recommendation: To Consent Calendar",8,0,0,0,8
1955762,1535113,2025-04-02,Senate,"Do pass, but first be re-referred to the Committee on [Appropriations] with the recommendation: To Consent Calendar",7,0,0,0,7
1955762,1552927,2025-04-21,Senate,"Placed on suspense file",6,0,0,1,7
1955763,1526896,2025-03-25,Senate,"Do pass and be ordered to the Consent Calendar",14,0,0,1,15
1955763,1533494,2025-04-01,Senate,"Consent Calendar 2nd SB272 Becker",39,0,0,1,40
1955765,1555979,2025-04-22,Senate,"Do pass, but first be re-referred to the Committee on [Public Safety]",10,2,0,1,13
1955765,1562937,2025-04-29,Senate,"Do pass as amended, but first amend, and re-refer to the Committee on [Appropriations]",5,1,0,0,6
1955766,1528298,2025-03-26,Senate,"Do pass, but first be re-referred to the Committee on [Appropriations] with the recommendation: To Consent Calendar",5,0,0,0,5
1955766,1538914,2025-04-07,Senate,"Placed on suspense file",7,0,0,0,7
1955767,1521948,2025-03-19,Senate,"Do pass, but first be re-referred to the Committee on [Public Safety]",7,0,0,0,7
1955767,1554525,2025-04-22,Senate,"Do pass as amended, but first amend, and re-refer to the Committee on [Appropriations]",6,0,0,0,6
1955768,1540923,2025-04-08,Senate,"Do pass, but first be re-referred to the Committee on [Appropriations]",4,1,0,1,6
1955768,1552910,2025-04-21,Senate,"Placed on suspense file",6,0,0,1,7
1955769,1528318,2025-03-26,Senate,"Do pass, but first be re-referred to the Committee on [Judiciary] with the recommendation: To Consent Calendar",10,0,0,1,11
1955769,1542764,2025-04-08,Senate,"Do pass, but first be re-referred to the Committee on [Appropriations] with the recommendation: To Consent Calendar",13,0,0,0,13
1955769,1552872,2025-04-21,Senate,"Placed on suspense file",6,0,0,1,7
1958461,1533567,2025-04-01,Assembly,"Do pass and be re-referred to the Committee on [Judiciary]",15,0,0,0,15
1958461,1566692,2025-05-06,Assembly,"Do pass as amended",12,0,0,0,12
1958462,1528296,2025-03-26,Assembly,"Do pass as amended",7,0,0,3,10
1958462,1533520,2025-04-01,Assembly,"AB 417 Carrillo Assembly Third Reading",62,0,0,18,80
1958463,1515267,2025-03-10,Assembly,"Do pass and be re-referred to the Committee on [Appropriations]",7,0,0,0,7
1958463,1526970,2025-03-25,Assembly,"Do pass and be re-referred to the Committee on [Appropriations] with recommendation: To Consent Calendar",12,0,0,0,12
1958463,1542802,2025-04-09,Assembly,"Do pass. To Consent Calendar",14,0,0,1,15
1958463,1557574,2025-04-24,Assembly,"AB 418 Wilson Consent Calendar Second Day Regular Session",75,0,0,4,79
1958464,1529522,2025-03-26,Assembly,"Do pass and be re-referred to the Committee on [Judiciary]",7,2,0,0,9
1958464,1540888,2025-04-08,Assembly,"Do pass and be re-referred to the Committee on [Appropriations]",9,1,0,2,12
1958465,1556201,2025-04-23,Assembly,"Do pass as amended, and be re-referred to the Committee on [Appropriations] with recommendation: To Consent Calendar",18,0,0,0,18
1958467,1545005,2025-04-09,Assembly,"Do pass as amended, and be re-referred to the Committee on [Appropriations] with recommendation: To Consent Calendar",9,0,0,0,9
1958469,1556109,2025-04-22,Assembly,"Do pass and be re-referred to the Committee on [Appropriations] with recommendation: To Consent Calendar",16,0,0,0,16
1958470,1555916,2025-04-22,Assembly,"Do pass as amended and be re-referred to the Committee on [Appropriations]",16,0,0,0,16
1958471,1540820,2025-04-07,Assembly,"Do pass and be re-referred to the Committee on [Judiciary]",7,0,0,0,7
1958471,1554578,2025-04-22,Assembly,"Do pass and be re-referred to the Committee on [Appropriations] with recommendation: To Consent Calendar",12,0,0,0,12
1958472,1540955,2025-04-08,Assembly,"Do pass as amended and be re-referred to the Committee on [Judiciary]",16,0,0,2,18
1958472,1554598,2025-04-22,Assembly,"Do pass and be re-referred to the Committee on [Appropriations] with recommendation: To Consent Calendar",12,0,0,0,12
1958473,1534999,2025-04-02,Assembly,"Do pass and be re-referred to the Committee on [Local Government]",17,0,0,0,17
1958473,1542860,2025-04-09,Assembly,"Do pass and be re-referred to the Committee on [Appropriations]",10,0,0,0,10
1958473,1556010,2025-04-23,Assembly,"Do pass",15,0,0,0,15
1958473,1565340,2025-05-05,Assembly,"AB 428 Blanca Rubio Assembly Third Reading",76,0,0,3,79
1958474,1566700,2025-05-05,Assembly,"Do pass as amended and be re-referred to the Committee on [Appropriations]",7,0,0,0,7
1958475,1563110,2025-04-29,Assembly,"Do pass as amended and be re-referred to the Committee on [Appropriations]",12,0,0,1,13
1958476,1561016,2025-04-28,Assembly,"Do pass as amended and be re-referred to the Committee on [Appropriations]",15,0,0,1,16
1958477,1554555,2025-04-22,Assembly,"Do pass as amended and be re-referred to the Committee on [Health]",14,0,0,4,18
1958477,1563060,2025-04-29,Assembly,"Do pass and be re-referred to the Committee on [Appropriations]",15,0,0,1,16
1958478,1562802,2025-04-29,Assembly,"Do pass and be re-referred to the Committee on [Appropriations]",2,4,0,3,9
1958480,1485611,2025-02-10,Assembly,"Be adopted. To Consent Calendar",9,0,0,2,11
1958480,1517824,2025-03-13,Senate,"Special Consent ACR26 Bonta et al",36,0,0,4,40
1958481,1492774,2025-02-18,Assembly,"Be adopted. To third reading",10,0,0,1,11
1958481,1517825,2025-03-13,Senate,"Special Consent ACR27 Blanca Rubio et al",36,0,0,4,40
1958482,1492766,2025-02-18,Assembly,"Be adopted. To third reading",10,0,0,1,11
1958482,1536795,2025-04-03,Senate,"Special Consent ACR28 Ortega et al",39,0,0,1,40
1958483,1492777,2025-02-18,Assembly,"Be adopted. To third reading",10,0,0,1,11
1958484,1521982,2025-03-19,Senate,"Do pass as amended, but first amend, and re-refer to the Committee on [Appropriations]",7,0,0,1,8
1958484,1538961,2025-04-07,Senate,"Placed on suspense file",7,0,0,0,7
1958485,1533541,2025-04-01,Senate,"Do pass, but first be re-referred to the Committee on [Appropriations]",5,0,0,0,5
1958486,1526989,2025-03-25,Senate,"Do pass",5,1,0,0,6
1958487,1538915,2025-04-07,Senate,"Do pass, but first be re-referred to the Committee on [Local Government]",13,0,0,4,17
1958487,1556097,2025-04-23,Senate,"Do pass as amended, but first amend, and re-refer to the Committee on [Appropriations]",5,0,0,2,7
1958488,1554530,2025-04-21,Senate,"Do pass, but first be re-referred to the Committee on [Local Government]",16,0,0,1,17
1958488,1562753,2025-04-30,Senate,"Do pass as amended, but first amend, and re-refer to the Committee on [Appropriations]",7,0,0,0,7
1958490,1536855,2025-04-02,Senate,"Do pass, but first be re-referred to the Committee on [Appropriations]",6,2,0,0,8
1958490,1552949,2025-04-21,Senate,"Placed on suspense file",6,0,0,1,7
1961044,1525453,2025-03-24,Assembly,"Do pass and be re-referred to the Committee on [Appropriations]",12,0,0,4,16
1961044,1567885,2025-05-07,Assembly,"Do pass",11,2,0,2,15
1961045,1525469,2025-03-24,Assembly,"Do pass and be re-referred to the Committee on [Local Government]",13,0,0,1,14
1961045,1542806,2025-04-09,Assembly,"Do pass and be re-referred to the Committee on [Appropriations]",10,0,0,0,10
1961046,1520453,2025-03-18,Assembly,"Do pass as amended",9,0,0,0,9
1961046,1530388,2025-03-28,Assembly,"AB 437 Lackey Assembly Third Reading",62,0,0,18,80
1961047,1554564,2025-04-21,Assembly,"Do pass and be re-referred to the Committee on [Appropriations] with recommendation: To Consent Calendar",15,0,0,1,16
1961047,1567924,2025-05-07,Assembly,"Do pass. To Consent Calendar",15,0,0,0,15
1961048,1525449,2025-03-24,Assembly,"Do pass and be re-referred to the Committee on [Appropriations]",11,1,0,2,14
1961048,1542817,2025-04-09,Assembly,"Do pass",10,2,0,3,15
1961048,1559400,2025-04-28,Assembly,"AB 439 Rogers Assembly Third Reading",54,13,0,12,79
1961049,1540801,2025-04-08,Assembly,"Do pass as amended, and be re-referred to the Committee on [Appropriations] with recommendation: To Consent Calendar",15,0,0,0,15
1961050,1540889,2025-04-07,Assembly,"Do pass and be re-referred to the Committee on [Appropriations]",7,0,0,0,7
1961052,1535121,2025-04-02,Assembly,"Do pass and be re-referred to the Committee on [Appropriations] with recommendation: To Consent Calendar",18,0,0,0,18
1961052,1537461,2025-04-02,Assembly,"Do pass and be re-referred to the Committee on [Natural Resources] with recommendation: To Consent Calendar",18,0,0,0,18
1961052,1558727,2025-04-21,Assembly,"Do pass and be re-referred to the Committee on [Appropriations] with recommendation: To Consent Calendar",14,0,0,0,14
1961054,1562832,2025-04-30,Assembly,"Do pass as amended and be re-referred to the Committee on [Appropriations]",20,0,0,2,22
1961055,1520418,2025-03-18,Assembly,"Do pass as amended and be re-referred to the Committee on [Judiciary]",10,3,0,2,15
1961055,1566683,2025-05-06,Assembly,"Do pass",8,3,0,1,12
1961056,1540894,2025-04-08,Assembly,"Do pass as amended and be re-referred to the Committee on [Health]",15,0,0,3,18
1961056,1562907,2025-04-29,Assembly,"Do pass as amended, and be re-referred to the Committee on [Appropriations] with recommendation: To Consent Calendar",16,0,0,0,16
1961057,1562915,2025-04-29,Assembly,"Do pass and be re-referred to the Committee on [Appropriations]",16,0,0,0,16
1961058,1527002,2025-03-25,Assembly,"Do pass and be re-referred to the Committee on [Appropriations]",10,0,0,2,12
1961059,1554483,2025-04-22,Assembly,"Do pass and be re-referred to the Committee on [Human Services]",6,1,0,0,7
1961059,1562969,2025-04-29,Assembly,"Do pass as amended and be re-referred to the Committee on [Appropriations]",5,2,0,0,7
1961060,1515273,2025-03-11,Assembly,"Do pass and be re-referred to the Committee on [Appropriations] with recommendation: To Consent Calendar",8,0,0,1,9
1961061,1538907,2025-04-07,Assembly,"Do pass as amended and be re-referred to the Committee on [Appropriations]",10,0,0,4,14
1961062,1545007,2025-04-09,Assembly,"Do pass as amended, and be re-referred to the Committee on [Appropriations] with recommendation: To Consent Calendar",9,0,0,0,9
1961063,1526931,2025-03-25,Assembly,"Do pass as amended and be re-referred to the Committee on [Appropriations]",10,3,0,0,13
1961063,1542878,2025-04-09,Assembly,"Do pass",10,4,0,1,15
1961064,1540884,2025-04-08,Assembly,"Do pass and be re-referred to the Committee on [Environmental Safety and Toxic Materials] with recommendation: To Consent Calendar",12,0,0,0,12
1961064,1561197,2025-04-29,Assembly,"Do pass and be re-referred to the Committee on [Appropriations] with recommendation: To Consent Calendar",7,0,0,0,7
1961065,1567868,2025-05-07,Assembly,"Do pass as amended",8,1,0,3,12
1961066,1542816,2025-04-09,Assembly,"Do pass and be re-referred to the Committee on [Appropriations] with recommendation: To Consent Calendar",12,0,0,0,12
1961066,1555987,2025-04-23,Assembly,"Do pass. To Consent Calendar",15,0,0,0,15
1961066,1564241,2025-05-01,Assembly,"AB 457 Soria Consent Calendar Second Day Regular Session",76,0,0,3,79
1961067,1535128,2025-04-01,Assembly,"Do pass as amended and be re-referred to the Committee on [Appropriations]",8,0,0,1,9
1961068,1562946,2025-04-30,Assembly,"Do pass and be re-referred to the Committee on [Appropriations]",2,4,0,1,7
1961068,1562947,2025-04-30,Assembly,Reconsideration,5,0,0,2,7
1961069,1533532,2025-04-01,Assembly,"Do pass and be re-referred to the Committee on [Appropriations]",15,0,0,0,15
1961070,1540851,2025-04-08,Assembly,"Do pass and be re-referred to the Committee on [Public Safety]",5,1,0,0,6
1961070,1562917,2025-04-29,Assembly,"Do pass and be re-referred to the Committee on [Appropriations]",7,0,0,2,9
1961071,1516564,2025-03-12,Assembly,"Do pass and be re-referred to the Committee on [Appropriations]",11,0,0,1,12
1961071,1522013,2025-03-19,Assembly,"Do pass",15,0,0,0,15
1961071,1533550,2025-04-01,Assembly,"AB 462 Lowenthal Third Reading Urgency",77,0,0,3,80
1961072,1556021,2025-04-22,Assembly,"Do pass as amended, and be re-referred to the Committee on [Appropriations] with recommendation: To Consent Calendar",16,0,0,0,16
1961072,1567916,2025-05-07,Assembly,"Do pass. To Consent Calendar",15,0,0,0,15
1961073,1515251,2025-03-11,Assembly,"Do pass as amended, and be re-referred to the Committee on [Judiciary] with recommendation: To Consent Calendar",8,0,0,1,9
1961073,1526972,2025-03-25,Assembly,"Do pass as amended and be re-referred to the Committee on [Appropriations]",12,0,0,0,12
1961074,1535090,2025-04-02,Assembly,"Do pass and be re-referred to the Committee on [Appropriations]",5,0,0,2,7
1961075,1522041,2025-03-18,Assembly,"Do pass and be re-referred to the Committee on [Appropriations]",10,0,0,0,10
1961076,1542915,2025-04-09,Assembly,"Do pass as amended",9,0,0,1,10
1961076,1565240,2025-05-05,Assembly,"AB 467 Fong Assembly Third Reading",65,7,0,7,79
1961077,1542924,2025-04-08,Assembly,"Do pass as amended and be re-referred to the Committee on [Appropriations]",8,0,0,1,9
1961079,1562964,2025-04-30,Assembly,"Do pass as amended and be re-referred to the Committee on [Appropriations]",8,1,0,1,10
1961080,1525465,2025-03-24,Assembly,"Do pass",13,0,0,1,14
1961080,1544959,2025-04-10,Assembly,"AB 471 Hart Assembly Third Reading",66,2,0,11,79
1961081,1535048,2025-04-02,Assembly,"Do pass as amended, and be re-referred to the Committee on [Natural Resources] with recommendation: To Consent Calendar",18,0,0,0,18
1961081,1558709,2025-04-21,Assembly,"Do pass as amended, and be re-referred to the Committee on [Appropriations] with recommendation: To Consent Calendar",14,0,0,0,14
1961083,1527009,2025-03-25,Assembly,"Do pass and be re-referred to the Committee on [Human Services]",8,3,0,1,12
1961083,1540933,2025-04-08,Assembly,"Do pass and be re-referred to the Committee on [Revenue and Taxation] with recommendation: To Consent Calendar",6,0,0,0,6
1961083,1561037,2025-04-28,Assembly,"Do pass as amended and be re-referred to the Committee on [Appropriations]",7,0,0,0,7
1961085,1485607,2025-02-10,Assembly,"Be adopted. To third reading",9,0,0,2,11
1961085,1517826,2025-03-13,Senate,"Special Consent ACR29 Irwin et al",36,0,0,4,40
1961086,1540867,2025-04-08,Senate,"Do pass as amended, but first amend, and re-refer to the Committee on [Appropriations]",6,0,0,0,6
1961086,1559419,2025-04-28,Senate,"Placed on suspense file",7,0,0,0,7
1961087,1554590,2025-04-22,Senate,"Do pass, but first be re-referred to the Committee on [Appropriations]",6,0,0,1,7
1961087,1565292,2025-05-05,Senate,"Placed on suspense file",7,0,0,0,7
1961090,1540853,2025-04-07,Senate,"Do pass, but first be re-referred to the Committee on [Appropriations] with the recommendation: To Consent Calendar",5,0,0,0,5
1961090,1552894,2025-04-21,Senate,"Placed on suspense file",6,0,0,1,7
1961091,1552877,2025-04-21,Senate,"Do pass as amended, but first amend, and re-refer to the Committee on [Judiciary]",11,0,0,0,11
1961091,1562750,2025-04-29,Senate,"Do pass as amended, but first amend, and re-refer to the Committee on [Appropriations]",13,0,0,0,13
1961092,1562766,2025-04-29,Senate,"Do pass as amended, but first amend, and re-refer to the Committee on [Appropriations]",16,0,0,1,17
1961093,1542828,2025-04-09,Senate,"Do pass as amended, but first amend, and re-refer to the Committee on [Appropriations]",5,0,0,0,5
1961093,1559431,2025-04-28,Senate,"Placed on suspense file",7,0,0,0,7
1961094,1556146,2025-04-23,Senate,"Do pass, but first be re-referred to the Committee on [Judiciary]",4,1,0,0,5
1961094,1562980,2025-04-29,Senate,"Do pass as amended, but first amend, and re-refer to the Committee on [Appropriations]",11,2,0,0,13
1961095,1562860,2025-04-29,Senate,"Do pass as amended, but first amend, and re-refer to the Committee on [Public Safety]",11,2,0,0,13
1961096,1501963,2025-02-27,Senate,"Senate 3rd Reading SR15 Ochoa Bogh et al",36,0,0,3,39
1964662,1526956,2025-03-25,Assembly,"Do pass and be re-referred to the Committee on [Appropriations]",6,1,0,2,9
1964663,1554515,2025-04-22,Assembly,"Do pass as amended and be re-referred to the Committee on [Public Safety]",18,0,0,0,18
1964663,1562821,2025-04-29,Assembly,"Do pass as amended, and be re-referred to the Committee on [Appropriations] with recommendation: To Consent Calendar",9,0,0,0,9
1964664,1545038,2025-04-09,Assembly,"Do pass and be re-referred to the Committee on [Appropriations]",9,0,0,0,9
1964665,1561033,2025-04-28,Assembly,"Do pass and be re-referred to the Committee on [Appropriations]",7,0,0,0,7
1964667,1528299,2025-03-26,Assembly,"Do pass and be re-referred to the Committee on [Revenue and Taxation] with recommendation: To Consent Calendar",10,0,0,1,11
1964667,1561173,2025-04-28,Assembly,"Do pass and be re-referred to the Committee on [Appropriations]",7,0,0,0,7
1964668,1533531,2025-04-01,Assembly,"Do pass as amended and be re-referred to the Committee on [Appropriations]",15,0,0,3,18
1964669,1528258,2025-03-26,Assembly,"Do pass and be re-referred to the Committee on [Appropriations]",8,0,0,0,8
1964669,1542823,2025-04-09,Assembly,"Do pass",14,0,0,1,15
1964670,1535042,2025-04-01,Assembly,"Do pass",9,4,0,2,15
1964670,1538938,2025-04-07,Assembly,"AB 483 Irwin Assembly Third Reading",47,12,0,20,79
1964671,1540870,2025-04-08,Assembly,"Do pass. To Consent Calendar",12,0,0,0,12
1964671,1552931,2025-04-21,Assembly,"AB 484 Dixon Consent Calendar Second Day Regular Session",73,0,0,6,79
1964672,1521984,2025-03-19,Assembly,"Do pass and be re-referred to the Committee on [Appropriations]",5,0,0,2,7
1964673,1526928,2025-03-25,Assembly,"Do pass as amended and be re-referred to the Committee on [Appropriations]",9,0,0,0,9
1964674,1535102,2025-04-02,Assembly,"Do pass and be re-referred to the Committee on [Appropriations] with recommendation: To Consent Calendar",17,0,0,0,17
1964676,1533592,2025-04-01,Assembly,"Do pass and be re-referred to the Committee on [Privacy and Consumer Protection]",17,0,0,1,18
1964676,1556016,2025-04-22,Assembly,"Do pass and be re-referred to the Committee on [Appropriations] with recommendation: To Consent Calendar",14,0,0,1,15
1964678,1525436,2025-03-24,Assembly,"Do pass as amended and be re-referred to the Committee on [Appropriations]",9,3,0,2,14
1964679,1533466,2025-04-01,Assembly,"Do pass and be re-referred to the Committee on [Appropriations]",15,0,0,0,15
1964679,1555956,2025-04-23,Assembly,"Do pass",15,0,0,0,15
1964679,1565301,2025-05-05,Assembly,"AB 492 Valencia Assembly Third Reading",76,0,0,3,79
1964680,1520449,2025-03-18,Assembly,"Do pass and be re-referred to the Committee on [Appropriations]",8,0,0,1,9
1964680,1521986,2025-03-19,Assembly,"Do pass as amended",15,0,0,0,15
1964680,1533534,2025-04-01,Assembly,"AB 493 Harabedian Third Reading Urgency",77,0,0,3,80
1964682,1554469,2025-04-22,Assembly,"Do pass and be re-referred to the Committee on [Human Services]",9,1,0,2,12
1964682,1562754,2025-04-29,Assembly,"Do pass and be re-referred to the Committee on [Appropriations]",5,1,0,1,7
1964685,1526933,2025-03-25,Assembly,"Do pass. To Consent Calendar",12,0,0,0,12
1964685,1533499,2025-04-01,Assembly,"AB 498 Michelle Rodriguez Consent Calendar Second Day",76,0,0,4,80
1964686,1526942,2025-03-25,Assembly,"Do pass and be re-referred to the Committee on [Appropriations]",12,0,0,3,15
1964687,1542815,2025-04-08,Assembly,"Do pass and be re-referred to the Committee on [Education]",10,0,0,0,10
1964687,1564248,2025-04-30,Assembly,"Do pass and be re-referred to the Committee on [Appropriations]",9,0,0,0,9
1964689,1528319,2025-03-26,Assembly,"Do pass and be re-referred to the Committee on [Appropriations] with recommendation: To Consent Calendar",7,0,0,0,7
1964689,1542936,2025-04-09,Assembly,"Do pass. To Consent Calendar",14,0,0,1,15
1964689,1557527,2025-04-24,Assembly,"AB 502 Pellerin Consent Calendar Second Day Regular Session",75,0,0,4,79
1964690,1544951,2025-04-09,Assembly,"Do pass. To Consent Calendar",9,0,0,0,9
1964690,1557563,2025-04-24,Assembly,"AB 503 Mark González Consent Calendar Second Day Regular Session",75,0,0,4,79
1964693,1540838,2025-04-08,Assembly,"Do pass and be re-referred to the Committee on [Business and Professions] with recommendation: To Consent Calendar",12,0,0,0,12
1964693,1554650,2025-04-22,Assembly,"Do pass as amended and be re-referred to the Committee on [Appropriations]",18,0,0,0,18
1964694,1558372,2025-04-24,Assembly,"Do pass and be re-referred to the Committee on [Local Government]",10,0,0,2,12
1964694,1564242,2025-04-30,Assembly,"Do pass and be re-referred to the Committee on [Appropriations]",9,0,0,1,10
1964695,1554672,2025-04-22,Assembly,"Do pass as amended and be re-referred to the Committee on [Appropriations]",7,0,0,0,7
1964696,1521963,2025-03-19,Assembly,"Do pass as amended and be re-referred to the Committee on [Appropriations]",19,0,0,3,22
1964697,1555971,2025-04-22,Assembly,"Do pass as amended and be re-referred to the Committee on [Appropriations]",13,0,0,3,16
1964698,1533504,2025-04-01,Assembly,"Do pass and be re-referred to the Committee on [Appropriations] with recommendation: To Consent Calendar",17,0,0,1,18
1964699,1555993,2025-04-22,Assembly,"Do pass as amended and be re-referred to the Committee on [Appropriations]",13,0,0,3,16
1964701,1563034,2025-04-29,Assembly,"Do pass as amended and be re-referred to the Committee on [Appropriations]",13,0,0,0,13
1964702,1540886,2025-04-08,Assembly,"Do pass and be re-referred to the Committee on [Appropriations] with recommendation: To Consent Calendar",12,0,0,0,12
1964702,1556085,2025-04-23,Assembly,"Do pass. To Consent Calendar",15,0,0,0,15
1964702,1564214,2025-05-01,Assembly,"AB 515 Pacheco Consent Calendar Second Day Regular Session",76,0,0,3,79
1964703,1533513,2025-04-01,Assembly,"Do pass and be re-referred to the Committee on [Appropriations] with recommendation: To Consent Calendar",17,0,0,1,18
1964703,1555970,2025-04-23,Assembly,"Do pass. To Consent Calendar",15,0,0,0,15
1964703,1564170,2025-05-01,Assembly,"AB 516 Kalra Consent Calendar Second Day Regular Session",76,0,0,3,79
1964704,1540818,2025-04-08,Assembly,"Do pass and be re-referred to the Committee on [Appropriations] with recommendation: To Consent Calendar",15,0,0,0,15
1964705,1542855,2025-04-09,Assembly,"Do pass as amended",10,1,0,1,12
1964706,1554512,2025-04-22,Assembly,"Do pass",17,0,0,1,18
1964706,1565252,2025-05-05,Assembly,"AB 519 Berman Assembly Third Reading",74,0,0,5,79
1964708,1533528,2025-04-01,Assembly,"Do pass and be re-referred to the Committee on [Judiciary] with recommendation: To Consent Calendar",17,0,0,1,18
1964708,1540800,2025-04-08,Assembly,"Do pass and be re-referred to the Committee on [Appropriations] with recommendation: To Consent Calendar",12,0,0,0,12
1964708,1556067,2025-04-23,Assembly,"Do pass. To Consent Calendar",15,0,0,0,15
1964708,1564194,2025-05-01,Assembly,"AB 521 Carrillo Consent Calendar Second Day Regular Session",76,0,0,3,79
1964710,1564171,2025-04-30,Assembly,"Do pass as amended",8,1,0,1,10
1964711,1562806,2025-04-30,Assembly,"Do pass and be re-referred to the Committee on [Appropriations]",8,0,0,0,8
1964712,1561034,2025-04-28,Assembly,"Do pass and be re-referred to the Committee on [Appropriations] with recommendation: To Consent Calendar",16,0,0,0,16
1964713,1535127,2025-04-02,Assembly,"Do pass as amended, and be re-referred to the Committee on [Natural Resources] with recommendation: To Consent Calendar",18,0,0,0,18
1964713,1558730,2025-04-21,Assembly,"Do pass and be re-referred to the Committee on [Appropriations] with recommendation: To Consent Calendar",14,0,0,0,14
1964714,1559495,2025-04-28,Assembly,"Do pass as amended and be re-referred to the Committee on [Appropriations]",14,0,0,0,14
1964715,1492780,2025-02-18,Assembly,"Be adopted. To third reading",10,0,0,1,11
1964716,1528244,2025-03-26,Senate,"Do pass, but first be re-referred to the Committee on [Military and Veterans Affairs]",5,0,0,0,5
1964716,1559383,2025-04-28,Senate,"Do pass, but first be re-referred to the Committee on [Appropriations] with the recommendation: To Consent Calendar",4,0,0,1,5
1964717,1544974,2025-04-09,Senate,"Do pass as amended, but first amend, and re-refer to the Committee on [Judiciary]",10,0,0,1,11
1964717,1563008,2025-04-29,Senate,"Do pass, but first be re-referred to the Committee on [Appropriations]",12,0,0,1,13
1964718,1538982,2025-04-07,Senate,"Do pass as amended, but first amend, and re-refer to the Committee on [Environmental Quality]",14,0,0,3,17
1964718,1562903,2025-04-30,Senate,"Do pass, but first be re-referred to the Committee on [Appropriations]",8,0,0,0,8
1964719,1555930,2025-04-23,Senate,"Do pass, but first be re-referred to the Committee on [Environmental Quality]",4,3,0,0,7
1964719,1563020,2025-04-30,Senate,"Do pass as amended",6,1,0,1,8
1964721,1562761,2025-04-30,Senate,"Do pass",5,0,0,0,5
1964722,1528297,2025-03-26,Senate,"Do pass as amended, but first amend, and re-refer to the Committee on [Appropriations]",5,0,0,0,5
1964722,1538920,2025-04-07,Senate,"Placed on suspense file",7,0,0,0,7
1964723,1556075,2025-04-22,Senate,"Do pass, but first be re-referred to the Committee on [Public Safety]",11,2,0,0,13
1964723,1562991,2025-04-29,Senate,"Do pass as amended",5,1,0,0,6
1964724,1554594,2025-04-22,Senate,"Do pass as amended, but first amend, and re-refer to the Committee on [Appropriations]",6,0,0,1,7
1964725,1556200,2025-04-23,Senate,"Do pass, but first be re-referred to the Committee on [Appropriations]",7,0,0,0,7
1964725,1565330,2025-05-05,Senate,"Placed on suspense file",7,0,0,0,7
1964726,1557495,2025-04-23,Senate,"Do pass as amended, but first amend, and re-refer to the Committee on [Appropriations]",10,0,0,1,11
1964727,1556054,2025-04-23,Senate,"Do pass, but first be re-referred to the Committee on [Judiciary]",6,1,0,0,7
1964727,1562902,2025-04-29,Senate,"Do pass, but first be re-referred to the Committee on [Appropriations]",12,0,0,1,13
1964730,1542827,2025-04-09,Senate,"Do pass, but first be re-referred to the Committee on [Judiciary]",4,1,0,0,5
1964730,1555949,2025-04-22,Senate,"Do pass, but first be re-referred to the Committee on [Appropriations]",10,2,0,1,13
1964730,1565335,2025-05-05,Senate,"Placed on suspense file",7,0,0,0,7
1964731,1562745,2025-04-29,Senate,"Do pass, but first be re-referred to the Committee on [Appropriations]",1,4,0,1,6
1964731,1562746,2025-04-29,Senate,"[First] hearing set for [04-30-2025]: Failed passage in Committee. Reconsideration granted",6,0,0,0,6
1964732,1538972,2025-04-07,Senate,"Do pass, but first be re-referred to the Committee on [Agriculture]",10,0,0,1,11
1964732,1561150,2025-04-29,Senate,"Do pass as amended, but first amend, and re-refer to the Committee on [Appropriations]",4,0,0,1,5
1964733,1557576,2025-04-23,Senate,"Do pass, but first be re-referred to the Committee on [Judiciary]",9,2,0,0,11
1964733,1562807,2025-04-29,Senate,"Do pass as amended, but first amend, and re-refer to the Committee on [Appropriations]",11,1,0,1,13
1964734,1559458,2025-04-28,Senate,"Do pass, but first be re-referred to the Committee on [Appropriations]",10,0,0,1,11
1964736,1501951,2025-02-27,Senate,"Senate 3rd Reading SCR20 Ochoa Bogh et al",35,0,0,4,39
1964736,1519120,2025-03-17,Assembly,"Be adopted. To Consent Calendar",10,0,0,1,11
1964736,1523574,2025-03-20,Assembly,"SCR 20 Ochoa Bogh Consent Calendar Second Day Regular Session",67,0,0,13,80
1965842,1526888,2025-03-25,Assembly,"Do pass and be re-referred to the Committee on [Appropriations]",9,0,0,0,9
1965843,1533490,2025-04-01,Assembly,"Do pass and be re-referred to the Committee on [Appropriations] with recommendation: To Consent Calendar",17,0,0,1,18
1965843,1556125,2025-04-23,Assembly,"Do pass. To Consent Calendar",15,0,0,0,15
1965843,1564148,2025-05-01,Assembly,"AB 529 Ahrens Consent Calendar Second Day Regular Session",76,0,0,3,79
1965844,1522006,2025-03-18,Assembly,"Do pass and be re-referred to the Committee on [Appropriations]",9,0,0,1,10
1965845,1535000,2025-04-02,Assembly,"Do pass and be re-referred to the Committee on [Appropriations] with recommendation: To Consent Calendar",18,0,0,0,18
1965845,1537459,2025-04-02,Assembly,"Do pass and be re-referred to the Committee on [Natural Resources] with recommendation: To Consent Calendar",18,0,0,0,18
1965845,1558729,2025-04-21,Assembly,"Do pass and be re-referred to the Committee on [Appropriations] with recommendation: To Consent Calendar",14,0,0,0,14
1965846,1561083,2025-04-29,Assembly,"Do pass and be re-referred to the Committee on [Utilities and Energy]",7,0,0,0,7
1965846,1564161,2025-04-30,Assembly,"Do pass as amended, and be re-referred to the Committee on [Appropriations] with recommendation: To Consent Calendar",18,0,0,0,18
1965847,1528252,2025-03-26,Assembly,"Do pass and be re-referred to the Committee on [Appropriations]",8,0,0,2,10
1965847,1542852,2025-04-09,Assembly,"Do pass",14,0,0,1,15
1965847,1557519,2025-04-24,Assembly,"AB 533 Flora Assembly Third Reading",73,0,0,6,79
1965848,1526960,2025-03-25,Assembly,"Do pass and be re-referred to the Committee on [Appropriations]",7,0,0,0,7
1965849,1526950,2025-03-25,Assembly,"Do pass and be re-referred to the Committee on [Appropriations] with recommendation: To Consent Calendar",9,0,0,0,9
1965850,1540978,2025-04-08,Assembly,"Do pass and be re-referred to the Committee on [Appropriations]",15,0,0,0,15
1965850,1555996,2025-04-23,Assembly,"Do pass",15,0,0,0,15
1965850,1565358,2025-05-05,Assembly,"AB 536 Patterson Assembly Third Reading",74,0,0,5,79
1965851,1556117,2025-04-22,Assembly,"Do pass and be re-referred to the Committee on [Appropriations]",9,0,0,1,10
1965852,1521955,2025-03-19,Assembly,"Do pass and be re-referred to the Committee on [Appropriations]",6,0,0,1,7
1965853,1555973,2025-04-22,Assembly,"Do pass as amended and be re-referred to the Committee on [Appropriations]",12,0,0,4,16
1965853,1567874,2025-05-07,Assembly,"Do pass",11,0,0,4,15
1965854,1526929,2025-03-25,Assembly,"Do pass. To Consent Calendar",12,0,0,0,12
1965854,1533485,2025-04-01,Assembly,"AB 540 Connolly Consent Calendar Second Day Regular Session",76,0,0,4,80
1965855,1540912,2025-04-08,Assembly,"Do pass and be re-referred to the Committee on [Appropriations]",12,0,0,0,12
1965856,1564219,2025-04-30,Assembly,"Do pass and be re-referred to the Committee on [Appropriations] with recommendation: To Consent Calendar",9,0,0,0,9
1965857,1555998,2025-04-22,Assembly,"Do pass and be re-referred to the Committee on [Appropriations]",16,0,0,0,16
1965858,1538901,2025-04-07,Assembly,"Do pass and be re-referred to the Committee on [Appropriations] with recommendation: To Consent Calendar",16,0,0,0,16
1965858,1563084,2025-04-30,Assembly,"Do pass. To Consent Calendar",14,0,0,1,15
1965858,1568653,2025-05-08,Assembly,"AB 544 Davies Consent Calendar Second Day Regular Session",69,0,0,10,79
1965859,1538927,2025-04-07,Assembly,"Do pass and be re-referred to the Committee on [Appropriations] with recommendation: To Consent Calendar",16,0,0,0,16
1965859,1562897,2025-04-30,Assembly,"Do pass. To Consent Calendar",14,0,0,1,15
1965859,1568662,2025-05-08,Assembly,"AB 545 Davies Consent Calendar Second Day Regular Session",69,0,0,10,79
1965860,1562778,2025-04-29,Assembly,"Do pass as amended and be re-referred to the Committee on [Appropriations]",14,0,0,2,16
1965861,1566735,2025-05-05,Assembly,"Do pass as amended and be re-referred to the Committee on [Appropriations]",5,1,0,1,7
1965862,1562884,2025-04-29,Assembly,"Do pass and be re-referred to the Committee on [Appropriations]",5,2,0,0,7
1965863,1540918,2025-04-07,Assembly,"Do pass and be re-referred to the Committee on [Arts, Entertainment, Sports, and Tourism]",7,0,0,0,7
1965863,1554443,2025-04-22,Assembly,"Do pass as amended and be re-referred to the Committee on [Appropriations]",8,0,0,1,9
1965864,1562814,2025-04-29,Assembly,"Do pass as amended and be re-referred to the Committee on [Appropriations]",13,0,0,0,13
1965865,1540868,2025-04-08,Assembly,"Do pass as amended and be re-referred to the Committee on [Appropriations]",12,1,0,2,15
1965866,1536846,2025-04-02,Assembly,"Do pass and be re-referred to the Committee on [Appropriations]",6,0,0,1,7
1965867,1526898,2025-03-25,Assembly,"Do pass and be re-referred to the Committee on [Appropriations] with recommendation: To Consent Calendar",7,0,0,0,7
1965867,1542894,2025-04-09,Assembly,"Do pass. To Consent Calendar",14,0,0,1,15
1965867,1557485,2025-04-24,Assembly,"AB 553 Caloza Consent Calendar Second Day Regular Session",75,0,0,4,79
1965868,1562787,2025-04-29,Assembly,"Do pass and be re-referred to the Committee on [Appropriations]",14,0,0,2,16
1965869,1492767,2025-02-18,Assembly,"Be adopted. To third reading",10,0,0,1,11
1965871,1521964,2025-03-19,Senate,"Do pass, but first be re-referred to the Committee on [Elections and Constitutional Amendments]",5,1,0,1,7
1965871,1561018,2025-04-29,Senate,"Do pass as amended, but first amend, and re-refer to the Committee on [Appropriations]",4,1,0,0,5
1965872,1557549,2025-04-23,Senate,"Do pass as amended, but first amend, and re-refer to the Committee on [Appropriations] with the recommendation: To Consent Calendar",11,0,0,0,11
1965873,1555950,2025-04-23,Senate,"Do pass as amended, but first amend, and re-refer to the Committee on [Appropriations]",5,3,0,0,8
1965873,1565302,2025-05-05,Senate,"Placed on suspense file",7,0,0,0,7
1965874,1554625,2025-04-22,Senate,"Do pass as amended, but first amend, and re-refer to the Committee on [Appropriations]",5,0,0,1,6
1965874,1565357,2025-05-05,Senate,"Placed on suspense file",7,0,0,0,7
1965875,1526915,2025-03-25,Senate,"Do pass as amended, but first amend, and re-refer to the Committee on [Judiciary]",5,1,0,0,6
1965875,1555917,2025-04-22,Senate,"Do pass, but first be re-referred to the Committee on [Appropriations]",11,2,0,0,13
1965875,1565319,2025-05-05,Senate,"Placed on suspense file",7,0,0,0,7
1965876,1561168,2025-04-29,Senate,"Do pass, but first be re-referred to the Committee on [Appropriations]",5,0,0,0,5
1965877,1555935,2025-04-23,Senate,"Do pass, but first be re-referred to the Committee on [Appropriations] with the recommendation: To Consent Calendar",7,0,0,0,7
1965878,1556033,2025-04-23,Senate,"Do pass, but first be re-referred to the Committee on [Appropriations]",6,0,0,1,7
1965878,1565243,2025-05-05,Senate,"Placed on suspense file",7,0,0,0,7
1965879,1535037,2025-04-02,Senate,"Do pass as amended, but first amend, and re-refer to the Committee on [Appropriations]",11,0,0,0,11
1965879,1552944,2025-04-21,Senate,"Placed on suspense file",6,0,0,1,7
1965881,1526978,2025-03-25,Senate,"Do pass, but first be re-referred to the Committee on [Natural Resources and Water] with the recommendation: To Consent Calendar",13,0,0,2,15
1965881,1554507,2025-04-22,Senate,"Do pass, but first be re-referred to the Committee on [Appropriations] with the recommendation: To Consent Calendar",6,0,0,1,7
1965881,1565265,2025-05-05,Senate,"Placed on suspense file",7,0,0,0,7
1965883,1536782,2025-04-02,Senate,"Do pass as amended, but first amend, and re-refer to the Committee on [Revenue and Taxation]",8,0,0,0,8
1965883,1556102,2025-04-23,Senate,"Do pass as amended, but first amend, and re-refer to the Committee on [Appropriations]",5,0,0,0,5
1965884,1528308,2025-03-26,Senate,"Do pass as amended, but first amend, and re-refer to the Committee on [Appropriations]",10,0,0,1,11
1965884,1552937,2025-04-21,Senate,"Placed on suspense file",6,0,0,1,7
1965885,1498289,2025-02-24,Senate,"Senate 3rd Reading SCR21 Smallwood-Cuevas",37,0,0,2,39
1965885,1519136,2025-03-17,Assembly,"Be adopted. To Consent Calendar",10,0,0,1,11
1965885,1523438,2025-03-20,Assembly,"SCR 21 Smallwood-Cuevas Consent Calendar Second Day Regular Session",66,0,0,14,80
1965886,1495961,2025-02-20,Senate,"Senate 3rd Reading SR16 Caballero et al",36,0,0,3,39
1968196,1559391,2025-04-28,Assembly,"Do pass and be re-referred to the Committee on [Appropriations] with recommendation: To Consent Calendar",14,0,0,0,14
1968197,1522021,2025-03-18,Assembly,"Do pass and be re-referred to the Committee on [Military and Veterans Affairs]",8,0,0,2,10
1968197,1545004,2025-04-08,Assembly,"Do pass and be re-referred to the Committee on [Appropriations]",6,0,0,2,8
1968198,1558354,2025-04-24,Assembly,"Do pass and be re-referred to the Committee on [Local Government]",11,0,0,1,12
1968200,1533464,2025-04-01,Assembly,"Do pass and be re-referred to the Committee on [Judiciary] with recommendation: To Consent Calendar",17,0,0,1,18
1968200,1540930,2025-04-08,Assembly,"Do pass and be re-referred to the Committee on [Appropriations] with recommendation: To Consent Calendar",12,0,0,0,12
1968200,1556159,2025-04-23,Assembly,"Do pass. To Consent Calendar",15,0,0,0,15
1968200,1564298,2025-05-01,Assembly,"AB 559 Berman Consent Calendar Second Day Regular Session",76,0,0,3,79
1968201,1564181,2025-04-30,Assembly,"Do pass and be re-referred to the Committee on [Appropriations]",9,0,0,0,9
1968202,1526927,2025-03-25,Assembly,"Do pass and be re-referred to the Committee on [Appropriations] with recommendation: To Consent Calendar",12,0,0,0,12
1968203,1526949,2025-03-25,Assembly,"Do pass and be re-referred to the Committee on [Appropriations]",7,0,0,0,7
1968203,1542800,2025-04-09,Assembly,"Do pass",14,0,0,1,15
1968204,1540804,2025-04-08,Assembly,"Do pass as amended and be re-referred to the Committee on [Education]",6,0,0,0,6
1968204,1564174,2025-04-30,Assembly,"Do pass and be re-referred to the Committee on [Appropriations] with recommendation: To Consent Calendar",9,0,0,0,9
1968205,1554556,2025-04-22,Assembly,"Do pass and be re-referred to the Committee on [Revenue and Taxation]",15,0,0,3,18
1968205,1566722,2025-05-05,Assembly,"Do pass as amended and be re-referred to the Committee on [Appropriations]",6,0,0,1,7
1968206,1526907,2025-03-25,Assembly,"Do pass as amended. To Consent Calendar",12,0,0,0,12
1968206,1536806,2025-04-03,Assembly,"AB 565 Dixon Consent Calendar Second Day",74,0,0,5,79
1968207,1535134,2025-04-01,Assembly,"Do pass as amended and be re-referred to the Committee on [Appropriations]",9,0,0,6,15
1968207,1555903,2025-04-23,Assembly,"Do pass",11,0,0,4,15
1968209,1527012,2025-03-25,Assembly,"Do pass as amended and be re-referred to the Committee on [Appropriations]",9,0,0,0,9
1968210,1556073,2025-04-23,Assembly,"Do pass as amended",7,0,0,0,7
1968211,1535001,2025-04-02,Assembly,"Do pass and be re-referred to the Committee on [Appropriations] with recommendation: To Consent Calendar",17,0,0,0,17
1968211,1556023,2025-04-23,Assembly,"Do pass. To Consent Calendar",15,0,0,0,15
1968211,1564152,2025-05-01,Assembly,"AB 570 Calderon Consent Calendar Second Day Regular Session",76,0,0,3,79
1968212,1538976,2025-04-07,Assembly,"Do pass as amended and be re-referred to the Committee on [Military and Veterans Affairs]",14,0,0,0,14
1968212,1561152,2025-04-29,Assembly,"Do pass and be re-referred to the Committee on [Appropriations]",8,0,0,0,8
1968212,1567852,2025-05-07,Assembly,"Do pass",15,0,0,0,15
1968213,1526969,2025-03-25,Assembly,"Do pass as amended and be re-referred to the Committee on [Appropriations]",5,2,0,2,9
1968213,1542788,2025-04-09,Assembly,"Do pass",10,4,0,1,15
1968214,1556208,2025-04-22,Assembly,"Do pass and be re-referred to the Committee on [Appropriations]",13,0,0,3,16
1968215,1555883,2025-04-22,Assembly,"Do pass and be re-referred to the Committee on [Appropriations]",16,0,0,0,16
1968215,1562867,2025-04-30,Assembly,"Do pass",14,0,0,1,15
1968217,1564218,2025-05-01,Assembly,"Do pass and be re-referred to the Committee on [Appropriations]",13,0,0,2,15
1968218,1563041,2025-04-29,Assembly,"Do pass as amended and be re-referred to the Committee on [Appropriations]",12,0,0,4,16
1968219,1520442,2025-03-18,Assembly,"Do pass as amended",14,0,0,1,15
1968221,1525458,2025-03-24,Assembly,"Do pass as amended and be re-referred to the Committee on [Water, Parks, and Wildlife]",13,0,0,1,14
1968221,1563031,2025-04-29,Assembly,"Do pass and be re-referred to the Committee on [Appropriations] with recommendation: To Consent Calendar",13,0,0,0,13
1968222,1526900,2025-03-25,Assembly,"Do pass. To Consent Calendar",13,0,0,0,13
1968222,1530382,2025-03-28,Assembly,"AB 581 Bennett Consent Calendar Second Day Regular Session",61,0,0,19,80
1968224,1533529,2025-04-01,Assembly,"Do pass as amended and be re-referred to the Committee on [Appropriations]",15,0,0,0,15
1968224,1555997,2025-04-23,Assembly,"Do pass",15,0,0,0,15
1968224,1568607,2025-05-08,Assembly,"AB 583 Pellerin Assembly Third Reading",72,0,0,7,79
1968225,1526930,2025-03-25,Assembly,"Do pass and be re-referred to the Committee on [Appropriations] with recommendation: To Consent Calendar",9,0,0,0,9
1968225,1542679,2025-04-09,Assembly,"Do pass. To Consent Calendar",14,0,0,1,15
1968225,1557513,2025-04-24,Assembly,"AB 584 Hadwick Consent Calendar Second Day Regular Session",75,0,0,4,79
1968226,1563005,2025-04-29,Assembly,"Do pass and be re-referred to the Committee on [Appropriations] with recommendation: To Consent Calendar",16,0,0,0,16
1968227,1533467,2025-04-01,Assembly,"Do pass and be re-referred to the Committee on [Judiciary] with recommendation: To Consent Calendar",17,0,0,1,18
1968227,1554636,2025-04-22,Assembly,"Do pass and be re-referred to the Committee on [Appropriations] with recommendation: To Consent Calendar",12,0,0,0,12
1968228,1556211,2025-04-22,Assembly,"Do pass and be re-referred to the Committee on [Appropriations]",10,0,0,0,10
1968228,1567886,2025-05-07,Assembly,"Do pass",15,0,0,0,15
1968229,1561170,2025-04-28,Assembly,"Do pass and be re-referred to the Committee on [Appropriations] with recommendation: To Consent Calendar",7,0,0,0,7
1968232,1561010,2025-04-28,Assembly,"Do pass and be re-referred to the Committee on [Appropriations]",7,0,0,0,7
1968233,1535063,2025-04-02,Assembly,"Do pass as amended and be re-referred to the Committee on [Health]",18,0,0,4,22
1968233,1556210,2025-04-22,Assembly,"Do pass and be re-referred to the Committee on [Appropriations]",16,0,0,0,16
1968233,1563097,2025-04-30,Assembly,"Do pass",14,0,0,1,15
1968234,1562916,2025-04-29,Assembly,"Do pass as amended and be re-referred to the Committee on [Appropriations]",7,0,0,0,7
1968235,1540913,2025-04-08,Assembly,"Do pass and be re-referred to the Committee on [Appropriations]",15,0,0,0,15
1968235,1556017,2025-04-23,Assembly,"Do pass",15,0,0,0,15
1968235,1568615,2025-05-08,Assembly,"AB 594 Solache Assembly Third Reading",73,0,0,6,79
1968236,1530394,2025-03-28,Assembly,"Be adopted. To third reading",7,0,0,4,11
1968237,1561141,2025-04-29,Senate,"Do pass, but first be re-referred to the Committee on [Environmental Quality]",13,3,0,1,17
1968237,1562976,2025-04-30,Senate,"Do pass, but first be re-referred to the Committee on [Appropriations]",6,2,0,0,8
1968238,1544998,2025-04-09,Senate,"Do pass as amended, but first amend, and re-refer to the Committee on [Judiciary]",8,0,0,3,11
1968238,1563014,2025-04-29,Senate,"Do pass as amended, but first amend, and re-refer to the Committee on [Appropriations]",10,0,0,3,13
1968239,1554554,2025-04-21,Senate,"Do pass, but first be re-referred to the Committee on [Judiciary]",12,4,0,1,17
1968239,1565333,2025-05-05,Senate,"Placed on suspense file",7,0,0,0,7
1968240,1521989,2025-03-19,Senate,"Do pass, but first be re-referred to the Committee on [Revenue and Taxation]",5,2,0,0,7
1968240,1542715,2025-04-09,Senate,"Do pass",4,1,0,0,5
1968241,1535027,2025-04-02,Senate,"Do pass, but first be re-referred to the Committee on [Judiciary]",6,0,0,1,7
1968241,1565279,2025-05-05,Senate,"Placed on suspense file",7,0,0,0,7
1968242,1561203,2025-04-29,Senate,"Do pass, but first be re-referred to the Committee on [Appropriations]",1,4,0,0,5
1968242,1561204,2025-04-29,Senate,"[First] hearing set for [04-29-2025]: Failed passage in Committee. Reconsideration granted",5,0,0,0,5
1968244,1562760,2025-04-29,Senate,"Do pass, but first be re-referred to the Committee on [Appropriations]",6,0,0,0,6
1968245,1557500,2025-04-23,Senate,"Do pass as amended, but first amend, and re-refer to the Committee on [Appropriations] with the recommendation: To Consent Calendar",11,0,0,0,11
1968246,1557569,2025-04-23,Senate,"Do pass, but first be re-referred to the Committee on [Judiciary]",11,0,0,0,11
1968246,1563121,2025-04-29,Senate,"Do pass, but first be re-referred to the Committee on [Appropriations] with the recommendation: To Consent Calendar",13,0,0,0,13
1968247,1533544,2025-04-01,Senate,"Do pass, but first be re-referred to the Committee on [Appropriations]",11,0,0,0,11
1968248,1522019,2025-03-19,Senate,"Do pass as amended, but first amend, and re-refer to the Committee on [Agriculture]",6,0,0,1,7
1968248,1561078,2025-04-29,Senate,"Do pass, but first be re-referred to the Committee on [Appropriations] with the recommendation: To Consent Calendar",4,0,0,1,5
1968251,1559397,2025-04-28,Senate,"Do pass, but first be re-referred to the Committee on [Appropriations] with the recommendation: To Consent Calendar",11,0,0,0,11
1968252,1526953,2025-03-25,Senate,"Do pass, but first be re-referred to the Committee on [Appropriations] with the recommendation: To Consent Calendar",13,0,0,2,15
1968252,1538971,2025-04-07,Senate,"Placed on suspense file",7,0,0,0,7
1968253,1521960,2025-03-19,Senate,"Do pass as amended, but first amend, and re-refer to the Committee on [Judiciary]",7,0,0,0,7
1968253,1567879,2025-05-06,Senate,"Do pass as amended",12,0,0,1,13
1968255,1562846,2025-04-30,Senate,"Do pass as amended, but first amend, and re-refer to the Committee on [Appropriations]",6,0,0,2,8
1968256,1526923,2025-03-25,Senate,"Do pass, but first be re-referred to the Committee on [Public Safety] with the recommendation: To Consent Calendar",14,0,0,1,15
1968256,1554463,2025-04-22,Senate,"Do pass, but first be re-referred to the Committee on [Appropriations] with the recommendation: To Consent Calendar",6,0,0,0,6
1968256,1565337,2025-05-05,Senate,"Placed on suspense file",7,0,0,0,7
1968257,1522014,2025-03-19,Senate,"Do pass as amended, but first amend, and re-refer to the Committee on [Energy, Utilities and Communications]",6,1,0,1,8
1968257,1554502,2025-04-21,Senate,"Do pass as amended, but first amend, and re-refer to the Committee on [Appropriations]",13,3,0,1,17
1968258,1552901,2025-04-21,Senate,"Do pass, but first be re-referred to the Committee on [Judiciary]",9,1,0,1,11
1968258,1562810,2025-04-29,Senate,"Do pass, but first be re-referred to the Committee on [Appropriations]",11,2,0,0,13
1968259,1540843,2025-04-07,Senate,"Do pass, but first be re-referred to the Committee on [Governmental Organization] with the recommendation: To Consent Calendar",5,0,0,0,5
1968259,1554466,2025-04-22,Senate,"Do pass, but first be re-referred to the Committee on [Appropriations] with the recommendation: To Consent Calendar",14,0,0,1,15
1968259,1565250,2025-05-05,Senate,"Placed on suspense file",7,0,0,0,7
1968261,1542760,2025-04-09,Senate,"Do pass, but first be re-referred to the Committee on [Judiciary]",5,2,0,0,7
1968261,1563002,2025-04-29,Senate,"Do pass as amended, but first amend, and re-refer to the Committee on [Appropriations]",11,2,0,0,13
1968262,1542841,2025-04-09,Senate,"Do pass, but first be re-referred to the Committee on [Rules]",5,0,0,0,5
1968262,1562775,2025-04-29,Senate,"Do pass, but first be re-referred to the Committee on [Appropriations] with the recommendation: To Consent Calendar",13,0,0,0,13
1968263,1540835,2025-04-08,Senate,"Do pass as amended, but first amend, and re-refer to the Committee on [Appropriations]",4,2,0,0,6
1968263,1559454,2025-04-28,Senate,"Placed on suspense file",7,0,0,0,7
1968264,1562824,2025-04-29,Senate,"Do pass",4,1,0,1,6
1968265,1563033,2025-04-30,Senate,"Do pass as amended, but first amend, and re-refer to the Committee on [Appropriations]",5,2,0,0,7
1968266,1533493,2025-04-01,Senate,"Senate 3rd Reading SCR22 Alvarado-Gil",39,0,0,1,40
1968266,1552885,2025-04-21,Assembly,"Be adopted. To Consent Calendar",10,0,0,1,11
1968266,1557564,2025-04-24,Assembly,"SCR 22 Alvarado-Gil Consent Calendar Second Day Regular Session",75,0,0,4,79
1968267,1565253,2025-05-05,Senate,"Senate 3rd Reading SCR23 Umberg",38,0,0,2,40
1970383,1563009,2025-04-30,Assembly,"Do pass as amended and be re-referred to the Committee on [Appropriations]",9,1,0,2,12
1970384,1522015,2025-03-19,Assembly,"Do pass and be re-referred to the Committee on [Appropriations]",6,0,0,1,7
1970384,1556137,2025-04-23,Assembly,"Do pass",11,2,0,2,15
1970384,1559420,2025-04-28,Assembly,"AB 596 McKinnor Assembly Third Reading",63,10,0,6,79
1970385,1521977,2025-03-19,Assembly,"Do pass and be re-referred to the Committee on [Appropriations]",17,0,0,0,17
1970385,1521978,2025-03-19,Assembly,"Do pass as amended",15,0,0,0,15
1970385,1533465,2025-04-01,Assembly,"AB 597 Harabedian Third Reading Urgency",77,0,0,3,80
1970386,1529535,2025-03-26,Assembly,"Do pass and be re-referred to the Committee on [Emergency Management] with recommendation: To Consent Calendar",9,0,0,0,9
1970386,1561201,2025-04-28,Assembly,"Do pass and be re-referred to the Committee on [Appropriations]",7,0,0,0,7
1970387,1528305,2025-03-25,Assembly,"Do pass and be re-referred to the Committee on [Appropriations] with recommendation: To Consent Calendar",7,0,0,0,7
1970389,1540807,2025-04-08,Assembly,"Do pass as amended and be re-referred to the Committee on [Public Safety]",6,0,0,0,6
1970390,1561163,2025-04-29,Assembly,"Do pass as amended and be re-referred to the Committee on [Appropriations]",6,3,0,1,10
1970392,1528240,2025-03-26,Assembly,"Do pass. To Consent Calendar",7,0,0,0,7
1970392,1533483,2025-04-01,Assembly,"AB 604 Berman Consent Calendar Second Day Regular Session",75,1,0,4,80
1970393,1554623,2025-04-21,Assembly,"Do pass and be re-referred to the Committee on [Natural Resources]",15,0,0,1,16
1970393,1559502,2025-04-28,Assembly,"Do pass and be re-referred to the Committee on [Appropriations] with recommendation: To Consent Calendar",14,0,0,0,14
1970394,1544960,2025-04-09,Assembly,"Do pass and be re-referred to the Committee on [Appropriations] with recommendation: To Consent Calendar",9,0,0,0,9
1970394,1563069,2025-04-30,Assembly,"Do pass. To Consent Calendar",14,0,0,1,15
1970394,1568648,2025-05-08,Assembly,"AB 606 Quirk-Silva Consent Calendar Second Day Regular Session",69,0,0,10,79
1970395,1526934,2025-03-25,Assembly,"Do pass and be re-referred to the Committee on [Appropriations] with recommendation: To Consent Calendar",7,0,0,0,7
1970397,1558704,2025-04-21,Assembly,"Do pass as amended and be re-referred to the Committee on [Housing and Community Development]",12,0,0,2,14
1970397,1562998,2025-04-30,Assembly,"Do pass as amended and be re-referred to the Committee on [Appropriations]",11,0,0,1,12
1970398,1558370,2025-04-24,Assembly,"Do pass and be re-referred to the Committee on [Local Government]",11,0,0,1,12
1970398,1564146,2025-04-30,Assembly,"Do pass and be re-referred to the Committee on [Appropriations]",10,0,0,0,10
1970399,1557570,2025-04-23,Assembly,"Do pass and be re-referred to the Committee on [Judiciary]",5,0,0,2,7
1970399,1561127,2025-04-29,Assembly,"Do pass",7,3,0,2,12
1970399,1568645,2025-05-08,Assembly,"AB 611 Lee Assembly Third Reading",41,14,0,24,79
1970400,1525429,2025-03-24,Assembly,"Do pass and be re-referred to the Committee on [Appropriations]",16,0,0,0,16
1970401,1566703,2025-05-05,Assembly,"Do pass as amended and be re-referred to the Committee on [Appropriations]",6,0,0,1,7
1970402,1526940,2025-03-25,Assembly,"Do pass as amended and be re-referred to the Committee on [Appropriations]",11,0,0,1,12
1970403,1540822,2025-04-07,Assembly,"Do pass and be re-referred to the Committee on [Utilities and Energy]",7,0,0,0,7
1970403,1564207,2025-04-30,Assembly,"Do pass as amended, and be re-referred to the Committee on [Appropriations] with recommendation: To Consent Calendar",18,0,0,0,18
1970404,1526887,2025-03-25,Assembly,"Do pass and be re-referred to the Committee on [Appropriations]",13,0,0,0,13
1970405,1562968,2025-04-29,Assembly,"Do pass and be re-referred to the Committee on [Appropriations]",5,1,0,1,7
1970406,1533486,2025-04-01,Assembly,"Do pass and be re-referred to the Committee on [Appropriations] with recommendation: To Consent Calendar",15,0,0,0,15
1970407,1538936,2025-04-07,Assembly,"Do pass and be re-referred to the Committee on [Public Safety]",14,0,0,0,14
1970407,1562777,2025-04-29,Assembly,"Do pass and be re-referred to the Committee on [Appropriations] with recommendation: To Consent Calendar",9,0,0,0,9
1970408,1525441,2025-03-24,Assembly,"Do pass and be re-referred to the Committee on [Appropriations] with recommendation: To Consent Calendar",16,0,0,0,16
1970409,1520450,2025-03-18,Assembly,"Do pass as amended and be re-referred to the Committee on [Judiciary]",15,0,0,0,15
1970409,1540797,2025-04-08,Assembly,"Do pass as amended, and be re-referred to the Committee on [Appropriations] with recommendation: To Consent Calendar",12,0,0,0,12
1970410,1542799,2025-04-08,Assembly,"Do pass and be re-referred to the Committee on [Appropriations]",5,0,0,4,9
1970410,1555896,2025-04-23,Assembly,"Do pass",10,4,0,1,15
1970414,1542807,2025-04-08,Assembly,"Do pass as amended and be re-referred to the Committee on [Appropriations]",7,0,0,0,7
1970415,1533491,2025-04-01,Assembly,"Do pass as amended, and be re-referred to the Committee on [Appropriations] with recommendation: To Consent Calendar",15,0,0,0,15
1970415,1556182,2025-04-23,Assembly,"Do pass. To Consent Calendar",15,0,0,0,15
1970415,1564244,2025-05-01,Assembly,"AB 627 Stefani Consent Calendar Second Day Regular Session",76,0,0,3,79
1970416,1526904,2025-03-25,Assembly,"Do pass as amended",9,1,0,2,12
1970416,1538905,2025-04-07,Assembly,"AB 628 McKinnor Assembly Third Reading",54,10,0,15,79
1970417,1529515,2025-03-26,Assembly,"Do pass and be re-referred to the Committee on [Appropriations] with recommendation: To Consent Calendar",9,0,0,0,9
1970418,1561102,2025-04-28,Assembly,"Do pass as amended and be re-referred to the Committee on [Appropriations]",15,0,0,1,16
1970419,1533487,2025-04-01,Assembly,"Do pass as amended and be re-referred to the Committee on [Appropriations]",17,0,0,1,18
1970419,1556068,2025-04-23,Assembly,"Do pass",15,0,0,0,15
1970419,1559480,2025-04-28,Assembly,"AB 631 Lee Assembly Third Reading",72,0,0,7,79
1970420,1542804,2025-04-09,Assembly,"Do pass as amended and be re-referred to the Committee on [Judiciary]",8,0,0,2,10
1970420,1566691,2025-05-06,Assembly,"Do pass as amended",9,0,0,3,12
1970423,1542716,2025-04-09,Assembly,"Do pass and be re-referred to the Committee on [Judiciary]",9,1,0,2,12
1970423,1561187,2025-04-29,Assembly,"Do pass and be re-referred to the Committee on [Appropriations]",8,2,0,2,12
1970424,1533555,2025-04-01,Assembly,"Do pass and be re-referred to the Committee on [Appropriations]",15,0,0,0,15
1970426,1528271,2025-03-25,Assembly,"Do pass and be re-referred to the Committee on [Appropriations]",7,0,0,0,7
1970427,1526943,2025-03-25,Assembly,"Do pass as amended and be re-referred to the Committee on [Appropriations]",13,0,0,0,13
1970427,1542682,2025-04-09,Assembly,"Do pass",14,0,0,1,15
1970427,1552835,2025-04-21,Assembly,"AB 639 Soria Assembly Third Reading",73,0,0,6,79
1970428,1545014,2025-04-09,Assembly,"Do pass and be re-referred to the Committee on [Appropriations]",7,0,0,2,9
1970429,1540976,2025-04-08,Assembly,"Do pass as amended, and be re-referred to the Committee on [Appropriations] with recommendation: To Consent Calendar",15,0,0,0,15
1970430,1529532,2025-03-26,Assembly,"Do pass as amended, and be re-referred to the Committee on [Appropriations] with recommendation: To Consent Calendar",9,0,0,0,9
1970432,1554514,2025-04-22,Assembly,"Do pass and be re-referred to the Committee on [Appropriations] with recommendation: To Consent Calendar",8,0,0,1,9
1970433,1556092,2025-04-22,Assembly,"Do pass and be re-referred to the Committee on [Emergency Management]",13,0,0,3,16
1970433,1561081,2025-04-28,Assembly,"Do pass and be re-referred to the Committee on [Appropriations]",6,0,0,1,7
1970434,1563032,2025-04-30,Assembly,"Do pass and be re-referred to the Committee on [Appropriations]",15,0,0,2,17
1970435,1558363,2025-04-24,Assembly,"Do pass and be re-referred to the Committee on [Local Government]",8,2,0,2,12
1970436,1521961,2025-03-18,Assembly,"Do pass and be re-referred to the Committee on [Local Government]",7,3,0,0,10
1970436,1564238,2025-04-30,Assembly,"Do pass as amended",9,0,0,1,10
1970437,1566723,2025-05-06,Assembly,"Do pass as amended",12,0,0,0,12
1970438,1558355,2025-04-24,Assembly,"Do pass and be re-referred to the Committee on [Local Government]",11,0,0,1,12
1970438,1564154,2025-04-30,Assembly,"Do pass and be re-referred to the Committee on [Appropriations]",9,0,0,1,10
1970439,1542937,2025-04-08,Assembly,"Do pass and be re-referred to the Committee on [Judiciary] with recommendation: To Consent Calendar",9,0,0,0,9
1970439,1554472,2025-04-22,Assembly,"Do pass and be re-referred to the Committee on [Appropriations] with recommendation: To Consent Calendar",12,0,0,0,12
1970440,1538945,2025-04-07,Assembly,"Do pass",13,0,0,1,14
1970440,1552875,2025-04-21,Assembly,"AB 652 Alvarez Assembly Third Reading",63,2,0,14,79
1970441,1554591,2025-04-22,Assembly,"Do pass and be re-referred to the Committee on [Appropriations] with recommendation: To Consent Calendar",9,0,0,0,9
1970442,1558356,2025-04-24,Assembly,"Do pass and be re-referred to the Committee on [Communications and Conveyance]",11,0,0,1,12
1970442,1562908,2025-04-30,Assembly,"Do pass and be re-referred to the Committee on [Appropriations]",8,2,0,0,10
1970443,1554611,2025-04-22,Assembly,"Do pass and be re-referred to the Committee on [Appropriations] with recommendation: To Consent Calendar",8,0,0,0,8
1970443,1567880,2025-05-07,Assembly,"Do pass. To Consent Calendar",15,0,0,0,15
1970444,1566704,2025-05-06,Assembly,"Do pass as amended",14,0,0,1,15
1970445,1555959,2025-04-22,Assembly,"Be adopted and re-referred to the Committee on [Judiciary]",6,3,0,1,10
1970445,1566706,2025-05-06,Assembly,"Be adopted as amended, and re-refer to the Committee on [Appropriations]",9,3,0,0,12
1970446,1517615,2025-03-13,Assembly,"Be adopted. To Consent Calendar",9,0,0,2,11
1970446,1523710,2025-03-20,Assembly,"ACR 32 Carrillo Consent Calendar Second Day Regular Session",67,0,0,13,80
1970447,1498282,2025-02-24,Assembly,"Be adopted. To third reading",11,0,0,0,11
1970449,1527008,2025-03-25,Senate,"Do pass, but first be re-referred to the Committee on [Appropriations]",6,0,0,1,7
1970449,1538997,2025-04-07,Senate,"Placed on suspense file",7,0,0,0,7
1970450,1535006,2025-04-01,Senate,"Do pass, but first be re-referred to the Committee on [Appropriations] with the recommendation: To Consent Calendar",13,0,0,0,13
1970450,1557578,2025-04-24,Senate,"Consent Calendar 2nd SB361 Becker",37,0,0,3,40
1970451,1534998,2025-04-02,Senate,"Do pass, but first be re-referred to the Committee on [Rules]",7,0,0,0,7
1970451,1556027,2025-04-22,Senate,"Do pass, but first be re-referred to the Committee on [Appropriations]",13,0,0,0,13
1970451,1565348,2025-05-05,Senate,"Placed on suspense file",7,0,0,0,7
1970452,1544967,2025-04-09,Senate,"Do pass as amended, but first amend, and re-refer to the Committee on [Appropriations]",9,2,0,0,11
1970452,1559389,2025-04-28,Senate,"Placed on suspense file",7,0,0,0,7
1970453,1561118,2025-04-28,Senate,"Do pass, but first be re-referred to the Committee on [Appropriations] with the recommendation: To Consent Calendar",15,0,0,0,15
1970455,1540984,2025-04-08,Senate,"Do pass as amended, but first amend, and re-refer to the Committee on [Labor, Public Employment and Retirement ]",13,0,0,2,15
1970455,1562945,2025-04-30,Senate,"Do pass, but first be re-referred to the Committee on [Appropriations]",4,1,0,0,5
1970456,1544964,2025-04-09,Senate,"Do pass as amended, but first amend, and re-refer to the Committee on [Judiciary]",11,0,0,0,11
1970456,1562848,2025-04-29,Senate,"Do pass as amended, but first amend, and re-refer to the Committee on [Appropriations]",12,1,0,0,13
1970457,1554568,2025-04-22,Senate,"Do pass as amended, but first amend, and re-refer to the Committee on [Appropriations] with the recommendation: To Consent Calendar",6,0,0,0,6
1970457,1565338,2025-05-05,Senate,"Placed on suspense file",7,0,0,0,7
1970458,1526935,2025-03-25,Senate,"Do pass, but first be re-referred to the Committee on [Governmental Organization]",6,0,0,1,7
1970458,1552912,2025-04-21,Senate,"Placed on suspense file",6,0,0,1,7
1970459,1559396,2025-04-28,Senate,"Do pass, but first be re-referred to the Committee on [Appropriations]",10,0,0,1,11
1970460,1554586,2025-04-21,Senate,"Do pass, but first be re-referred to the Committee on [Rules]",16,0,0,1,17
1970460,1561143,2025-04-28,Senate,"Do pass as amended, but first amend, and re-refer to the Committee on [Appropriations]",15,0,0,0,15
1970461,1552856,2025-04-21,Senate,"Do pass, but first be re-referred to the Committee on [Education]",11,0,0,0,11
1970461,1563105,2025-04-30,Senate,"Do pass as amended, but first amend, and re-refer to the Committee on [Appropriations]",7,0,0,0,7
1970462,1542740,2025-04-09,Senate,"Do pass, but first be re-referred to the Committee on [Appropriations] with the recommendation: To Consent Calendar",7,0,0,0,7
1970462,1552845,2025-04-21,Senate,"Placed on suspense file",6,0,0,1,7
1970463,1542746,2025-04-09,Senate,"Do pass, but first be re-referred to the Committee on [Appropriations] with the recommendation: To Consent Calendar",7,0,0,0,7
1970463,1557548,2025-04-24,Senate,"Consent Calendar 2nd SB374 Archuleta",37,0,0,3,40
1970467,1563018,2025-04-29,Senate,"Do pass as amended, but first amend, and re-refer to the Committee on [Appropriations]",13,0,0,0,13
1970468,1533478,2025-04-01,Senate,"Do pass, but first be re-referred to the Committee on [Appropriations]",6,0,0,0,6
1970468,1552871,2025-04-21,Senate,"Placed on suspense file",6,0,0,1,7
1970469,1526988,2025-03-25,Senate,"Do pass, but first be re-referred to the Committee on [Appropriations]",6,0,0,0,6
1970469,1538877,2025-04-07,Senate,"Placed on suspense file",7,0,0,0,7
1970470,1559494,2025-04-28,Senate,"Senate 3rd Reading SCR24 Alvarado-Gil",39,0,0,1,40
1971689,1533468,2025-04-01,Assembly,"Do pass and be re-referred to the Committee on [Appropriations] with recommendation: To Consent Calendar",17,0,0,1,18
1971690,1556051,2025-04-23,Assembly,"Do pass as amended and be re-referred to the Committee on [Housing and Community Development]",10,0,0,0,10
1971690,1562975,2025-04-30,Assembly,"Do pass and be re-referred to the Committee on [Appropriations]",11,0,0,1,12
1971691,1526977,2025-03-25,Assembly,"Do pass and be re-referred to the Committee on [Appropriations]",5,2,0,0,7
1971692,1561119,2025-04-29,Assembly,"Do pass as amended and be re-referred to the Committee on [Appropriations]",9,0,0,1,10
1971693,1538926,2025-04-07,Assembly,"Do pass and be re-referred to the Committee on [Appropriations] with recommendation: To Consent Calendar",14,0,0,0,14
1971693,1555934,2025-04-23,Assembly,"Do pass. To Consent Calendar",15,0,0,0,15
1971695,1559426,2025-04-28,Assembly,"Do pass and be re-referred to the Committee on [Appropriations]",9,0,0,0,9
1971697,1540814,2025-04-08,Assembly,"Do pass as amended and be re-referred to the Committee on [Health]",15,0,0,3,18
1971698,1534995,2025-04-02,Assembly,"Do pass and be re-referred to the Committee on [Appropriations]",20,0,0,2,22
1971698,1556203,2025-04-23,Assembly,"Do pass",15,0,0,0,15
1971699,1556070,2025-04-22,Assembly,"Do pass as amended and be re-referred to the Committee on [Appropriations]",13,0,0,3,16
1971700,1528245,2025-03-26,Assembly,"Do pass as amended and be re-referred to the Committee on [Local Government]",10,0,0,1,11
1971700,1542842,2025-04-09,Assembly,"Do pass and be re-referred to the Committee on [Appropriations]",10,0,0,0,10
1971701,1556050,2025-04-23,Assembly,"Do pass as amended and be re-referred to the Committee on [Business and Professions]",10,0,0,0,10
1971701,1561038,2025-04-29,Assembly,"Do pass and be re-referred to the Committee on [Appropriations]",17,0,0,1,18
1971702,1521947,2025-03-19,Assembly,"Do pass and be re-referred to the Committee on [Judiciary]",6,0,0,1,7
1971702,1540874,2025-04-08,Assembly,"Do pass and be re-referred to the Committee on [Appropriations]",9,0,0,3,12
1971702,1567920,2025-05-07,Assembly,"Do pass",11,0,0,4,15
1971704,1538935,2025-04-07,Assembly,"Do pass and be re-referred to the Committee on [Natural Resources]",15,0,0,1,16
1971704,1558718,2025-04-21,Assembly,"Do pass and be re-referred to the Committee on [Appropriations] with recommendation: To Consent Calendar",14,0,0,0,14
1971705,1562755,2025-04-30,Assembly,"Do pass and be re-referred to the Committee on [Appropriations]",8,0,0,0,8
1971706,1555921,2025-04-22,Assembly,"Do pass and be re-referred to the Committee on [Appropriations] with recommendation: To Consent Calendar",16,0,0,0,16
1971707,1529524,2025-03-26,Assembly,"Do pass",9,0,0,0,9
1971707,1545011,2025-04-10,Assembly,"AB 677 Bryan Assembly Third Reading",74,0,0,5,79
1971708,1558366,2025-04-24,Assembly,"Do pass and be re-referred to the Committee on [Appropriations]",10,0,0,2,12
1971709,1526884,2025-03-25,Assembly,"Do pass as amended and be re-referred to the Committee on [Appropriations]",10,3,0,0,13
1971709,1542805,2025-04-09,Assembly,"Do pass",10,4,0,1,15
1971709,1565274,2025-05-05,Assembly,"AB 679 Pellerin Assembly Third Reading",57,13,0,9,79
1971710,1526982,2025-03-25,Assembly,"Do pass and be re-referred to the Committee on [Appropriations] with recommendation: To Consent Calendar",7,0,0,0,7
1971711,1522009,2025-03-18,Assembly,"Do pass and be re-referred to the Committee on [Appropriations]",8,2,0,0,10
1971711,1542801,2025-04-09,Assembly,"Do pass",10,4,0,1,15
1971711,1565239,2025-05-05,Assembly,"AB 681 Elhawary Assembly Third Reading",61,10,0,8,79
1971712,1562786,2025-04-29,Assembly,"Do pass and be re-referred to the Committee on [Appropriations] with recommendation: To Consent Calendar",16,0,0,0,16
1971714,1542866,2025-04-08,Assembly,"Do pass and be re-referred to the Committee on [Governmental Organization]",10,0,0,0,10
1971714,1556134,2025-04-23,Assembly,"Do pass and be re-referred to the Committee on [Appropriations]",22,0,0,0,22
1971716,1533535,2025-04-01,Assembly,"Do pass and be re-referred to the Committee on [Appropriations] with recommendation: To Consent Calendar",17,0,0,1,18
1971717,1538992,2025-04-07,Assembly,"Do pass as amended and be re-referred to the Committee on [Appropriations]",10,2,0,2,14
1971718,1526924,2025-03-25,Assembly,"Do pass and be re-referred to the Committee on [Appropriations] with recommendation: To Consent Calendar",15,0,0,0,15
1971719,1526913,2025-03-25,Assembly,"Do pass and be re-referred to the Committee on [Appropriations] with recommendation: To Consent Calendar",7,0,0,0,7
1971720,1526986,2025-03-25,Assembly,"Do pass as amended and be re-referred to the Committee on [Appropriations]",9,0,0,0,9
1971722,1536792,2025-04-02,Assembly,"Do pass and be re-referred to the Committee on [Judiciary]",5,0,0,2,7
1971722,1554633,2025-04-22,Assembly,"Do pass and be re-referred to the Committee on [Appropriations]",7,3,0,2,12
1971723,1542759,2025-04-09,Assembly,"Do pass and be re-referred to the Committee on [Appropriations]",9,1,0,0,10
1971724,1536760,2025-04-02,Assembly,"Do pass and be re-referred to the Committee on [Higher Education] with recommendation: To Consent Calendar",7,0,0,0,7
1971724,1561088,2025-04-29,Assembly,"Do pass and be re-referred to the Committee on [Appropriations]",9,0,0,1,10
1971725,1556064,2025-04-22,Assembly,"Do pass and be re-referred to the Committee on [Appropriations]",7,3,0,0,10
1971726,1528315,2025-03-25,Assembly,"Do pass and be re-referred to the Committee on [Appropriations] with recommendation: To Consent Calendar",7,0,0,0,7
1971727,1562997,2025-04-29,Assembly,"Do pass as amended and be re-referred to the Committee on [Appropriations]",12,0,0,1,13
1971728,1564301,2025-04-30,Assembly,"Do pass as amended",10,0,0,0,10
1971729,1563128,2025-04-30,Assembly,"Do pass as amended and be re-referred to the Committee on [Appropriations]",4,2,0,1,7
1971731,1526919,2025-03-25,Assembly,"Do pass and be re-referred to the Committee on [Appropriations]",8,0,0,1,9
1971733,1542717,2025-04-07,Assembly,"Do pass as amended and be re-referred to the Committee on [Appropriations]",6,0,0,1,7
1971733,1562789,2025-04-30,Assembly,"Do pass",14,0,0,1,15
1971733,1565315,2025-05-05,Assembly,"AB 703 Lee Assembly Third Reading",76,0,0,3,79
1971734,1526910,2025-03-25,Assembly,"Do pass and be re-referred to the Committee on [Appropriations]",7,0,0,2,9
1971735,1556072,2025-04-23,Assembly,"Do pass and be re-referred to the Committee on [Appropriations] with recommendation: To Consent Calendar",18,0,0,0,18
1971736,1558703,2025-04-21,Assembly,"Do pass as amended and be re-referred to the Committee on [Utilities and Energy]",13,0,0,1,14
1971736,1564166,2025-04-30,Assembly,"Do pass and be re-referred to the Committee on [Appropriations]",18,0,0,0,18
1971738,1520443,2025-03-18,Assembly,"Do pass and be re-referred to the Committee on [Judiciary]",9,0,0,0,9
1971738,1526909,2025-03-25,Assembly,"Do pass as amended. To Consent Calendar",12,0,0,0,12
1971738,1536825,2025-04-03,Assembly,"AB 708 Valencia Consent Calendar Second Day Regular Session",74,0,0,5,79
1971739,1562793,2025-04-29,Assembly,"Do pass. To Consent Calendar",13,0,0,0,13
1971739,1568660,2025-05-08,Assembly,"AB 709 Jeff Gonzalez Consent Calendar Second Day Regular Session",69,0,0,10,79
1971741,1526993,2025-03-25,Assembly,"Do pass",12,0,0,0,12
1971742,1542776,2025-04-09,Assembly,"Do pass and be re-referred to the Committee on [Judiciary]",11,0,0,1,12
1971742,1554638,2025-04-22,Assembly,"Do pass and be re-referred to the Committee on [Appropriations]",9,0,0,3,12
1971742,1563028,2025-04-30,Assembly,"Do pass",12,0,0,3,15
1971744,1542753,2025-04-08,Assembly,"Do pass and be re-referred to the Committee on [Business and Professions]",9,0,0,1,10
1971744,1561186,2025-04-29,Assembly,"Do pass and be re-referred to the Committee on [Appropriations]",17,0,0,1,18
1971746,1561132,2025-04-28,Assembly,"Do pass and be re-referred to the Committee on [Utilities and Energy]",7,0,0,0,7
1971746,1564286,2025-04-30,Assembly,"Do pass and be re-referred to the Committee on [Appropriations] with recommendation: To Consent Calendar",18,0,0,0,18
1971747,1540924,2025-04-08,Assembly,"Do pass and be re-referred to the Committee on [Appropriations] with recommendation: To Consent Calendar",13,0,0,0,13
1971748,1555931,2025-04-22,Assembly,"Do pass as amended, and be re-referred to the Committee on [Appropriations] with recommendation: To Consent Calendar",10,0,0,0,10
1971750,1521979,2025-03-19,Assembly,"Do pass and be re-referred to the Committee on [Appropriations] with recommendation: To Consent Calendar",19,0,0,3,22
1971750,1542734,2025-04-09,Assembly,"Do pass. To Consent Calendar",14,0,0,1,15
1971750,1557593,2025-04-24,Assembly,"AB 720 Rogers Consent Calendar Second Day Regular Session",75,0,0,4,79
1971751,1558733,2025-04-21,Assembly,"Do pass as amended and be re-referred to the Committee on [Appropriations]",14,0,0,0,14
1971752,1563064,2025-04-30,Assembly,"Do pass and be re-referred to the Committee on [Appropriations]",9,0,0,3,12
1971753,1535149,2025-04-01,Assembly,"Do pass as amended and be re-referred to the Committee on [Appropriations]",14,0,0,1,15
1971755,1492770,2025-02-18,Assembly,"Be adopted. To third reading",10,0,0,1,11
1971755,1517827,2025-03-13,Senate,"Special Consent ACR33 Zbur et al",36,0,0,4,40
1971756,1498302,2025-02-24,Assembly,"Be adopted. To third reading",11,0,0,0,11
1971760,1556022,2025-04-22,Senate,"Do pass as amended, but first amend, and re-refer to the Committee on [Appropriations]",11,2,0,0,13
1971760,1565295,2025-05-05,Senate,"Placed on suspense file",7,0,0,0,7
1971761,1526996,2025-03-25,Senate,"Do pass, but first be re-referred to the Committee on [Appropriations]",6,0,0,0,6
1971762,1535010,2025-04-02,Senate,"Do pass as amended, but first amend, and re-refer to the Committee on [Appropriations]",11,0,0,0,11
1971763,1538878,2025-04-07,Senate,"Do pass, but first be re-referred to the Committee on [Appropriations]",10,0,0,1,11
1971764,1526965,2025-03-25,Senate,"Do pass, but first be re-referred to the Committee on [Appropriations]",11,2,0,2,15
1971764,1538874,2025-04-07,Senate,"Placed on suspense file",7,0,0,0,7
1971765,1528325,2025-03-26,Senate,"Do pass, but first be re-referred to the Committee on [Business, Professions and Economic Development] with the recommendation: To Consent Calendar",7,0,0,0,7
1971765,1559368,2025-04-28,Senate,"Do pass, but first be re-referred to the Committee on [Appropriations] with the recommendation: To Consent Calendar",11,0,0,0,11
1971766,1567914,2025-05-07,Senate,"Do pass",7,0,0,0,7
1971767,1535059,2025-04-02,Senate,"Do pass as amended, but first amend, and re-refer to the Committee on [Appropriations]",7,0,0,0,7
1971767,1552915,2025-04-21,Senate,"Placed on suspense file",6,0,0,1,7
1971768,1562874,2025-04-30,Senate,"Do pass, but first be re-referred to the Committee on [Appropriations] with the recommendation: To Consent Calendar",7,0,0,0,7
1971770,1521990,2025-03-19,Senate,"Do pass, but first be re-referred to the Committee on [Judiciary]",7,0,0,0,7
1971770,1535061,2025-04-01,Senate,"Do pass, but first be re-referred to the Committee on [Appropriations] with the recommendation: To Consent Calendar",13,0,0,0,13
1971771,1540895,2025-04-08,Senate,"Do pass, but first be re-referred to the Committee on [Appropriations]",15,0,0,0,15
1971772,1540890,2025-04-08,Senate,"Do pass, but first be re-referred to the Committee on [Appropriations]",6,0,0,0,6
1971772,1552897,2025-04-21,Senate,"Placed on suspense file",6,0,0,1,7
1971774,1533489,2025-04-01,Senate,"Do pass, but first be re-referred to the Committee on [Public Safety]",5,0,0,0,5
1971774,1554464,2025-04-22,Senate,"Do pass, but first be re-referred to the Committee on [Appropriations]",6,0,0,0,6
1971774,1565224,2025-05-05,Senate,"Placed on suspense file",7,0,0,0,7
1971775,1521995,2025-03-19,Senate,"Do pass as amended, but first amend, and re-refer to the Committee on [Judiciary]",6,0,0,1,7
1971775,1562949,2025-04-29,Senate,"Do pass, but first be re-referred to the Committee on [Appropriations]",11,1,0,1,13
1971776,1554621,2025-04-22,Senate,"Do pass, but first be re-referred to the Committee on [Appropriations] with the recommendation: To Consent Calendar",15,0,0,0,15
1971776,1568670,2025-05-08,Senate,"Consent Calendar 2nd SB400 Cortese",36,0,0,4,40
1971778,1552851,2025-04-21,Senate,"Do pass",11,0,0,0,11
1971779,1557595,2025-04-23,Senate,"Do pass, but first be re-referred to the Committee on [Judiciary]",9,2,0,0,11
1971779,1563012,2025-04-29,Senate,"Do pass as amended, but first amend, and re-refer to the Committee on [Appropriations]",10,1,0,2,13
1971780,1536811,2025-04-02,Senate,"Do pass, but first be re-referred to the Committee on [Judiciary]",7,0,0,1,8
1971780,1565244,2025-05-05,Senate,"Placed on suspense file",7,0,0,0,7
1971784,1561159,2025-04-29,Senate,"Do pass, but first be re-referred to the Committee on [Appropriations] with the recommendation: To Consent Calendar",5,0,0,0,5
1971785,1567892,2025-05-07,Senate,"Do pass",7,0,0,0,7
1971786,1556185,2025-04-22,Senate,"Do pass, but first be re-referred to the Committee on [Judiciary] with the recommendation: To Consent Calendar",11,0,0,0,11
1971786,1567923,2025-05-06,Senate,"Do pass as amended, and be ordered to the Consent Calendar",12,0,0,1,13
1971787,1535004,2025-04-02,Senate,"Do pass, but first be re-referred to the Committee on [Human Services]",7,0,0,0,7
1971787,1552848,2025-04-21,Senate,"Do pass, but first be re-referred to the Committee on [Appropriations]",5,0,0,0,5
1971787,1565282,2025-05-05,Senate,"Placed on suspense file",7,0,0,0,7
1971788,1552951,2025-04-21,Senate,"Do pass, but first be re-referred to the Committee on [Appropriations] with the recommendation: To Consent Calendar",5,0,0,0,5
1971788,1568635,2025-05-08,Senate,"Consent Calendar 2nd SB412 Limón",36,0,0,4,40
1971789,1542729,2025-04-08,Senate,"Do pass, but first be re-referred to the Committee on [Appropriations] with the recommendation: To Consent Calendar",13,0,0,0,13
1971789,1557586,2025-04-24,Senate,"Consent Calendar 2nd SB413 Allen",37,0,0,3,40
1971790,1556004,2025-04-23,Senate,"Do pass, but first be re-referred to the Committee on [Judiciary]",6,0,0,1,7
1971790,1563019,2025-04-29,Senate,"Do pass as amended, but first amend, and re-refer to the Committee on [Appropriations]",11,0,0,2,13
1971791,1563042,2025-04-30,Senate,"Do pass, but first be re-referred to the Committee on [Appropriations]",7,0,0,0,7
1971792,1555909,2025-04-23,Senate,"Do pass, but first be re-referred to the Committee on [Appropriations] with the recommendation: To Consent Calendar",7,0,0,0,7
1971792,1565304,2025-05-05,Senate,"Placed on suspense file",7,0,0,0,7
1974442,1563010,2025-04-29,Assembly,"Do pass as amended, and be re-referred to the Committee on [Appropriations] with recommendation: To Consent Calendar",16,0,0,0,16
1974443,1528282,2025-03-26,Assembly,"Do pass and be re-referred to the Committee on [Local Government] with recommendation: To Consent Calendar",10,0,0,1,11
1974443,1542718,2025-04-09,Assembly,"Do pass and be re-referred to the Committee on [Appropriations] with recommendation: To Consent Calendar",10,0,0,0,10
1974444,1545033,2025-04-09,Assembly,"Do pass as amended and be re-referred to the Committee on [Appropriations]",7,2,0,0,9
1974445,1561117,2025-04-29,Assembly,"Do pass and be re-referred to the Committee on [Appropriations]",4,2,0,1,7
1974446,1555982,2025-04-23,Assembly,"Do pass and be re-referred to the Committee on [Natural Resources] with recommendation: To Consent Calendar",18,0,0,0,18
1974446,1559472,2025-04-28,Assembly,"Do pass and be re-referred to the Committee on [Appropriations] with recommendation: To Consent Calendar",14,0,0,0,14
1974447,1561125,2025-04-29,Assembly,"Do pass and be re-referred to the Committee on [Appropriations]",9,0,0,1,10
1974448,1542690,2025-04-08,Assembly,"Do pass and be re-referred to the Committee on [Education]",9,0,0,1,10
1974448,1564234,2025-04-30,Assembly,"Do pass as amended, and be re-referred to the Committee on [Appropriations] with recommendation: To Consent Calendar",9,0,0,0,9
1974449,1542835,2025-04-09,Assembly,"Do pass and be re-referred to the Committee on [Judiciary]",8,0,0,0,8
1974449,1554627,2025-04-22,Assembly,"Do pass and be re-referred to the Committee on [Appropriations] with recommendation: To Consent Calendar",12,0,0,0,12
1974449,1563108,2025-04-30,Assembly,"Do pass. To Consent Calendar",14,0,0,1,15
1974449,1568629,2025-05-08,Assembly,"AB 732 Macedo Consent Calendar Second Day Regular Session",69,0,0,10,79
1974451,1562863,2025-04-29,Assembly,"Do pass and be re-referred to the Committee on [Appropriations]",8,3,0,2,13
1974452,1564223,2025-04-30,Assembly,"Do pass and be re-referred to the Committee on [Appropriations]",8,0,0,2,10
1974453,1542813,2025-04-09,Assembly,"Do pass as amended and be re-referred to the Committee on [Appropriations]",10,1,0,1,12
1974454,1534984,2025-04-02,Assembly,"Do pass and be re-referred to the Committee on [Appropriations] with recommendation: To Consent Calendar",18,0,0,0,18
1974454,1562952,2025-04-30,Assembly,"Do pass. To Consent Calendar",14,0,0,1,15
1974454,1568626,2025-05-08,Assembly,"AB 737 Quirk-Silva Consent Calendar Second Day Regular Session",69,0,0,10,79
1974455,1538893,2025-04-07,Assembly,"Do pass as amended and be re-referred to the Committee on [Appropriations]",10,1,0,3,14
1974455,1555913,2025-04-23,Assembly,"Do pass",14,0,0,1,15
1974457,1555951,2025-04-23,Assembly,"Do pass as amended, and be re-referred to the Committee on [Appropriations] with recommendation: To Consent Calendar",18,0,0,0,18
1974458,1526912,2025-03-25,Assembly,"Do pass and be re-referred to the Committee on [Appropriations] with recommendation: To Consent Calendar",9,0,0,0,9
1974458,1542697,2025-04-09,Assembly,"Do pass. To Consent Calendar",14,0,0,1,15
1974458,1557528,2025-04-24,Assembly,"AB 741 Ransom Consent Calendar Second Day Regular Session",75,0,0,4,79
1974459,1540970,2025-04-08,Assembly,"Do pass and be re-referred to the Committee on [Judiciary]",12,2,0,4,18
1974459,1561014,2025-04-29,Assembly,"Do pass and be re-referred to the Committee on [Appropriations]",8,2,0,2,12
1974460,1559482,2025-04-28,Assembly,"Do pass as amended and be re-referred to the Committee on [Appropriations]",9,0,0,0,9
1974461,1535030,2025-04-02,Assembly,"Do pass and be re-referred to the Committee on [Appropriations] with recommendation: To Consent Calendar",21,0,0,1,22
1974461,1562820,2025-04-30,Assembly,"Do pass. To Consent Calendar",14,0,0,1,15
1974461,1568613,2025-05-08,Assembly,"AB 744 Michelle Rodriguez Consent Calendar Second Day Regular Session",69,0,0,10,79
1974462,1564209,2025-04-30,Assembly,"Do pass and be re-referred to the Committee on [Appropriations]",11,4,0,3,18
1974463,1557480,2025-04-23,Assembly,"Do pass and be re-referred to the Committee on [Public Safety]",6,0,0,1,7
1974463,1563106,2025-04-29,Assembly,"Do pass and be re-referred to the Committee on [Appropriations]",8,0,0,1,9
1974464,1540910,2025-04-08,Assembly,"Do pass and be re-referred to the Committee on [Appropriations]",9,0,0,3,12
1974466,1554518,2025-04-22,Assembly,"Do pass and be re-referred to the Committee on [Appropriations]",7,0,0,2,9
1974467,1528269,2025-03-26,Assembly,"Do pass and be re-referred to the Committee on [Judiciary]",10,0,0,1,11
1974467,1540898,2025-04-08,Assembly,"Do pass as amended and be re-referred to the Committee on [Appropriations]",10,0,0,2,12
1974467,1562904,2025-04-30,Assembly,"Do pass",13,0,0,2,15
1974468,1536788,2025-04-02,Assembly,"Do pass and be re-referred to the Committee on [Appropriations] with recommendation: To Consent Calendar",7,0,0,0,7
1974468,1563082,2025-04-30,Assembly,"Do pass. To Consent Calendar",14,0,0,1,15
1974468,1568643,2025-05-08,Assembly,"AB 751 Gipson Consent Calendar Second Day Regular Session",69,0,0,10,79
1974469,1563007,2025-04-29,Assembly,"Do pass",7,0,0,0,7
1974470,1540885,2025-04-08,Assembly,"Do pass as amended and be re-referred to the Committee on [Education]",6,0,0,0,6
1974470,1564257,2025-04-30,Assembly,"Do pass and be re-referred to the Committee on [Appropriations] with recommendation: To Consent Calendar",9,0,0,0,9
1974471,1561116,2025-04-29,Assembly,"Do pass. To Consent Calendar",7,0,0,0,7
1974471,1568661,2025-05-08,Assembly,"AB 754 Connolly Consent Calendar Second Day Regular Session",69,0,0,10,79
1974475,1558714,2025-04-21,Assembly,"Do pass as amended and be re-referred to the Committee on [Emergency Management]",4,2,0,8,14
1974476,1554457,2025-04-22,Assembly,"Do pass as amended and be re-referred to the Committee on [Appropriations]",18,0,0,0,18
1974477,1567925,2025-05-07,Assembly,"Do pass as amended",11,0,0,1,12
1974478,1542795,2025-04-09,Assembly,"Do pass and be re-referred to the Committee on [Revenue and Taxation]",8,2,0,0,10
1974478,1561114,2025-04-28,Assembly,"Do pass as amended",5,2,0,0,7
1974479,1542893,2025-04-08,Assembly,"Do pass and be re-referred to the Committee on [Business and Professions]",4,1,0,2,7
1974481,1526966,2025-03-25,Assembly,"Do pass and be re-referred to the Committee on [Appropriations]",13,0,0,0,13
1974481,1542803,2025-04-09,Assembly,"Do pass",14,0,0,1,15
1974481,1557540,2025-04-24,Assembly,"AB 764 Jeff Gonzalez Assembly Third Reading",73,0,0,6,79
1974482,1536762,2025-04-02,Assembly,"Do pass and be re-referred to the Committee on [Insurance] with recommendation: To Consent Calendar",7,0,0,0,7
1974483,1562970,2025-04-30,Assembly,"Do pass and be re-referred to the Committee on [Appropriations]",15,5,0,2,22
1974485,1562943,2025-04-30,Assembly,"Do pass and be re-referred to the Committee on [Judiciary]",7,2,0,3,12
1974486,1564163,2025-04-30,Assembly,"Do pass as amended",10,0,0,0,10
1974487,1535069,2025-04-02,Assembly,"Do pass and be re-referred to the Committee on [Appropriations]",20,0,0,2,22
1974488,1565300,2025-05-05,Assembly,"Do pass",9,0,0,0,9
1974489,1544953,2025-04-09,Assembly,"Do pass as amended and be re-referred to the Committee on [Appropriations]",9,0,0,0,9
1974490,1561020,2025-04-29,Assembly,"Do pass and be re-referred to the Committee on [Appropriations]",7,0,0,0,7
1974491,1566697,2025-05-06,Assembly,"Do pass. To Consent Calendar",12,0,0,0,12
1974492,1528255,2025-03-26,Assembly,"Do pass as amended and be re-referred to the Committee on [Appropriations]",7,0,0,0,7
1974494,1556204,2025-04-23,Assembly,"Do pass and be re-referred to the Committee on [Human Services] with recommendation: To Consent Calendar",18,0,0,0,18
1974494,1562966,2025-04-29,Assembly,"Do pass as amended, and be re-referred to the Committee on [Appropriations] with recommendation: To Consent Calendar",7,0,0,0,7
1974496,1564278,2025-05-01,Assembly,"Do pass as amended",6,0,0,1,7
1974499,1564226,2025-04-30,Assembly,"Do pass as amended",10,0,0,0,10
1974500,1535151,2025-04-02,Assembly,"Do pass as amended and be re-referred to the Committee on [Emergency Management]",16,3,0,3,22
1974500,1561123,2025-04-28,Assembly,"Do pass as amended and be re-referred to the Committee on [Appropriations]",5,1,0,1,7
1974500,1562960,2025-04-28,Assembly,"Amendments (Committee's)",5,1,0,1,7
1974501,1564215,2025-04-30,Assembly,"Do pass and be re-referred to the Committee on [Appropriations] with recommendation: To Consent Calendar",9,0,0,0,9
1974502,1526899,2025-03-25,Assembly,"Do pass and be re-referred to the Committee on [Health]",8,0,0,1,9
1974502,1556168,2025-04-22,Assembly,"Do pass and be re-referred to the Committee on [Appropriations]",13,0,0,3,16
1974503,1552829,2025-04-21,Assembly,"Do pass. To Consent Calendar",9,0,0,0,9
1974503,1567890,2025-05-07,Assembly,"Do pass. To Consent Calendar",15,0,0,0,15
1974504,1533470,2025-04-01,Assembly,"Do pass as amended and be re-referred to the Committee on [Appropriations]",15,0,0,0,15
1974504,1555927,2025-04-23,Assembly,"Do pass",15,0,0,0,15
1974504,1565329,2025-05-05,Assembly,"AB 787 Papan Assembly Third Reading",77,0,0,2,79
1974505,1535139,2025-04-01,Assembly,"Do pass as amended, and be re-referred to the Committee on [Appropriations] with recommendation: To Consent Calendar",9,0,0,0,9
1974506,1533517,2025-04-01,Assembly,"Do pass",13,0,0,2,15
1974506,1552963,2025-04-21,Assembly,"AB 789 Bonta Assembly Third Reading",59,4,0,16,79
1974507,1563096,2025-04-30,Assembly,"Do pass and be re-referred to the Committee on [Human Services] with recommendation: To Consent Calendar",10,0,0,2,12
1974507,1564290,2025-05-01,Assembly,"Do pass as amended",7,0,0,0,7
1974508,1556015,2025-04-22,Assembly,"Do pass as amended and be re-referred to the Committee on [Appropriations]",10,0,0,0,10
1974509,1535096,2025-04-02,Assembly,"Do pass and be re-referred to the Committee on [Appropriations]",5,0,0,2,7
1974509,1556059,2025-04-23,Assembly,"Do pass",11,1,0,3,15
1974509,1559401,2025-04-28,Assembly,"AB 792 Lee Assembly Third Reading",61,5,0,13,79
1974510,1540956,2025-04-08,Assembly,"Do pass as amended",12,0,0,0,12
1974510,1557534,2025-04-24,Assembly,"AB 793 Schultz Assembly Third Reading",68,0,0,11,79
1974511,1542687,2025-04-08,Assembly,"Do pass as amended and be re-referred to the Committee on [Appropriations]",5,2,0,0,7
1974512,1556056,2025-04-23,Assembly,"Do pass and be re-referred to the Committee on [Appropriations]",22,0,0,0,22
1974513,1556101,2025-04-22,Assembly,"Do pass and be re-referred to the Committee on [Revenue and Taxation]",8,4,0,3,15
1974514,1554630,2025-04-22,Assembly,"Do pass and be re-referred to the Committee on [Appropriations]",7,0,0,1,8
1974515,1563063,2025-04-29,Assembly,"Do pass and be re-referred to the Committee on [Appropriations] with recommendation: To Consent Calendar",7,0,0,0,7
1974516,1526901,2025-03-25,Assembly,"Do pass and be re-referred to the Committee on [Appropriations] with recommendation: To Consent Calendar",9,0,0,0,9
1974516,1556116,2025-04-23,Assembly,"Do pass. To Consent Calendar",15,0,0,0,15
1974516,1564186,2025-05-01,Assembly,"AB 799 Celeste Rodriguez Consent Calendar Second Day Regular Session",76,0,0,3,79
1974517,1527010,2025-03-25,Assembly,"Do pass and be re-referred to the Committee on [Appropriations]",6,1,0,2,9
1974518,1559415,2025-04-28,Assembly,"Do pass as amended and be re-referred to the Committee on [Appropriations]",5,1,0,3,9
1974519,1534988,2025-04-01,Assembly,"Do pass and be re-referred to the Committee on [Appropriations] with recommendation: To Consent Calendar",9,0,0,0,9
1974520,1559427,2025-04-28,Assembly,"Do pass as amended, and be re-referred to the Committee on [Appropriations] with recommendation: To Consent Calendar",14,0,0,0,14
1974521,1540836,2025-04-08,Assembly,"Do pass and be re-referred to the Committee on [Appropriations]",13,1,0,1,15
1974523,1562978,2025-04-30,Assembly,"Do pass and be re-referred to the Committee on [Judiciary]",9,0,0,3,12
1974523,1566701,2025-05-06,Assembly,"Do pass",9,0,0,3,12
1974525,1525462,2025-03-24,Assembly,"Be adopted. To third reading",11,0,0,0,11
1974525,1545012,2025-04-10,Assembly,"ACR 34 Ta Assembly Third Reading",61,2,0,16,79
1974526,1511496,2025-03-10,Assembly,"Be adopted. To third reading",9,0,0,2,11
1974526,1557573,2025-04-24,Senate,"Special Consent ACR35 Papan et al",37,0,0,3,40
1974528,1544942,2025-04-09,Senate,"Do pass, but first be re-referred to the Committee on [Judiciary]",9,0,0,2,11
1974528,1555938,2025-04-22,Senate,"Do pass as amended, but first amend, and re-refer to the Committee on [Appropriations]",11,1,0,1,13
1974530,1542781,2025-04-08,Senate,"Do pass, but first be re-referred to the Committee on [Governmental Organization]",11,1,0,1,13
1974530,1554430,2025-04-22,Senate,"Do pass, but first be re-referred to the Committee on [Appropriations]",10,4,0,1,15
1974530,1565269,2025-05-05,Senate,"Placed on suspense file",7,0,0,0,7
1974531,1533558,2025-04-01,Senate,"Do pass, but first be re-referred to the Committee on [Appropriations]",2,3,0,1,6
1974531,1533559,2025-04-01,Senate,"[First] hearing set for [04-01-2025]: Failed passage in Committee. Reconsideration granted",6,0,0,0,6
1974532,1528283,2025-03-26,Senate,"Do pass, but first be re-referred to the Committee on [Human Services] with the recommendation: To Consent Calendar",5,0,0,0,5
1974532,1552819,2025-04-21,Senate,"Do pass, but first be re-referred to the Committee on [Appropriations] with the recommendation: To Consent Calendar",5,0,0,0,5
1974532,1565259,2025-05-05,Senate,"Placed on suspense file",7,0,0,0,7
1974533,1554452,2025-04-22,Senate,"Do pass, but first be re-referred to the Committee on [Natural Resources and Water]",5,1,0,0,6
1974533,1562889,2025-04-30,Senate,"Do pass as amended, but first amend, and re-refer to the Committee on [Appropriations]",7,0,0,0,7
1974537,1540945,2025-04-08,Senate,"Do pass, but first be re-referred to the Committee on [Appropriations]",6,0,0,1,7
1974537,1552960,2025-04-21,Senate,"Placed on suspense file",6,0,0,1,7
1974538,1526902,2025-03-25,Senate,"Do pass, but first be re-referred to the Committee on [Appropriations] with the recommendation: To Consent Calendar",13,0,0,2,15
1974538,1538962,2025-04-07,Senate,"Placed on suspense file",7,0,0,0,7
1974539,1555995,2025-04-23,Senate,"Do pass, but first be re-referred to the Committee on [Appropriations] with the recommendation: To Consent Calendar",7,0,0,0,7
1974539,1565294,2025-05-05,Senate,"Placed on suspense file",7,0,0,0,7
1974541,1533545,2025-04-01,Senate,"Do pass, but first be re-referred to the Committee on [Appropriations]",6,0,0,0,6
1974541,1552876,2025-04-21,Senate,"Placed on suspense file",6,0,0,1,7
1974542,1533568,2025-04-01,Senate,"Do pass as amended, but first amend, and re-refer to the Committee on [Appropriations]",6,0,0,0,6
1974543,1540824,2025-04-07,Senate,"Do pass, but first be re-referred to the Committee on [Appropriations]",5,0,0,0,5
1974543,1552867,2025-04-21,Senate,"Placed on suspense file",6,0,0,1,7
1974544,1540854,2025-04-07,Senate,"Do pass, but first be re-referred to the Committee on [Judiciary]",4,1,0,0,5
1974544,1556144,2025-04-22,Senate,"Do pass, but first be re-referred to the Committee on [Appropriations]",11,2,0,0,13
1974544,1565296,2025-05-05,Senate,"Placed on suspense file",7,0,0,0,7
1974545,1552898,2025-04-21,Senate,"Do pass as amended, but first amend, and re-refer to the Committee on [Appropriations]",5,0,0,0,5
1974545,1565226,2025-05-05,Senate,"Placed on suspense file",7,0,0,0,7
1974546,1562784,2025-04-29,Senate,"Do pass as amended, but first amend, and re-refer to the Committee on [Appropriations]",10,2,0,1,13
1974547,1528279,2025-03-26,Senate,"Do pass, but first be re-referred to the Committee on [Judiciary]",5,2,0,0,7
1974547,1556153,2025-04-22,Senate,"Do pass, but first be re-referred to the Committee on [Appropriations]",11,2,0,0,13
1974547,1565318,2025-05-05,Senate,"Placed on suspense file",7,0,0,0,7
1974548,1528260,2025-03-26,Senate,"Do pass, but first be re-referred to the Committee on [Appropriations]",7,0,0,0,7
1974548,1538960,2025-04-07,Senate,"Placed on suspense file",7,0,0,0,7
1974549,1545070,2025-04-09,Senate,"Do pass as amended, but first amend, and re-refer to the Committee on [Appropriations] with the recommendation: To Consent Calendar",11,0,0,0,11
1974549,1559462,2025-04-28,Senate,"Placed on suspense file",7,0,0,0,7
1974550,1567878,2025-05-06,Senate,"Do pass and be ordered to the Consent Calendar",12,0,0,1,13
1974551,1556176,2025-04-23,Senate,"Do pass as amended, but first amend, and re-refer to the Committee on [Appropriations]",3,0,0,5,8
1974551,1556177,2025-04-23,Senate,"[First] hearing set for [04-23-2025]: Failed passage in Committee. Reconsideration granted",8,0,0,0,8
1974552,1528311,2025-03-26,Senate,"Do pass as amended, but first amend, and re-refer to the Committee on [Judiciary]",4,1,0,0,5
1974552,1565365,2025-05-05,Senate,"Placed on suspense file",7,0,0,0,7
1974553,1528259,2025-03-26,Senate,"Do pass as amended, but first amend, and re-refer to the Committee on [Appropriations]",5,0,0,0,5
1974554,1540881,2025-04-07,Senate,"Do pass, but first be re-referred to the Committee on [Appropriations]",5,0,0,0,5
1974554,1552938,2025-04-21,Senate,"Placed on suspense file",6,0,0,1,7
1974555,1554523,2025-04-22,Senate,"Do pass, but first be re-referred to the Committee on [Local Government]",13,0,0,2,15
1974556,1534989,2025-04-01,Senate,"Do pass as amended, but first amend, and re-refer to the Committee on [Appropriations]",12,0,0,1,13
1974557,1528275,2025-03-26,Senate,"Do pass, but first be re-referred to the Committee on [Appropriations]",5,0,0,0,5
1974557,1538911,2025-04-07,Senate,"Placed on suspense file",7,0,0,0,7
1974558,1540883,2025-04-08,Senate,"Do pass as amended, but first amend, and re-refer to the Committee on [Judiciary]",6,0,0,0,6
1974558,1562798,2025-04-29,Senate,"Do pass, but first be re-referred to the Committee on [Appropriations]",13,0,0,0,13
1974560,1535047,2025-04-01,Senate,"Do pass, but first be re-referred to the Committee on [Appropriations]",11,0,0,2,13
1974560,1552919,2025-04-21,Senate,"Placed on suspense file",6,0,0,1,7
1974561,1540871,2025-04-08,Senate,"Do pass, but first be re-referred to the Committee on [Public Safety] with the recommendation: To Consent Calendar",15,0,0,0,15
1974561,1552838,2025-04-21,Senate,"Placed on suspense file",6,0,0,1,7
1974562,1540827,2025-04-07,Senate,"Do pass, but first be re-referred to the Committee on [Judiciary]",5,0,0,0,5
1974562,1556029,2025-04-22,Senate,"Do pass, but first be re-referred to the Committee on [Appropriations] with the recommendation: To Consent Calendar",13,0,0,0,13
1974562,1565280,2025-05-05,Senate,"Placed on suspense file",7,0,0,0,7
1976395,1542917,2025-04-09,Assembly,"Do pass as amended, and be re-referred to the Committee on [Appropriations] with recommendation: To Consent Calendar",7,0,0,0,7
1976395,1562805,2025-04-30,Assembly,"Do pass. To Consent Calendar",14,0,0,1,15
1976395,1568619,2025-05-08,Assembly,"AB 808 Addis Consent Calendar Second Day Regular Session",69,0,0,10,79
1976396,1526893,2025-03-25,Assembly,"Do pass as amended, and be re-referred to the Committee on [Appropriations] with recommendation: To Consent Calendar",9,0,0,0,9
1976397,1542870,2025-04-09,Assembly,"Do pass as amended and be re-referred to the Committee on [Privacy and Consumer Protection]",9,1,0,0,10
1976397,1556202,2025-04-22,Assembly,"Do pass and be re-referred to the Committee on [Appropriations]",12,0,0,3,15
1976398,1545055,2025-04-09,Assembly,"Do pass and be re-referred to the Committee on [Appropriations] with recommendation: To Consent Calendar",9,0,0,0,9
1976399,1526925,2025-03-25,Assembly,"Do pass as amended and be re-referred to the Committee on [Appropriations]",8,0,0,1,9
1976402,1556184,2025-04-23,Assembly,"Do pass and be re-referred to the Committee on [Appropriations]",17,0,0,0,17
1976404,1535099,2025-04-02,Assembly,"Do pass and be re-referred to the Committee on [Appropriations] with recommendation: To Consent Calendar",21,0,0,1,22
1976404,1563103,2025-04-30,Assembly,"Do pass. To Consent Calendar",14,0,0,1,15
1976404,1568631,2025-05-08,Assembly,"AB 817 Nguyen Consent Calendar Second Day Regular Session",69,0,0,10,79
1976405,1555985,2025-04-23,Assembly,"Do pass as amended and be re-referred to the Committee on [Housing and Community Development]",10,0,0,0,10
1976405,1562811,2025-04-30,Assembly,"Do pass and be re-referred to the Committee on [Appropriations] with recommendation: To Consent Calendar",10,0,0,2,12
1976408,1545039,2025-04-09,Assembly,"Do pass and be re-referred to the Committee on [Appropriations] with recommendation: To Consent Calendar",9,0,0,0,9
1976409,1540791,2025-04-08,Assembly,"Do pass and be re-referred to the Committee on [Appropriations]",5,0,0,1,6
1976410,1538871,2025-04-07,Assembly,"Do pass as amended and be re-referred to the Committee on [Environmental Safety and Toxic Materials]",10,4,0,0,14
1976410,1561093,2025-04-29,Assembly,"Do pass and be re-referred to the Committee on [Appropriations]",6,0,0,1,7
1976411,1535067,2025-04-01,Assembly,"Do pass and be re-referred to the Committee on [Judiciary] with recommendation: To Consent Calendar",9,0,0,0,9
1976411,1540793,2025-04-08,Assembly,"Do pass and be re-referred to the Committee on [Appropriations] with recommendation: To Consent Calendar",12,0,0,0,12
1976412,1564208,2025-04-30,Assembly,"Do pass and be re-referred to the Committee on [Appropriations]",18,0,0,0,18
1976413,1545030,2025-04-08,Assembly,"Do pass and be re-referred to the Committee on [Judiciary]",8,0,0,0,8
1976414,1563083,2025-04-30,Assembly,"Do pass and be re-referred to the Committee on [Appropriations]",4,0,0,3,7
1976415,1556081,2025-04-23,Assembly,"Do pass as amended and be re-referred to the Committee on [Appropriations]",22,0,0,0,22
1976416,1540833,2025-04-08,Assembly,"Do pass and be re-referred to the Committee on [Revenue and Taxation] with recommendation: To Consent Calendar",15,0,0,0,15
1976416,1561082,2025-04-28,Assembly,"Do pass as amended and be re-referred to the Committee on [Appropriations]",7,0,0,0,7
1976417,1554604,2025-04-21,Assembly,"Do pass and be re-referred to the Committee on [Appropriations] with recommendation: To Consent Calendar",15,0,0,1,16
1976418,1534993,2025-04-02,Assembly,"Do pass and be re-referred to the Committee on [Appropriations] with recommendation: To Consent Calendar",21,0,0,1,22
1976418,1565312,2025-05-05,Assembly,"AB 831 Ramos Assembly Third Reading",77,0,0,2,79
1976420,1529549,2025-03-26,Assembly,"Do pass and be re-referred to the Committee on [Appropriations]",9,0,0,0,9
1976422,1556179,2025-04-22,Assembly,"Do pass and be re-referred to the Committee on [Appropriations]",16,0,0,0,16
1976423,1540864,2025-04-08,Assembly,"Do pass and be re-referred to the Committee on [Appropriations]",15,0,0,0,15
1976424,1526954,2025-03-25,Assembly,"Do pass as amended and be re-referred to the Committee on [Appropriations]",8,0,0,1,9
1976426,1558734,2025-04-21,Assembly,"Do pass and be re-referred to the Committee on [Judiciary]",14,0,0,0,14
1976426,1561025,2025-04-29,Assembly,"Do pass and be re-referred to the Committee on [Appropriations]",11,0,0,1,12
1976428,1540882,2025-04-07,Assembly,"Do pass and be re-referred to the Committee on [Labor and Employment]",7,0,0,0,7
1976428,1557515,2025-04-23,Assembly,"Do pass and be re-referred to the Committee on [Appropriations] with recommendation: To Consent Calendar",7,0,0,0,7
1976430,1526991,2025-03-25,Assembly,"Do pass and be re-referred to the Committee on [Appropriations]",13,0,0,2,15
1976431,1533495,2025-04-01,Assembly,"Do pass and be re-referred to the Committee on [Education]",2,6,0,1,9
1976432,1557498,2025-04-23,Assembly,"Do pass and be re-referred to the Committee on [Appropriations]",7,0,0,0,7
1976433,1540957,2025-04-08,Assembly,"Do pass and be re-referred to the Committee on [Natural Resources]",13,0,0,0,13
1976433,1558722,2025-04-21,Assembly,"Do pass and be re-referred to the Committee on [Appropriations] with recommendation: To Consent Calendar",14,0,0,0,14
1976434,1563118,2025-04-29,Assembly,"Do pass as amended",5,0,0,4,9
1976435,1554528,2025-04-22,Assembly,"Do pass as amended and be re-referred to the Committee on [Appropriations]",9,0,0,0,9
1976436,1562906,2025-04-29,Assembly,"Do pass and be re-referred to the Committee on [Appropriations]",12,1,0,3,16
1976437,1556195,2025-04-22,Assembly,"Do pass and be re-referred to the Committee on [Appropriations]",6,1,0,3,10
1976438,1526914,2025-03-25,Assembly,"Do pass as amended and be re-referred to the Committee on [Appropriations]",12,0,0,0,12
1976440,1556150,2025-04-22,Assembly,"Do pass and be re-referred to the Committee on [Judiciary]",11,1,0,3,15
1976440,1561162,2025-04-29,Assembly,"Do pass and be re-referred to the Committee on [Appropriations]",9,0,0,3,12
1976442,1561146,2025-04-28,Assembly,"Do pass and be re-referred to the Committee on [Appropriations] with recommendation: To Consent Calendar",7,0,0,0,7
1976444,1529534,2025-03-26,Assembly,"Do pass as amended and be re-referred to the Committee on [Appropriations]",7,2,0,0,9
1976445,1557474,2025-04-23,Assembly,"Do pass and be re-referred to the Committee on [Appropriations]",5,1,0,1,7
1976446,1540951,2025-04-08,Assembly,"Do pass. To Consent Calendar",12,0,0,0,12
1976446,1552854,2025-04-21,Assembly,"AB 859 Macedo Consent Calendar Second Day Regular Session",73,0,0,6,79
1976447,1545000,2025-04-09,Assembly,"Do pass as amended and be re-referred to the Committee on [Appropriations]",9,0,0,0,9
1976448,1556112,2025-04-22,Assembly,"Do pass as amended and be re-referred to the Committee on [Transportation]",7,1,0,2,10
1976449,1529546,2025-03-26,Assembly,"Do pass as amended and be re-referred to the Committee on [Appropriations]",7,2,0,0,9
1976450,1566709,2025-05-06,Assembly,"Do pass",8,3,0,1,12
1976451,1561024,2025-04-29,Assembly,"Do pass and be re-referred to the Committee on [Appropriations]",7,0,0,0,7
1976452,1529509,2025-03-26,Assembly,"Do pass as amended and be re-referred to the Committee on [Appropriations]",9,0,0,0,9
1976453,1540969,2025-04-08,Assembly,"Do pass and be re-referred to the Committee on [Banking and Finance]",12,0,0,0,12
1976453,1559471,2025-04-28,Assembly,"Do pass and be re-referred to the Committee on [Appropriations]",9,0,0,0,9
1976454,1533527,2025-04-01,Assembly,"Do pass and be re-referred to the Committee on [Appropriations]",13,0,0,5,18
1976454,1556060,2025-04-23,Assembly,"Do pass",11,0,0,4,15
1976454,1559388,2025-04-28,Assembly,"AB 867 Lee Assembly Third Reading",72,0,0,7,79
1976456,1535068,2025-04-01,Assembly,"Do pass and be re-referred to the Committee on [Appropriations] with recommendation: To Consent Calendar",15,0,0,0,15
1976457,1555933,2025-04-22,Assembly,"Do pass. To Consent Calendar",16,0,0,0,16
1976457,1564212,2025-05-01,Assembly,"AB 870 Hadwick Consent Calendar Second Day",76,0,0,3,79
1976460,1540929,2025-04-08,Assembly,"Do pass as amended and be re-referred to the Committee on [Appropriations]",17,0,0,1,18
1976462,1561140,2025-04-28,Assembly,"Do pass and be re-referred to the Committee on [Appropriations] with recommendation: To Consent Calendar",16,0,0,0,16
1976463,1554484,2025-04-22,Assembly,"Do pass as amended and be re-referred to the Committee on [Appropriations]",15,1,0,2,18
1976463,1567932,2025-05-07,Assembly,"Do pass",14,0,0,1,15
1976465,1526903,2025-03-25,Assembly,"Do pass",9,1,0,2,12
1976466,1554576,2025-04-22,Assembly,"Do pass and be re-referred to the Committee on [Appropriations] with recommendation: To Consent Calendar",9,0,0,0,9
1976466,1562751,2025-04-30,Assembly,"Do pass. To Consent Calendar",14,0,0,1,15
1976466,1568625,2025-05-08,Assembly,"AB 879 Patterson Consent Calendar Second Day Regular Session",69,0,0,10,79
1976467,1535002,2025-04-02,Assembly,"Do pass and be re-referred to the Committee on [Appropriations]",21,0,0,1,22
1976468,1556106,2025-04-23,Assembly,"Do pass and be re-referred to the Committee on [Natural Resources]",17,0,0,1,18
1976468,1559428,2025-04-28,Assembly,"Do pass as amended and be re-referred to the Committee on [Appropriations]",13,0,0,1,14
1976469,1540948,2025-04-08,Assembly,"Do pass as amended and be re-referred to the Committee on [Appropriations]",8,0,0,4,12
1976472,1561040,2025-04-29,Assembly,"Do pass and be re-referred to the Committee on [Appropriations]",10,0,0,0,10
1976473,1562819,2025-04-29,Assembly,"Do pass and be re-referred to the Committee on [Appropriations] with recommendation: To Consent Calendar",16,0,0,0,16
1976474,1529541,2025-03-26,Assembly,"Do pass and be re-referred to the Committee on [Appropriations]",9,0,0,0,9
1976475,1562977,2025-04-30,Assembly,"Do pass and be re-referred to the Committee on [Appropriations]",16,0,0,1,17
1976476,1536805,2025-04-02,Assembly,"Do pass and be re-referred to the Committee on [Appropriations] with recommendation: To Consent Calendar",7,0,0,0,7
1976476,1563022,2025-04-30,Assembly,"Do pass. To Consent Calendar",14,0,0,1,15
1976476,1568630,2025-05-08,Assembly,"AB 889 Hadwick Consent Calendar Second Day Regular Session",69,0,0,10,79
1976477,1540837,2025-04-08,Assembly,"Do pass",6,0,0,0,6
1976477,1552842,2025-04-21,Assembly,"AB 890 Lee Assembly Third Reading",74,0,0,5,79
1976478,1538932,2025-04-07,Assembly,"Do pass and be re-referred to the Committee on [Appropriations]",12,4,0,0,16
1976480,1542826,2025-04-09,Assembly,"Do pass and be re-referred to the Committee on [Local Government]",10,1,0,1,12
1976480,1564247,2025-04-30,Assembly,"Do pass and be re-referred to the Committee on [Appropriations]",9,0,0,1,10
1976481,1556126,2025-04-22,Assembly,"Do pass as amended, and be re-referred to the Committee on [Appropriations] with recommendation: To Consent Calendar",16,0,0,0,16
1976483,1562842,2025-04-29,Assembly,"Do pass and be re-referred to the Committee on [Appropriations] with recommendation: To Consent Calendar",7,0,0,0,7
1976483,1567872,2025-05-07,Assembly,"Do pass. To Consent Calendar",15,0,0,0,15
1976484,1554607,2025-04-22,Assembly,"Do pass and be re-referred to the Committee on [Appropriations]",2,3,0,4,9
1976485,1526963,2025-03-25,Assembly,"Do pass and be re-referred to the Committee on [Appropriations] with recommendation: To Consent Calendar",7,0,0,0,7
1976485,1555965,2025-04-23,Assembly,"Do pass. To Consent Calendar",15,0,0,0,15
1976485,1568672,2025-05-08,Assembly,"AB 898 Bryan Assembly Third Reading",73,0,0,6,79
1976486,1558731,2025-04-21,Assembly,"Do pass and be re-referred to the Committee on [Appropriations]",14,0,0,0,14
1976487,1538964,2025-04-07,Assembly,"Do pass and be re-referred to the Committee on [Appropriations]",14,0,0,0,14
1976489,1554441,2025-04-21,Assembly,"Do pass as amended and be re-referred to the Committee on [Local Government]",11,2,0,3,16
1976490,1529519,2025-03-26,Assembly,"Do pass as amended and be re-referred to the Committee on [Appropriations]",9,0,0,0,9
1976491,1562971,2025-04-29,Assembly,"Do pass and be re-referred to the Committee on [Appropriations]",5,1,0,1,7
1976492,1556189,2025-04-23,Assembly,"Do pass and be re-referred to the Committee on [Appropriations] with recommendation: To Consent Calendar",22,0,0,0,22
1976493,1562941,2025-04-30,Assembly,"Do pass and be re-referred to the Committee on [Local Government]",9,1,0,2,12
1976493,1564291,2025-04-30,Assembly,"Do pass and be re-referred to the Committee on [Appropriations]",8,0,0,2,10
1976494,1538919,2025-04-07,Assembly,"Do pass and be re-referred to the Committee on [Appropriations] with recommendation: To Consent Calendar",14,0,0,0,14
1976495,1544991,2025-04-09,Assembly,"Do pass as amended and be re-referred to the Committee on [Appropriations]",7,2,0,0,9
1976497,1556053,2025-04-22,Assembly,"Do pass and be re-referred to the Committee on [Appropriations]",13,0,0,3,16
1976498,1561172,2025-04-28,Assembly,"Do pass and be re-referred to the Committee on [Appropriations]",14,0,0,2,16
1976499,1555907,2025-04-23,Assembly,"Do pass and be re-referred to the Committee on [Appropriations] with recommendation: To Consent Calendar",7,0,0,0,7
1976500,1562972,2025-04-30,Assembly,"Do pass and be re-referred to the Committee on [Appropriations]",9,0,0,3,12
1976501,1559376,2025-04-28,Assembly,"Do pass and be re-referred to the Committee on [Appropriations]",10,4,0,0,14
1976502,1564265,2025-04-30,Assembly,"Do pass and be re-referred to the Committee on [Appropriations] with recommendation: To Consent Calendar",18,0,0,0,18
1976503,1528313,2025-03-25,Assembly,"Do pass and be re-referred to the Committee on [Health]",5,2,0,0,7
1976504,1529511,2025-03-26,Assembly,"Do pass",6,2,0,1,9
1976506,1542750,2025-04-09,Assembly,"Do pass and be re-referred to the Committee on [Appropriations]",7,0,0,0,7
1976507,1556174,2025-04-23,Assembly,"Do pass as amended and be re-referred to the Committee on [Housing and Community Development]",10,0,0,0,10
1976507,1562799,2025-04-30,Assembly,"Do pass and be re-referred to the Committee on [Appropriations] with recommendation: To Consent Calendar",10,0,0,2,12
1976509,1542885,2025-04-08,Assembly,"Do pass and be re-referred to the Committee on [Public Safety]",10,0,0,0,10
1976509,1563049,2025-04-29,Assembly,"Do pass as amended and be re-referred to the Committee on [Appropriations]",9,0,0,0,9
1976510,1542859,2025-04-08,Assembly,"Do pass and be re-referred to the Committee on [Appropriations]",6,0,0,3,9
1976512,1542884,2025-04-09,Assembly,"Do pass and be re-referred to the Committee on [Appropriations]",8,2,0,2,12
1976513,1526908,2025-03-25,Assembly,"Do pass and be re-referred to the Committee on [Human Services]",9,0,0,3,12
1976513,1540863,2025-04-08,Assembly,"Do pass and be re-referred to the Committee on [Appropriations]",6,0,0,0,6
1976514,1529526,2025-03-26,Assembly,"Do pass as amended, and be re-referred to the Committee on [Appropriations] with recommendation: To Consent Calendar",9,0,0,0,9
1976514,1556099,2025-04-23,Assembly,"Do pass. To Consent Calendar",15,0,0,0,15
1976514,1564193,2025-05-01,Assembly,"AB 927 Sharp-Collins Consent Calendar Second Day Regular Session",76,0,0,3,79
1976515,1528257,2025-03-26,Assembly,"Do pass and be re-referred to the Committee on [Judiciary]",6,1,0,1,8
1976515,1540892,2025-04-08,Assembly,"Do pass as amended and be re-referred to the Committee on [Appropriations]",10,1,0,1,12
1976516,1562888,2025-04-29,Assembly,"Do pass as amended and be re-referred to the Committee on [Appropriations]",9,3,0,1,13
1976517,1562757,2025-04-30,Assembly,"Do pass as amended and be re-referred to the Committee on [Appropriations]",5,2,0,0,7
1976518,1540813,2025-04-08,Assembly,"Do pass as amended",12,0,0,0,12
1976518,1552945,2025-04-21,Assembly,"AB 931 Kalra Assembly Third Reading",59,0,0,20,79
1976519,1540790,2025-04-08,Assembly,"Do pass as amended and be re-referred to the Committee on [Judiciary]",6,0,0,3,9
1976519,1561124,2025-04-29,Assembly,"Do pass and be re-referred to the Committee on [Appropriations]",11,0,0,1,12
1976521,1555955,2025-04-22,Assembly,"Do pass and be re-referred to the Committee on [Appropriations] with recommendation: To Consent Calendar",10,0,0,0,10
1976522,1540947,2025-04-08,Assembly,"Do pass and be re-referred to the Committee on [Education]",9,1,0,2,12
1976522,1564179,2025-04-30,Assembly,"Do pass as amended and be re-referred to the Committee on [Appropriations]",7,0,0,2,9
1976523,1526892,2025-03-25,Assembly,"Do pass and be re-referred to the Committee on [Appropriations] with recommendation: To Consent Calendar",7,0,0,0,7
1976524,1528265,2025-03-26,Assembly,"Do pass and be re-referred to the Committee on [Appropriations]",8,0,0,0,8
1976525,1526916,2025-03-25,Assembly,"Do pass as amended and be re-referred to the Committee on [Appropriations]",7,1,0,1,9
1976527,1554480,2025-04-22,Assembly,"Do pass and be re-referred to the Committee on [Appropriations]",8,0,0,0,8
1976528,1535038,2025-04-02,Assembly,"Do pass and be re-referred to the Committee on [Natural Resources]",17,0,0,1,18
1976528,1558706,2025-04-21,Assembly,"Do pass as amended and be re-referred to the Committee on [Appropriations]",14,0,0,0,14
1976529,1564250,2025-04-30,Assembly,"Do pass as amended and be re-referred to the Committee on [Appropriations]",10,5,0,3,18
1976530,1534987,2025-04-02,Assembly,"Do pass as amended and be re-referred to the Committee on [Appropriations]",17,0,0,0,17
1976530,1562882,2025-04-30,Assembly,"Do pass",14,0,0,1,15
1976531,1561128,2025-04-28,Assembly,"Do pass and be re-referred to the Committee on [Appropriations] with recommendation: To Consent Calendar",7,0,0,0,7
1976533,1519114,2025-03-17,Assembly,"Be adopted. To Consent Calendar",10,0,0,1,11
1976533,1523625,2025-03-20,Assembly,"HR 15 Aguiar-Curry Consent Calendar Second Day Regular Session",67,0,0,13,80
1976534,1559416,2025-04-28,Assembly,"Be adopted. To third reading",9,0,0,2,11
1976535,1563001,2025-04-29,Senate,"Do pass as amended, but first amend, and re-refer to the Committee on [Appropriations]",16,0,0,1,17
1976536,1536815,2025-04-02,Senate,"Do pass as amended, but first amend, and re-refer to the Committee on [Appropriations] with the recommendation: To Consent Calendar",8,0,0,0,8
1976536,1552863,2025-04-21,Senate,"Placed on suspense file",6,0,0,1,7
1976537,1561133,2025-04-28,Senate,"Do pass, but first be re-referred to the Committee on [Appropriations]",15,0,0,0,15
1976538,1538929,2025-04-07,Senate,"Do pass, but first be re-referred to the Committee on [Appropriations]",10,0,0,1,11
1976539,1562981,2025-04-29,Senate,"Do pass",1,2,0,8,11
1976539,1562982,2025-04-29,Senate,"[First] hearing set for [04-30-2025]: Failed passage in Committee. Reconsideration granted",11,0,0,0,11
1976540,1533575,2025-04-01,Senate,"Do pass as amended, but first amend, and re-refer to the Committee on [Appropriations]",5,0,0,0,5
1976540,1552916,2025-04-21,Senate,"Placed on suspense file",6,0,0,1,7
1976541,1533549,2025-04-01,Senate,"Do pass, but first be re-referred to the Committee on [Judiciary] with the recommendation: To Consent Calendar",6,0,0,0,6
1976541,1567922,2025-05-06,Senate,"Do pass as amended, and be ordered to the Consent Calendar",12,0,0,1,13
1976543,1540828,2025-04-08,Senate,"Do pass, but first be re-referred to the Committee on [Local Government] with the recommendation: To Consent Calendar",15,0,0,0,15
1976543,1552830,2025-04-21,Senate,"Placed on suspense file",6,0,0,1,7
1976544,1540849,2025-04-08,Senate,"Do pass, but first be re-referred to the Committee on [Appropriations]",6,0,0,1,7
1976544,1552818,2025-04-21,Senate,"Placed on suspense file",6,0,0,1,7
1976545,1540795,2025-04-08,Senate,"Do pass as amended, but first amend, and re-refer to the Committee on [Local Government] with the recommendation: To Consent Calendar",6,0,0,1,7
1976545,1565238,2025-05-05,Senate,"Placed on suspense file",7,0,0,0,7
1976546,1556093,2025-04-23,Senate,"Do pass, but first be re-referred to the Committee on [Judiciary]",4,1,0,0,5
1976546,1563068,2025-04-29,Senate,"Do pass as amended, but first amend, and re-refer to the Committee on [Appropriations]",11,0,0,2,13
1976547,1554612,2025-04-22,Senate,"Do pass, but first be re-referred to the Committee on [Appropriations]",14,0,0,1,15
1976547,1565275,2025-05-05,Senate,"Placed on suspense file",7,0,0,0,7
1976548,1556164,2025-04-23,Senate,"Do pass, but first be re-referred to the Committee on [Judiciary] with the recommendation: To Consent Calendar",8,0,0,0,8
1976548,1562833,2025-04-29,Senate,"Do pass as amended, but first amend, and re-refer to the Committee on [Appropriations]",13,0,0,0,13
1976549,1526961,2025-03-25,Senate,"Do pass as amended, but first amend, and re-refer to the Committee on [Appropriations]",11,3,0,1,15
1976549,1538875,2025-04-07,Senate,"Placed on suspense file",7,0,0,0,7
1976550,1555963,2025-04-22,Senate,"Do pass, but first be re-referred to the Committee on [Appropriations]",11,0,0,2,13
1976550,1565241,2025-05-05,Senate,"Placed on suspense file",7,0,0,0,7
1976551,1562923,2025-04-30,Senate,"Do pass, but first be re-referred to the Committee on [Appropriations]",4,1,0,0,5
1976552,1526995,2025-03-25,Senate,"Do pass, but first be re-referred to the Committee on [Judiciary]",9,1,0,5,15
1976552,1542910,2025-04-08,Senate,"Do pass as amended, but first amend, and re-refer to the Committee on [Appropriations]",10,1,0,2,13
1976553,1540954,2025-04-07,Senate,"Do pass, but first be re-referred to the Committee on [Judiciary] with the recommendation: To Consent Calendar",5,0,0,0,5
1976553,1555904,2025-04-22,Senate,"Do pass, but first be re-referred to the Committee on [Appropriations] with the recommendation: To Consent Calendar",13,0,0,0,13
1976553,1565261,2025-05-05,Senate,"Placed on suspense file",7,0,0,0,7
1976554,1563026,2025-04-30,Senate,"Do pass as amended, but first amend, and re-refer to the Committee on [Appropriations]",7,0,0,0,7
1976555,1538986,2025-04-07,Senate,"Do pass as amended, but first amend, and re-refer to the Committee on [Appropriations]",15,0,0,2,17
1976555,1565368,2025-05-05,Senate,"Placed on suspense file",7,0,0,0,7
1976556,1563122,2025-04-30,Senate,"Do pass, but first be re-referred to the Committee on [Appropriations]",3,5,0,0,8
1976556,1563123,2025-04-30,Senate,"[First] hearing set for [04-30-2025]: Failed passage in Committee. Reconsideration granted",8,0,0,0,8
1976559,1556057,2025-04-22,Senate,"Do pass, but first be re-referred to the Committee on [Appropriations]",11,2,0,0,13
1976559,1565297,2025-05-05,Senate,"Placed on suspense file",7,0,0,0,7
1976560,1542873,2025-04-09,Senate,"Do pass, but first be re-referred to the Committee on [Appropriations] with the recommendation: To Consent Calendar",7,0,0,0,7
1976560,1552837,2025-04-21,Senate,"Placed on suspense file",6,0,0,1,7
1976562,1526894,2025-03-25,Senate,"Do pass, but first be re-referred to the Committee on [Appropriations]",14,0,0,1,15
1976564,1556039,2025-04-23,Senate,"Do pass, but first be re-referred to the Committee on [Elections and Constitutional Amendments] with the recommendation: To Consent Calendar",7,0,0,0,7
1976564,1561029,2025-04-29,Senate,"Do pass, but first be re-referred to the Committee on [Appropriations] with the recommendation: To Consent Calendar",5,0,0,0,5
1976565,1526948,2025-03-25,Senate,"Do pass, but first be re-referred to the Committee on [Appropriations]",6,0,0,0,6
1976565,1538917,2025-04-07,Senate,"Placed on suspense file",7,0,0,0,7
1976566,1540859,2025-04-08,Senate,"Do pass, but first be re-referred to the Committee on [Housing]",6,0,0,1,7
1976566,1562840,2025-04-29,Senate,"Do pass as amended, but first amend, and re-refer to the Committee on [Appropriations]",11,0,0,0,11
1976567,1536800,2025-04-02,Senate,"Do pass as amended, but first amend, and re-refer to the Committee on [Public Safety] with the recommendation: To Consent Calendar",7,0,0,0,7
1976567,1554506,2025-04-22,Senate,"Do pass, but first be re-referred to the Committee on [Appropriations] with the recommendation: To Consent Calendar",6,0,0,0,6
1976567,1568678,2025-05-08,Senate,"Consent Calendar 2nd SB485 Reyes",36,0,0,4,40
1976568,1533502,2025-04-01,Senate,"Do pass as amended, but first amend, and re-refer to the Committee on [Environmental Quality]",11,0,0,0,11
1976568,1562873,2025-04-30,Senate,"Do pass, but first be re-referred to the Committee on [Appropriations]",8,0,0,0,8
1976569,1562804,2025-04-30,Senate,"Do pass, but first be re-referred to the Committee on [Appropriations]",5,0,0,0,5
1976571,1556155,2025-04-23,Senate,"Do pass, but first be re-referred to the Committee on [Housing]",6,1,0,0,7
1976571,1562803,2025-04-29,Senate,"Do pass, but first be re-referred to the Committee on [Appropriations]",11,0,0,0,11
1976573,1525461,2025-03-24,Senate,"Do pass, but first be re-referred to the Committee on [Appropriations]",16,0,0,1,17
1976575,1561096,2025-04-29,Senate,"Do pass, but first be re-referred to the Committee on [Appropriations]",4,0,0,1,5
1976576,1528289,2025-03-26,Senate,"Do pass, but first be re-referred to the Committee on [Education]",4,1,0,0,5
1976576,1555988,2025-04-23,Senate,"Do pass, but first be re-referred to the Committee on [Appropriations]",5,2,0,0,7
1976576,1565327,2025-05-05,Senate,"Placed on suspense file",7,0,0,0,7
1976577,1556105,2025-04-23,Senate,"Do pass, but first be re-referred to the Committee on [Judiciary]",5,2,0,0,7
1976577,1563109,2025-04-29,Senate,"Do pass, but first be re-referred to the Committee on [Appropriations]",11,2,0,0,13
1976578,1536859,2025-04-02,Senate,"Do pass as amended, but first amend, and re-refer to the Committee on [Transportation]",8,0,0,0,8
1976578,1554544,2025-04-22,Senate,"Do pass, but first be re-referred to the Committee on [Appropriations]",15,0,0,0,15
1976578,1565361,2025-05-05,Senate,"Placed on suspense file",7,0,0,0,7
1976579,1542768,2025-04-08,Senate,"Do pass, but first be re-referred to the Committee on [Public Safety]",11,2,0,0,13
1976579,1562808,2025-04-29,Senate,"Do pass, but first be re-referred to the Committee on [Appropriations]",5,1,0,0,6
1976580,1526981,2025-03-25,Senate,"Do pass, but first be re-referred to the Committee on [Appropriations]",5,0,0,1,6
1976580,1538872,2025-04-07,Senate,"Placed on suspense file",7,0,0,0,7
1976581,1567894,2025-05-07,Senate,"Do pass as amended",6,1,0,0,7
1976582,1563024,2025-04-29,Senate,"Do pass as amended, but first amend, and re-refer to the Committee on [Appropriations]",13,3,0,1,17
1976583,1536758,2025-04-02,Senate,"Do pass as amended, but first amend, and re-refer to the Committee on [Judiciary]",6,0,0,2,8
1976583,1555946,2025-04-22,Senate,"Do pass, but first be re-referred to the Committee on [Appropriations]",11,0,0,2,13
1976583,1565235,2025-05-05,Senate,"Placed on suspense file",7,0,0,0,7
1976584,1555911,2025-04-22,Senate,"Do pass as amended, but first amend, and re-refer to the Committee on [Education]",9,1,0,1,11
1976585,1545037,2025-04-09,Senate,"Do pass as amended, but first amend, and re-refer to the Committee on [Governmental Organization]",10,0,0,1,11
1976585,1562901,2025-04-29,Senate,"Do pass, but first be re-referred to the Committee on [Appropriations]",13,0,0,0,13
1976586,1528281,2025-03-26,Senate,"Do pass as amended, but first amend, and re-refer to the Committee on [Judiciary] with the recommendation: To Consent Calendar",10,0,0,1,11
1976586,1556045,2025-04-22,Senate,"Do pass as amended, but first amend, and re-refer to the Committee on [Appropriations] with the recommendation: To Consent Calendar",13,0,0,0,13
1976586,1568616,2025-05-08,Senate,"Consent Calendar 2nd SB504 Laird et al",36,0,0,4,40
1976588,1542844,2025-04-08,Senate,"Do pass, but first be re-referred to the Committee on [Appropriations] with the recommendation: To Consent Calendar",15,0,0,0,15
1976588,1557494,2025-04-24,Senate,"Consent Calendar 2nd SB506 TRANS. (Cortese)",37,0,0,3,40
1976589,1563102,2025-04-29,Senate,"Do pass as amended, but first amend, and re-refer to the Committee on [Appropriations]",11,0,0,0,11
1976590,1538994,2025-04-07,Senate,"Do pass, but first be re-referred to the Committee on [Appropriations]",10,0,0,1,11
1976591,1533518,2025-04-01,Senate,"Do pass, but first be re-referred to the Committee on [Governmental Organization]",6,0,0,0,6
1976591,1540963,2025-04-08,Senate,"Do pass, but first be re-referred to the Committee on [Appropriations]",15,0,0,0,15
1976591,1552902,2025-04-21,Senate,"Placed on suspense file",6,0,0,1,7
1976592,1562834,2025-04-30,Senate,"Do pass, but first be re-referred to the Committee on [Appropriations]",7,0,0,0,7
1976594,1526897,2025-03-25,Senate,"Do pass, but first be re-referred to the Committee on [Appropriations] with the recommendation: To Consent Calendar",13,0,0,2,15
1976594,1545024,2025-04-10,Senate,"Consent Calendar 2nd SB512 McGuire",35,0,0,5,40
1976595,1528247,2025-03-26,Senate,"Do pass, but first be re-referred to the Committee on [Appropriations]",4,1,0,0,5
1976596,1540936,2025-04-08,Senate,"Do pass as amended, but first amend, and re-refer to the Committee on [Appropriations] with the recommendation: To Consent Calendar",6,0,0,1,7
1976596,1559501,2025-04-28,Senate,"Placed on suspense file",7,0,0,0,7
1976597,1536776,2025-04-02,Senate,"Do pass as amended, but first amend, and re-refer to the Committee on [Appropriations]",5,2,0,0,7
1976597,1552900,2025-04-21,Senate,"Placed on suspense file",6,0,0,1,7
1976598,1567881,2025-05-07,Senate,"Do pass",6,0,0,1,7
1976599,1552817,2025-04-21,Senate,"Do pass, but first be re-referred to the Committee on [Judiciary]",11,0,0,0,11
1976599,1562831,2025-04-29,Senate,"Do pass as amended, but first amend, and re-refer to the Committee on [Appropriations] with the recommendation: To Consent Calendar",13,0,0,0,13
1976600,1556089,2025-04-22,Senate,"Do pass as amended, but first amend, and re-refer to the Committee on [Appropriations]",11,2,0,0,13
1976600,1565256,2025-05-05,Senate,"Placed on suspense file",7,0,0,0,7
1976601,1559365,2025-04-28,Senate,"Do pass, but first be re-referred to the Committee on [Appropriations] with the recommendation: To Consent Calendar",4,0,0,1,5
1976602,1564165,2025-04-30,Senate,"Do pass, but first be re-referred to the Committee on [Appropriations] with the recommendation: To Consent Calendar",11,0,0,0,11
1976603,1556166,2025-04-23,Senate,"Do pass as amended, but first amend, and re-refer to the Committee on [Appropriations] with the recommendation: To Consent Calendar",5,0,0,0,5
1976603,1568597,2025-05-08,Senate,"Consent Calendar 2nd SB521 Gonzalez",36,0,0,4,40
1976604,1542696,2025-04-08,Senate,"Do pass, but first be re-referred to the Committee on [Local Government]",10,2,0,1,13
1976606,1525417,2025-03-24,Senate,"Be adopted as amended",16,0,0,1,17
1976606,1538979,2025-04-07,Senate,"Senate 3rd Reading SCR25 Blakespear et al",36,0,0,4,40
1976607,1501955,2025-02-27,Senate,"Senate 3rd Reading SR17 Rubio et al",36,0,0,3,39
1976608,1501952,2025-02-27,Senate,"Senate 3rd Reading SR18 Richardson",36,0,0,3,39
1978537,1554521,2025-04-22,Assembly,"Do pass and be re-referred to the Committee on [Judiciary]",17,0,0,1,18
1978537,1561050,2025-04-29,Assembly,"Do pass and be re-referred to the Committee on [Appropriations]",10,0,0,2,12
1978538,1540950,2025-04-08,Assembly,"Do pass and be re-referred to the Committee on [Emergency Management] with recommendation: To Consent Calendar",15,0,0,0,15
1978538,1561063,2025-04-28,Assembly,"Do pass and be re-referred to the Committee on [Appropriations] with recommendation: To Consent Calendar",7,0,0,0,7
1978539,1540967,2025-04-08,Assembly,"Do pass as amended, and be re-referred to the Committee on [Appropriations] with recommendation: To Consent Calendar",12,0,0,0,12
1978539,1555972,2025-04-23,Assembly,"Do pass. To Consent Calendar",15,0,0,0,15
1978539,1564285,2025-05-01,Assembly,"AB 1004 Wallis Consent Calendar Second Day Regular Session",76,0,0,3,79
1978540,1545020,2025-04-09,Assembly,"Do pass as amended and be re-referred to the Committee on [Appropriations]",9,0,0,0,9
1978541,1542850,2025-04-08,Assembly,"Do pass as amended and be re-referred to the Committee on [Appropriations]",9,0,0,0,9
1978542,1542711,2025-04-09,Assembly,"Do pass and be re-referred to the Committee on [Housing and Community Development]",10,0,0,0,10
1978542,1563003,2025-04-30,Assembly,"Do pass and be re-referred to the Committee on [Appropriations] with recommendation: To Consent Calendar",10,0,0,2,12
1978543,1556012,2025-04-23,Assembly,"Do pass and be re-referred to the Committee on [Appropriations]",21,0,0,1,22
1978543,1567851,2025-05-07,Assembly,"Do pass",15,0,0,0,15
1978544,1545018,2025-04-09,Assembly,"Do pass and be re-referred to the Committee on [Appropriations] with recommendation: To Consent Calendar",9,0,0,0,9
1978544,1563099,2025-04-30,Assembly,"Do pass. To Consent Calendar",14,0,0,1,15
1978544,1568646,2025-05-08,Assembly,"AB 1009 Blanca Rubio Consent Calendar Second Day Regular Session",69,0,0,10,79
1978546,1542786,2025-04-08,Assembly,"Do pass as amended and be re-referred to the Committee on [Appropriations]",9,0,0,0,9
1978548,1535107,2025-04-01,Assembly,"Do pass and be re-referred to the Committee on [Appropriations] with recommendation: To Consent Calendar",9,0,0,0,9
1978549,1554597,2025-04-21,Assembly,"Do pass and be re-referred to the Committee on [Appropriations]",14,1,0,1,16
1978551,1555937,2025-04-23,Assembly,"Do pass and be re-referred to the Committee on [Natural Resources]",15,0,0,3,18
1978551,1564294,2025-05-01,Assembly,"Do pass as amended and be re-referred to the Committee on [Appropriations]",14,0,0,0,14
1978552,1556123,2025-04-23,Assembly,"Do pass and be re-referred to the Committee on [Appropriations] with recommendation: To Consent Calendar",18,0,0,0,18
1978553,1556161,2025-04-22,Assembly,"Do pass and be re-referred to the Committee on [Judiciary]",9,3,0,3,15
1978553,1561043,2025-04-29,Assembly,"Do pass as amended and be re-referred to the Committee on [Appropriations]",8,3,0,1,12
1978555,1556074,2025-04-23,Assembly,"Do pass and be re-referred to the Committee on [Appropriations]",15,2,0,1,18
1978556,1542829,2025-04-09,Assembly,"Do pass and be re-referred to the Committee on [Local Government]",8,1,0,3,12
1978556,1564203,2025-04-30,Assembly,"Do pass as amended and be re-referred to the Committee on [Appropriations]",9,0,0,1,10
1978557,1554491,2025-04-21,Assembly,"Do pass and be re-referred to the Committee on [Appropriations]",10,3,0,3,16
1978559,1540812,2025-04-08,Assembly,"Do pass and be re-referred to the Committee on [Appropriations]",13,0,0,0,13
1978560,1561080,2025-04-29,Assembly,"Do pass as amended and be re-referred to the Committee on [Appropriations]",11,0,0,1,12
1978561,1542692,2025-04-09,Assembly,"Do pass and be re-referred to the Committee on [Utilities and Energy]",11,0,0,1,12
1978561,1567858,2025-05-07,Assembly,"Do pass as amended",15,0,0,3,18
1978562,1561174,2025-04-29,Assembly,"Do pass and be re-referred to the Committee on [Appropriations]",17,0,0,1,18
1978563,1561091,2025-04-29,Assembly,"Do pass and be re-referred to the Committee on [Appropriations]",7,2,0,1,10
1978564,1542752,2025-04-09,Assembly,"Do pass and be re-referred to the Committee on [Appropriations] with recommendation: To Consent Calendar",7,0,0,0,7
1978564,1563047,2025-04-30,Assembly,"Do pass. To Consent Calendar",14,0,0,1,15
1978564,1568663,2025-05-08,Assembly,"AB 1029 Valencia Consent Calendar Second Day Regular Session",69,0,0,10,79
1978565,1528295,2025-03-26,Assembly,"Do pass. To Consent Calendar",8,0,0,2,10
1978565,1533548,2025-04-01,Assembly,"AB 1030 Papan Consent Calendar Second Day Regular Session",76,0,0,4,80
1978566,1561039,2025-04-29,Assembly,"Do pass and be re-referred to the Committee on [Appropriations]",6,0,0,1,7
1978567,1562853,2025-04-29,Assembly,"Do pass as amended and be re-referred to the Committee on [Appropriations]",16,0,0,0,16
1978568,1554476,2025-04-22,Assembly,"Do pass and be re-referred to the Committee on [Appropriations] with recommendation: To Consent Calendar",12,0,0,0,12
1978569,1564183,2025-04-30,Assembly,"Do pass and be re-referred to the Committee on [Appropriations] with recommendation: To Consent Calendar",9,0,0,0,9
1978570,1542713,2025-04-08,Assembly,"Do pass and be re-referred to the Committee on [Appropriations]",8,2,0,0,10
1978571,1535123,2025-04-01,Assembly,"Do pass and be re-referred to the Committee on [Appropriations]",7,0,0,2,9
1978572,1540932,2025-04-08,Assembly,"Do pass as amended and be re-referred to the Committee on [Judiciary]",11,3,0,1,15
1978572,1561042,2025-04-29,Assembly,"Do pass and be re-referred to the Committee on [Appropriations]",8,3,0,1,12
1978573,1562822,2025-04-29,Assembly,"Do pass and be re-referred to the Committee on [Appropriations]",6,4,0,3,13
1978573,1562823,2025-04-29,Assembly,Reconsideration,11,0,0,2,13
1978574,1556087,2025-04-23,Assembly,"Do pass and be re-referred to the Committee on [Appropriations]",22,0,0,0,22
1978576,1533474,2025-04-01,Assembly,"Do pass as amended and be re-referred to the Committee on [Appropriations]",12,0,0,3,15
1978577,1542703,2025-04-09,Assembly,"Do pass and be re-referred to the Committee on [Appropriations]",8,0,0,0,8
1978578,1556028,2025-04-22,Assembly,"Do pass and be re-referred to the Committee on [Judiciary]",13,0,0,2,15
1978578,1561121,2025-04-29,Assembly,"Do pass and be re-referred to the Committee on [Appropriations]",12,0,0,0,12
1978579,1540925,2025-04-08,Assembly,"Do pass and be re-referred to the Committee on [Local Government]",13,0,0,0,13
1978579,1564279,2025-04-30,Assembly,"Do pass and be re-referred to the Committee on [Appropriations]",10,0,0,0,10
1978580,1561077,2025-04-29,Assembly,"Do pass and be re-referred to the Committee on [Appropriations]",7,2,0,1,10
1978581,1538876,2025-04-07,Assembly,"Do pass as amended",14,0,0,0,14
1978583,1556071,2025-04-23,Assembly,"Do pass and be re-referred to the Committee on [Appropriations]",17,0,0,0,17
1978584,1540931,2025-04-08,Assembly,"Do pass and be re-referred to the Committee on [Appropriations]",5,1,0,0,6
1978585,1527001,2025-03-25,Assembly,"Do pass as amended and be re-referred to the Committee on [Appropriations]",9,1,0,2,12
1978586,1561148,2025-04-28,Assembly,"Do pass and be re-referred to the Committee on [Appropriations] with recommendation: To Consent Calendar",16,0,0,0,16
1978587,1552873,2025-04-21,Assembly,"Do pass and be re-referred to the Committee on [Elections]",9,0,0,0,9
1978588,1564180,2025-04-30,Assembly,"Do pass and be re-referred to the Committee on [Appropriations]",7,1,0,1,9
1978591,1563051,2025-04-29,Assembly,"Do pass as amended and be re-referred to the Committee on [Appropriations]",9,2,0,2,13
1978594,1554486,2025-04-21,Assembly,"Do pass and be re-referred to the Committee on [Appropriations] with recommendation: To Consent Calendar",15,0,0,1,16
1978596,1528290,2025-03-26,Assembly,"Do pass as amended and be re-referred to the Committee on [Local Government]",8,2,0,1,11
1978596,1556197,2025-04-23,Assembly,"Do pass and be re-referred to the Committee on [Appropriations]",9,1,0,0,10
1978596,1563077,2025-04-30,Assembly,"Do pass",10,3,0,2,15
1978597,1564228,2025-04-30,Assembly,"Do pass and be re-referred to the Committee on [Appropriations]",2,4,0,3,9
1978597,1564229,2025-04-30,Assembly,Reconsideration,9,0,0,0,9
1978599,1555954,2025-04-22,Assembly,"Do pass and be re-referred to the Committee on [Judiciary]",10,3,0,2,15
1978599,1561185,2025-04-29,Assembly,"Do pass as amended and be re-referred to the Committee on [Appropriations]",9,3,0,0,12
1978600,1540842,2025-04-08,Assembly,"Do pass as amended and be re-referred to the Committee on [Banking and Finance]",7,3,0,2,12
1978600,1552955,2025-04-21,Assembly,"Do pass",0,6,0,3,9
1978600,1552956,2025-04-21,Assembly,Reconsideration,7,2,0,0,9
1978601,1564145,2025-05-01,Assembly,"Do pass and be re-referred to the Committee on [Judiciary]",2,2,0,3,7
1978602,1556143,2025-04-23,Assembly,"Do pass as amended and be re-referred to the Committee on [Appropriations]",7,0,0,0,7
1978603,1554547,2025-04-22,Assembly,"Do pass and be re-referred to the Committee on [Emergency Management]",6,0,0,1,7
1978603,1561209,2025-04-28,Assembly,"Do pass and be re-referred to the Committee on [Appropriations] with recommendation: To Consent Calendar",7,0,0,0,7
1978604,1554494,2025-04-22,Assembly,"Do pass and be re-referred to the Committee on [Emergency Management]",6,0,0,1,7
1978604,1561109,2025-04-28,Assembly,"Do pass and be re-referred to the Committee on [Appropriations] with recommendation: To Consent Calendar",7,0,0,0,7
1978606,1554455,2025-04-22,Assembly,"Do pass",7,2,0,0,9
1978607,1542882,2025-04-09,Assembly,"Do pass and be re-referred to the Committee on [Appropriations] with recommendation: To Consent Calendar",7,0,0,0,7
1978607,1556002,2025-04-23,Assembly,"Do pass. To Consent Calendar",15,0,0,0,15
1978607,1564243,2025-05-01,Assembly,"AB 1072 Pellerin Consent Calendar Second Day Regular Session",76,0,0,3,79
1978609,1540840,2025-04-08,Assembly,"Do pass and be re-referred to the Committee on [Appropriations]",5,1,0,0,6
1978610,1540803,2025-04-07,Assembly,"Do pass and be re-referred to the Committee on [Natural Resources]",6,1,0,0,7
1978610,1558711,2025-04-21,Assembly,"Do pass as amended and be re-referred to the Committee on [Appropriations]",14,0,0,0,14
1978610,1567860,2025-05-07,Assembly,"Do pass",15,0,0,0,15
1978611,1542880,2025-04-07,Assembly,"Do pass and be re-referred to the Committee on [Appropriations]",6,0,0,1,7
1978613,1542686,2025-04-08,Assembly,"Do pass and be re-referred to the Committee on [Appropriations]",6,2,0,1,9
1978614,1526944,2025-03-25,Assembly,"Do pass and be re-referred to the Committee on [Elections]",7,3,0,2,12
1978614,1562841,2025-04-30,Assembly,"Do pass as amended",4,2,0,1,7
1978615,1562984,2025-04-29,Assembly,"Do pass and be re-referred to the Committee on [Appropriations]",7,0,0,0,7
1978617,1533481,2025-04-01,Assembly,"Do pass and be re-referred to the Committee on [Appropriations]",14,0,0,4,18
1978619,1526918,2025-03-25,Assembly,"Do pass and be re-referred to the Committee on [Health]",9,1,0,2,12
1978619,1563035,2025-04-29,Assembly,"Do pass as amended and be re-referred to the Committee on [Appropriations]",12,2,0,2,16
1978620,1554616,2025-04-21,Assembly,"Do pass and be re-referred to the Committee on [Appropriations] with recommendation: To Consent Calendar",15,0,0,1,16
1978620,1567857,2025-05-07,Assembly,"Do pass. To Consent Calendar",15,0,0,0,15
1978621,1558710,2025-04-21,Assembly,"Do pass as amended and be re-referred to the Committee on [Water, Parks, and Wildlife]",13,0,0,1,14
1978621,1562756,2025-04-29,Assembly,"Do pass as amended and be re-referred to the Committee on [Appropriations]",11,0,0,2,13
1978622,1554615,2025-04-22,Assembly,"Do pass as amended, and be re-referred to the Committee on [Appropriations] with recommendation: To Consent Calendar",9,0,0,0,9
1978623,1555983,2025-04-22,Assembly,"Do pass and be re-referred to the Committee on [Environmental Safety and Toxic Materials]",16,0,0,0,16
1978623,1561100,2025-04-29,Assembly,"Do pass and be re-referred to the Committee on [Appropriations]",7,0,0,0,7
1978624,1540806,2025-04-08,Assembly,"Do pass and be re-referred to the Committee on [Appropriations]",11,0,0,2,13
1978624,1556058,2025-04-23,Assembly,"Do pass",15,0,0,0,15
1978624,1559452,2025-04-28,Assembly,"AB 1089 Carrillo Assembly Third Reading",65,0,0,14,79
1978627,1535009,2025-04-01,Assembly,"Do pass",2,4,0,3,9
1978627,1542869,2025-04-08,Assembly,Reconsideration,7,1,0,1,9
1978628,1542847,2025-04-08,Assembly,"Do pass and be re-referred to the Committee on [Appropriations]",7,1,0,2,10
1978629,1535043,2025-04-01,Assembly,"Do pass as amended and be re-referred to the Committee on [Appropriations]",9,0,0,0,9
1978630,1556065,2025-04-23,Assembly,"Do pass and be re-referred to the Committee on [Natural Resources] with recommendation: To Consent Calendar",18,0,0,0,18
1978630,1559433,2025-04-28,Assembly,"Do pass and be re-referred to the Committee on [Appropriations] with recommendation: To Consent Calendar",14,0,0,0,14
1978631,1561108,2025-04-29,Assembly,"Do pass and be re-referred to the Committee on [Appropriations] with recommendation: To Consent Calendar",7,0,0,0,7
1978633,1542694,2025-04-08,Assembly,"Do pass as amended, and be re-referred to the Committee on [Judiciary] with recommendation: To Consent Calendar",10,0,0,0,10
1978633,1554588,2025-04-22,Assembly,"Do pass and be re-referred to the Committee on [Appropriations] with recommendation: To Consent Calendar",12,0,0,0,12
1978634,1562791,2025-04-29,Assembly,"Do pass and be re-referred to the Committee on [Appropriations] with recommendation: To Consent Calendar",7,0,0,0,7
1978635,1542745,2025-04-08,Assembly,"Do pass and be re-referred to the Committee on [Appropriations]",5,0,0,4,9
1978636,1554492,2025-04-22,Assembly,"Do pass and be re-referred to the Committee on [Appropriations] with recommendation: To Consent Calendar",18,0,0,0,18
1978637,1561207,2025-04-29,Assembly,"Do pass and be re-referred to the Committee on [Appropriations] with recommendation: To Consent Calendar",7,0,0,0,7
1978638,1562774,2025-04-29,Assembly,"Do pass as amended and be re-referred to the Committee on [Appropriations]",16,0,0,0,16
1978639,1557575,2025-04-23,Assembly,"Do pass and be re-referred to the Committee on [Utilities and Energy]",6,0,0,1,7
1978639,1564178,2025-04-30,Assembly,"Do pass as amended, and be re-referred to the Committee on [Appropriations] with recommendation: To Consent Calendar",18,0,0,0,18
1978640,1540946,2025-04-08,Assembly,"Do pass. To Consent Calendar",12,0,0,0,12
1978640,1552947,2025-04-21,Assembly,"AB 1105 Quirk-Silva Consent Calendar Second Day Regular Session",73,0,0,6,79
1978641,1559374,2025-04-28,Assembly,"Do pass and be re-referred to the Committee on [Appropriations]",14,0,0,0,14
1978642,1540979,2025-04-08,Assembly,"Do pass and be re-referred to the Committee on [Public Safety] with recommendation: To Consent Calendar",17,0,0,1,18
1978642,1562995,2025-04-29,Assembly,"Do pass and be re-referred to the Committee on [Appropriations]",7,0,0,2,9
1978643,1542775,2025-04-08,Assembly,"Do pass as amended and be re-referred to the Committee on [Local Government]",8,0,0,1,9
1978643,1564206,2025-04-30,Assembly,"Do pass and be re-referred to the Committee on [Appropriations]",10,0,0,0,10
1978644,1540866,2025-04-08,Assembly,"Do pass",9,0,0,3,12
1978645,1536763,2025-04-02,Assembly,"Do pass and be re-referred to the Committee on [Appropriations]",6,0,0,1,7
1978646,1545032,2025-04-09,Assembly,"Do pass as amended and be re-referred to the Committee on [Transportation]",8,1,0,0,9
1978646,1561036,2025-04-28,Assembly,"Do pass as amended and be re-referred to the Committee on [Appropriations]",16,0,0,0,16
1978647,1564245,2025-04-30,Assembly,"Do pass as amended and be re-referred to the Committee on [Appropriations]",10,0,0,0,10
1978648,1562951,2025-04-29,Assembly,"Do pass as amended and be re-referred to the Committee on [Appropriations]",11,1,0,4,16
1978649,1561049,2025-04-28,Assembly,"Do pass and be re-referred to the Committee on [Appropriations] with recommendation: To Consent Calendar",16,0,0,0,16
1978651,1542867,2025-04-09,Assembly,"Do pass as amended and be re-referred to the Committee on [Appropriations]",5,2,0,0,7
1978652,1535057,2025-04-02,Assembly,"Do pass as amended and be re-referred to the Committee on [Appropriations]",14,0,0,4,18
1978654,1529558,2025-03-26,Assembly,"Do pass as amended and be re-referred to the Committee on [Appropriations]",9,0,0,0,9
1978655,1540959,2025-04-08,Assembly,"Do pass and be re-referred to the Committee on [Appropriations] with recommendation: To Consent Calendar",6,0,0,0,6
1978657,1542901,2025-04-08,Assembly,"Do pass as amended and be re-referred to the Committee on [Education]",9,0,0,1,10
1978658,1544968,2025-04-09,Assembly,"Do pass as amended and be re-referred to the Committee on [Appropriations]",9,0,0,0,9
1978658,1562967,2025-04-30,Assembly,"Do pass",14,0,0,1,15
1978658,1568610,2025-05-08,Assembly,"AB 1123 Muratsuchi Assembly Third Reading",72,0,0,7,79
1978660,1556018,2025-04-23,Assembly,"Do pass and be re-referred to the Committee on [Appropriations] with recommendation: To Consent Calendar",17,0,0,0,17
1978662,1542838,2025-04-08,Assembly,"Do pass as amended and be re-referred to the Committee on [Judiciary]",7,1,0,1,9
1978662,1554458,2025-04-22,Assembly,"Do pass and be re-referred to the Committee on [Appropriations]",9,2,0,1,12
1978663,1529544,2025-03-26,Assembly,"Do pass and be re-referred to the Committee on [Appropriations] with recommendation: To Consent Calendar",9,0,0,0,9
1978664,1563085,2025-04-29,Assembly,"Do pass and be re-referred to the Committee on [Appropriations]",13,0,0,3,16
1978665,1554533,2025-04-22,Assembly,"Do pass and be re-referred to the Committee on [Appropriations] with recommendation: To Consent Calendar",18,0,0,0,18
1978666,1542876,2025-04-09,Assembly,"Do pass and be re-referred to the Committee on [Local Government] with recommendation: To Consent Calendar",12,0,0,0,12
1978666,1556083,2025-04-23,Assembly,"Do pass and be re-referred to the Committee on [Appropriations] with recommendation: To Consent Calendar",10,0,0,0,10
1978667,1554580,2025-04-21,Assembly,"Do pass and be re-referred to the Committee on [Appropriations]",12,1,0,3,16
1978669,1542834,2025-04-08,Assembly,"Do pass and be re-referred to the Committee on [Judiciary]",8,0,0,1,9
1978669,1554543,2025-04-22,Assembly,"Do pass as amended",12,0,0,0,12
1978671,1536841,2025-04-02,Assembly,"Do pass and be re-referred to the Committee on [Appropriations]",6,0,0,1,7
1978672,1556046,2025-04-22,Assembly,"Do pass and be re-referred to the Committee on [Judiciary]",13,0,0,2,15
1978672,1561188,2025-04-29,Assembly,"Do pass and be re-referred to the Committee on [Appropriations]",11,0,0,1,12
1978673,1554511,2025-04-22,Assembly,"Do pass and be re-referred to the Committee on [Revenue and Taxation]",8,0,0,1,9
1978673,1561167,2025-04-28,Assembly,"Do pass and be re-referred to the Committee on [Appropriations]",6,1,0,0,7
1978674,1538937,2025-04-07,Assembly,"Do pass as amended and be re-referred to the Committee on [Water, Parks, and Wildlife]",13,0,0,1,14
1978674,1562920,2025-04-29,Assembly,"Do pass and be re-referred to the Committee on [Appropriations]",12,0,0,1,13
1978675,1542685,2025-04-08,Assembly,"Do pass and be re-referred to the Committee on [Appropriations] with recommendation: To Consent Calendar",9,0,0,0,9
1978676,1542719,2025-04-09,Assembly,"Do pass and be re-referred to the Committee on [Transportation] with recommendation: To Consent Calendar",10,0,0,0,10
1978676,1561008,2025-04-28,Assembly,"Do pass and be re-referred to the Committee on [Appropriations] with recommendation: To Consent Calendar",16,0,0,0,16
1978677,1528262,2025-03-26,Assembly,"Do pass and be re-referred to the Committee on [Appropriations]",8,0,0,0,8
1978677,1542723,2025-04-09,Assembly,"Do pass",14,0,0,1,15
1978678,1540943,2025-04-07,Assembly,"Do pass and be re-referred to the Committee on [Natural Resources]",7,0,0,0,7
1978678,1558712,2025-04-21,Assembly,"Do pass as amended, and be re-referred to the Committee on [Appropriations] with recommendation: To Consent Calendar",14,0,0,0,14
1978679,1542783,2025-04-08,Assembly,"Do pass as amended and be re-referred to the Committee on [Appropriations]",5,0,0,4,9
1978680,1561053,2025-04-28,Assembly,"Do pass and be re-referred to the Committee on [Appropriations] with recommendation: To Consent Calendar",16,0,0,0,16
1978681,1562796,2025-04-29,Assembly,"Do pass as amended and be re-referred to the Committee on [Appropriations]",8,3,0,2,13
1978683,1542839,2025-04-08,Assembly,"Do pass and be re-referred to the Committee on [Judiciary]",5,2,0,0,7
1978683,1554561,2025-04-22,Assembly,"Do pass as amended and be re-referred to the Committee on [Appropriations]",9,2,0,1,12
1978684,1538949,2025-04-07,Assembly,"Do pass. To Consent Calendar",16,0,0,0,16
1978684,1552841,2025-04-21,Assembly,"AB 1149 Davies Consent Calendar Second Day",73,0,0,6,79
1978685,1535114,2025-04-01,Assembly,"Do pass",12,1,0,2,15
1978685,1545027,2025-04-10,Assembly,"AB 1150 Schultz Assembly Third Reading",66,1,0,12,79
1978686,1554632,2025-04-21,Assembly,"Do pass and be re-referred to the Committee on [Appropriations] with recommendation: To Consent Calendar",15,0,0,1,16
1978687,1558371,2025-04-24,Assembly,"Do pass and be re-referred to the Committee on [Local Government] with recommendation: To Consent Calendar",11,0,0,1,12
1978687,1564168,2025-04-30,Assembly,"Do pass",10,0,0,0,10
1978687,1568642,2025-05-08,Assembly,"AB 1152 Patterson Assembly Third Reading",68,0,0,11,79
1978688,1538957,2025-04-07,Assembly,"Do pass as amended and be re-referred to the Committee on [Appropriations]",14,0,0,0,14
1978689,1528246,2025-03-26,Assembly,"Do pass and be re-referred to the Committee on [Local Government] with recommendation: To Consent Calendar",10,0,0,1,11
1978689,1542712,2025-04-09,Assembly,"Do pass and be re-referred to the Committee on [Appropriations]",10,0,0,0,10
1978689,1556034,2025-04-23,Assembly,"Do pass",15,0,0,0,15
1978689,1559385,2025-04-28,Assembly,"AB 1154 Carrillo Assembly Third Reading",70,1,0,8,79
1978690,1555902,2025-04-22,Assembly,"Do pass and be re-referred to the Committee on [Judiciary]",9,0,0,1,10
1978690,1561046,2025-04-29,Assembly,"Do pass and be re-referred to the Committee on [Appropriations] with recommendation: To Consent Calendar",12,0,0,0,12
1978691,1555900,2025-04-23,Assembly,"Do pass and be re-referred to the Committee on [Utilities and Energy]",9,0,0,1,10
1978691,1555901,2025-04-23,Assembly,"Do pass and be re-referred to the Committee on [Agriculture]",16,0,0,2,18
1978691,1562871,2025-04-30,Assembly,"Do pass as amended and be re-referred to the Committee on [Appropriations]",6,1,0,1,8
1978692,1557580,2025-04-24,Assembly,"Do pass and be re-referred to the Committee on [Judiciary]",7,5,0,0,12
1978693,1554641,2025-04-22,Assembly,"Do pass and be re-referred to the Committee on [Appropriations] with recommendation: To Consent Calendar",12,0,0,0,12
1978695,1542709,2025-04-08,Assembly,"Do pass and be re-referred to the Committee on [Privacy and Consumer Protection]",8,0,0,1,9
1978695,1564204,2025-05-01,Assembly,"Do pass as amended and be re-referred to the Committee on [Appropriations]",13,0,0,2,15
1978696,1540831,2025-04-08,Assembly,"Do pass as amended and be re-referred to the Committee on [Health]",6,0,0,0,6
1978696,1563023,2025-04-29,Assembly,"Do pass as amended, and be re-referred to the Committee on [Appropriations] with recommendation: To Consent Calendar",16,0,0,0,16
1978697,1566716,2025-05-06,Assembly,"Do pass. To Consent Calendar",12,0,0,0,12
1978699,1528291,2025-03-26,Assembly,"Do pass and be re-referred to the Committee on [Appropriations]",8,0,0,0,8
1978700,1544976,2025-04-09,Assembly,"Do pass as amended",9,0,0,0,9
1978701,1554609,2025-04-22,Assembly,"Do pass and be re-referred to the Committee on [Appropriations]",7,0,0,1,8
1978702,1562983,2025-04-30,Assembly,"Do pass and be re-referred to the Committee on [Appropriations] with recommendation: To Consent Calendar",7,0,0,0,7
1978703,1526957,2025-03-25,Assembly,"Do pass and be re-referred to the Committee on [Appropriations] with recommendation: To Consent Calendar",15,0,0,0,15
1978703,1542707,2025-04-09,Assembly,"Do pass. To Consent Calendar",14,0,0,1,15
1978703,1557518,2025-04-24,Assembly,"AB 951 Ta Consent Calendar Second Day Regular Session",75,0,0,4,79
1978704,1535003,2025-04-01,Assembly,"Do pass and be re-referred to the Committee on [Appropriations] with recommendation: To Consent Calendar",9,0,0,0,9
1978704,1556172,2025-04-23,Assembly,"Do pass. To Consent Calendar",15,0,0,0,15
1978704,1564258,2025-05-01,Assembly,"AB 952 Elhawary Consent Calendar Second Day Regular Session",76,0,0,3,79
1978705,1562979,2025-04-30,Assembly,"Do pass as amended, and be re-referred to the Committee on [Appropriations] with recommendation: To Consent Calendar",7,0,0,0,7
1978706,1538948,2025-04-07,Assembly,"Do pass and be re-referred to the Committee on [Appropriations]",12,4,0,0,16
1978707,1556175,2025-04-22,Assembly,"Do pass as amended and be re-referred to the Committee on [Appropriations]",16,0,0,0,16
1978708,1558379,2025-04-24,Assembly,"Do pass and be re-referred to the Committee on [Local Government]",11,0,0,1,12
1978708,1564269,2025-04-30,Assembly,"Do pass and be re-referred to the Committee on [Appropriations]",9,0,0,1,10
1978709,1540971,2025-04-08,Assembly,"Do pass and be re-referred to the Committee on [Governmental Organization]",12,0,0,6,18
1978709,1556120,2025-04-23,Assembly,"Do pass as amended and be re-referred to the Committee on [Appropriations]",17,1,0,4,22
1978710,1561032,2025-04-29,Assembly,"Do pass as amended and be re-referred to the Committee on [Appropriations]",8,0,0,2,10
1978711,1529510,2025-03-26,Assembly,"Do pass and be re-referred to the Committee on [Appropriations] with recommendation: To Consent Calendar",9,0,0,0,9
1978712,1556127,2025-04-22,Assembly,"Do pass as amended, and be re-referred to the Committee on [Appropriations] with recommendation: To Consent Calendar",16,0,0,0,16
1978713,1528322,2025-03-25,Assembly,"Do pass and be re-referred to the Committee on [Appropriations] with recommendation: To Consent Calendar",7,0,0,0,7
1978714,1545021,2025-04-09,Assembly,"Do pass. To Consent Calendar",9,0,0,0,9
1978714,1557546,2025-04-24,Assembly,"AB 962 Hoover Consent Calendar Second Day Regular Session",75,0,0,4,79
1978715,1557488,2025-04-23,Assembly,"Do pass and be re-referred to the Committee on [Appropriations]",7,0,0,0,7
1978716,1556110,2025-04-23,Assembly,"Do pass and be re-referred to the Committee on [Education]",10,0,0,0,10
1978716,1564295,2025-04-30,Assembly,"Do pass and be re-referred to the Committee on [Appropriations] with recommendation: To Consent Calendar",9,0,0,0,9
1978717,1561009,2025-04-28,Assembly,"Do pass and be re-referred to the Committee on [Appropriations] with recommendation: To Consent Calendar",16,0,0,0,16
1978719,1554531,2025-04-22,Assembly,"Do pass as amended and be re-referred to the Committee on [Appropriations]",17,0,0,1,18
1978720,1561155,2025-04-29,Assembly,"Do pass and be re-referred to the Committee on [Appropriations]",17,0,0,1,18
1978721,1540942,2025-04-08,Assembly,"Do pass as amended and be re-referred to the Committee on [Appropriations]",6,0,0,0,6
1978722,1540968,2025-04-08,Assembly,"Do pass as amended and be re-referred to the Committee on [Public Safety]",6,0,0,0,6
1978723,1562797,2025-04-30,Assembly,"Do pass and be re-referred to the Committee on [Appropriations]",19,0,0,3,22
1978724,1555984,2025-04-22,Assembly,"Do pass as amended and be re-referred to the Committee on [Judiciary]",7,1,0,2,10
1978724,1566719,2025-05-06,Assembly,"Do pass",9,2,0,1,12
1978725,1538977,2025-04-07,Assembly,"Do pass as amended and be re-referred to the Committee on [Judiciary]",14,0,0,0,14
1978725,1561079,2025-04-29,Assembly,"Do pass and be re-referred to the Committee on [Appropriations]",9,0,0,3,12
1978726,1555929,2025-04-22,Assembly,"Do pass and be re-referred to the Committee on [Appropriations]",15,0,0,1,16
1978727,1562827,2025-04-29,Assembly,"Do pass as amended and be re-referred to the Committee on [Appropriations]",13,0,0,0,13
1978729,1542741,2025-04-08,Assembly,"Do pass and be re-referred to the Committee on [Appropriations]",10,0,0,0,10
1978730,1538889,2025-04-07,Assembly,"Do pass and be re-referred to the Committee on [Appropriations] with recommendation: To Consent Calendar",16,0,0,0,16
1978730,1562898,2025-04-30,Assembly,"Do pass. To Consent Calendar",14,0,0,1,15
1978730,1568651,2025-05-08,Assembly,"AB 978 Hoover Consent Calendar Second Day Regular Session",69,0,0,10,79
1978731,1564210,2025-05-01,Assembly,"Do pass and be re-referred to the Committee on [Appropriations] with recommendation: To Consent Calendar",13,0,0,2,15
1978733,1554548,2025-04-22,Assembly,"Do pass as amended and be re-referred to the Committee on [Appropriations]",9,0,0,0,9
1978734,1558713,2025-04-21,Assembly,"Do pass and be re-referred to the Committee on [Appropriations] with recommendation: To Consent Calendar",14,0,0,0,14
1978736,1566729,2025-05-05,Assembly,"Do pass and be re-referred to the Committee on [Appropriations]",7,0,0,0,7
1978737,1554461,2025-04-22,Assembly,"Do pass and be re-referred to the Committee on [Appropriations]",17,0,0,1,18
1978737,1567877,2025-05-07,Assembly,"Do pass",15,0,0,0,15
1978738,1561175,2025-04-28,Assembly,"Do pass and be re-referred to the Committee on [Appropriations]",6,0,0,1,7
1978739,1561061,2025-04-28,Assembly,"Do pass and be re-referred to the Committee on [Appropriations]",16,0,0,0,16
1978740,1542819,2025-04-08,Assembly,"Do pass as amended and be re-referred to the Committee on [Education]",8,0,0,2,10
1978740,1564255,2025-04-30,Assembly,"Do pass as amended, and be re-referred to the Committee on [Appropriations] with recommendation: To Consent Calendar",9,0,0,0,9
1978741,1535025,2025-04-02,Assembly,"Do pass and be re-referred to the Committee on [Public Employment and Retirement]",20,0,0,2,22
1978741,1556048,2025-04-23,Assembly,"Do pass and be re-referred to the Committee on [Appropriations]",7,0,0,0,7
1978742,1542762,2025-04-08,Assembly,"Do pass. To Consent Calendar",7,0,0,0,7
1978742,1557482,2025-04-24,Assembly,"AB 990 Hadwick Consent Calendar Second Day Regular Session",75,0,0,4,79
1978744,1554577,2025-04-22,Assembly,"Do pass as amended, and be re-referred to the Committee on [Appropriations] with recommendation: To Consent Calendar",9,0,0,0,9
1978744,1567897,2025-05-07,Assembly,"Do pass. To Consent Calendar",15,0,0,0,15
1978745,1542919,2025-04-08,Assembly,"Do pass and be re-referred to the Committee on [Appropriations] with recommendation: To Consent Calendar",7,0,0,0,7
1978746,1554613,2025-04-22,Assembly,"Do pass as amended, and be re-referred to the Committee on [Appropriations] with recommendation: To Consent Calendar",9,0,0,0,9
1978747,1564162,2025-05-01,Assembly,"Do pass as amended, and be re-referred to the Committee on [Appropriations] with recommendation: To Consent Calendar",13,0,0,2,15
1978748,1559371,2025-04-28,Assembly,"Do pass as amended, and be re-referred to the Committee on [Appropriations] with recommendation: To Consent Calendar",14,0,0,0,14
1978749,1540869,2025-04-08,Assembly,"Do pass and be re-referred to the Committee on [Transportation] with recommendation: To Consent Calendar",6,0,0,0,6
1978749,1561060,2025-04-28,Assembly,"Do pass and be re-referred to the Committee on [Appropriations] with recommendation: To Consent Calendar",16,0,0,0,16
1978750,1561157,2025-04-29,Assembly,"Do pass and be re-referred to the Committee on [Appropriations]",7,0,0,0,7
1978753,1565231,2025-05-05,Assembly,"Be adopted. To Consent Calendar",9,0,0,2,11
1978753,1568618,2025-05-08,Assembly,"ACR 36 Carrillo Consent Calendar Second Day Regular Session",69,0,0,10,79
1978754,1561183,2025-04-28,Assembly,"Be adopted. To Consent Calendar",16,0,0,0,16
1978754,1564205,2025-05-01,Assembly,"ACR 37 Wallis Consent Calendar Second Day Regular Session",76,0,0,3,79
1978757,1540880,2025-04-08,Senate,"Do pass, but first be re-referred to the Committee on [Appropriations]",5,1,0,0,6
1978757,1552827,2025-04-21,Senate,"Placed on suspense file",6,0,0,1,7
1978758,1555976,2025-04-23,Senate,"Do pass",4,0,0,3,7
1978759,1555894,2025-04-23,Senate,"Do pass as amended, but first amend, and re-refer to the Committee on [Appropriations]",6,1,0,1,8
1978761,1564211,2025-04-30,Senate,"Do pass as amended, but first amend, and re-refer to the Committee on [Appropriations]",8,2,0,1,11
1978763,1544983,2025-04-09,Senate,"Do pass as amended, but first amend, and re-refer to the Committee on [Appropriations]",9,0,0,2,11
1978763,1559402,2025-04-28,Senate,"Placed on suspense file",7,0,0,0,7
1978764,1562854,2025-04-30,Senate,"Do pass, but first be re-referred to the Committee on [Appropriations]",0,2,0,5,7
1978764,1562855,2025-04-30,Senate,"[Second] hearing set for [04-30-2025]: Failed passage in Committee. Reconsideration granted",7,0,0,0,7
1978766,1525423,2025-03-24,Senate,"Do pass as amended, but first amend, and re-refer to the Committee on [Transportation]",16,0,0,1,17
1978766,1542749,2025-04-08,Senate,"Do pass and be ordered to the Consent Calendar",15,0,0,0,15
1978766,1557557,2025-04-24,Senate,"Consent Calendar 2nd SB533 Richardson",37,0,0,3,40
1978767,1538921,2025-04-07,Senate,"Do pass, but first be re-referred to the Committee on [Local Government]",10,0,0,1,11
1978767,1567893,2025-05-07,Senate,"Do pass as amended, and be ordered to the Consent Calendar",7,0,0,0,7
1978768,1564160,2025-04-30,Senate,"Do pass, but first be re-referred to the Committee on [Appropriations]",8,0,0,3,11
1978769,1555884,2025-04-23,Senate,"Do pass as amended, but first amend, and re-refer to the Committee on [Appropriations]",5,0,0,0,5
1978770,1554477,2025-04-22,Senate,"Do pass as amended, but first amend, and re-refer to the Committee on [Appropriations]",5,0,0,1,6
1978770,1565284,2025-05-05,Senate,"Placed on suspense file",7,0,0,0,7
1978772,1542751,2025-04-09,Senate,"Do pass as amended, but first amend, and re-refer to the Committee on [Appropriations]",7,0,0,0,7
1978772,1559453,2025-04-28,Senate,"Placed on suspense file",7,0,0,0,7
1978773,1554450,2025-04-21,Senate,"Do pass, but first be re-referred to the Committee on [Judiciary]",17,0,0,0,17
1978773,1562933,2025-04-29,Senate,"Do pass as amended, but first amend, and re-refer to the Committee on [Appropriations]",11,0,0,2,13
1978774,1554459,2025-04-21,Senate,"Do pass as amended, but first amend, and re-refer to the Committee on [Appropriations]",13,4,0,0,17
1978775,1554439,2025-04-22,Senate,"Do pass as amended, but first amend, and re-refer to the Committee on [Appropriations]",4,2,0,1,7
1978776,1556094,2025-04-22,Senate,"Do pass, but first be re-referred to the Committee on [Local Government]",11,0,0,0,11
1978776,1563091,2025-04-30,Senate,"Do pass, but first be re-referred to the Committee on [Appropriations]",7,0,0,0,7
1978777,1525459,2025-03-24,Senate,"Do pass, but first be re-referred to the Committee on [Transportation]",16,0,0,1,17
1978777,1542851,2025-04-08,Senate,"Do pass, but first be re-referred to the Committee on [Appropriations] with the recommendation: To Consent Calendar",15,0,0,0,15
1978777,1564293,2025-05-01,Senate,"Consent Calendar 2nd SB544 Laird",37,0,0,3,40
1978778,1542725,2025-04-08,Senate,"Do pass, but first be re-referred to the Committee on [Local Government]",11,1,0,3,15
1978778,1562794,2025-04-30,Senate,"Do pass as amended, but first amend, and re-refer to the Committee on [Appropriations]",5,2,0,0,7
1978780,1556100,2025-04-23,Senate,"Do pass, but first be re-referred to the Committee on [Appropriations]",6,0,0,1,7
1978781,1564195,2025-04-30,Senate,"Do pass as amended, but first amend, and re-refer to the Committee on [Appropriations] with the recommendation: To Consent Calendar",11,0,0,0,11
1978782,1567870,2025-05-07,Senate,"Do pass",5,2,0,0,7
1978783,1556149,2025-04-23,Senate,"Do pass, but first be re-referred to the Committee on [Judiciary]",5,1,0,1,7
1978783,1562973,2025-04-29,Senate,"Do pass as amended, but first amend, and re-refer to the Committee on [Appropriations]",10,1,0,2,13
1978784,1554481,2025-04-22,Senate,"Do pass, but first be re-referred to the Committee on [Appropriations]",5,1,0,0,6
1978785,1533496,2025-04-01,Senate,"Do pass, but first be re-referred to the Committee on [Appropriations] with the recommendation: To Consent Calendar",6,0,0,0,6
1978785,1552896,2025-04-21,Senate,"Placed on suspense file",6,0,0,1,7
1978786,1533538,2025-04-01,Senate,"Do pass, but first be re-referred to the Committee on [Appropriations] with the recommendation: To Consent Calendar",6,0,0,0,6
1978786,1552925,2025-04-21,Senate,"Placed on suspense file",6,0,0,1,7
1978787,1563087,2025-04-29,Senate,"Do pass, but first be re-referred to the Committee on [Local Government]",1,5,0,0,6
1978788,1542862,2025-04-09,Senate,"Do pass, but first be re-referred to the Committee on [Appropriations]",4,1,0,0,5
1978788,1565364,2025-05-05,Senate,"Placed on suspense file",7,0,0,0,7
1978789,1540934,2025-04-08,Senate,"Do pass as amended, but first amend, and re-refer to the Committee on [Appropriations]",6,0,0,1,7
1978789,1559496,2025-04-28,Senate,"Placed on suspense file",7,0,0,0,7
1978791,1567876,2025-05-07,Senate,"Do pass and be ordered to the Consent Calendar",7,0,0,0,7
1978792,1525450,2025-03-24,Senate,"Do pass as amended, but first amend, and re-refer to the Committee on [Appropriations]",13,0,0,4,17
1978792,1565271,2025-05-05,Senate,"Placed on suspense file",7,0,0,0,7
1978793,1540887,2025-04-07,Senate,"Do pass, but first be re-referred to the Committee on [Public Safety]",4,0,0,1,5
1978793,1554501,2025-04-22,Senate,"Do pass, but first be re-referred to the Committee on [Appropriations]",5,1,0,0,6
1978793,1565322,2025-05-05,Senate,"Placed on suspense file",7,0,0,0,7
1978794,1536786,2025-04-02,Senate,"Do pass as amended, but first amend, and re-refer to the Committee on [Judiciary]",8,0,0,0,8
1978794,1556171,2025-04-22,Senate,"Do pass, but first be re-referred to the Committee on [Appropriations]",13,0,0,0,13
1978794,1565229,2025-05-05,Senate,"Placed on suspense file",7,0,0,0,7
1978795,1554660,2025-04-22,Senate,"Do pass as amended, but first amend, and re-refer to the Committee on [Appropriations]",4,1,0,1,6
1978795,1565345,2025-05-05,Senate,"Placed on suspense file",7,0,0,0,7
1978796,1554614,2025-04-22,Senate,"Do pass, but first be re-referred to the Committee on [Appropriations] with the recommendation: To Consent Calendar",6,0,0,1,7
1978796,1565346,2025-05-05,Senate,"Placed on suspense file",7,0,0,0,7
1978800,1526926,2025-03-25,Senate,"Do pass as amended, but first amend, and re-refer to the Committee on [Environmental Quality]",7,0,0,0,7
1978800,1563056,2025-04-30,Senate,"Do pass, but first be re-referred to the Committee on [Appropriations]",8,0,0,0,8
1978801,1542702,2025-04-09,Senate,"Do pass as amended, but first amend, and re-refer to the Committee on [Appropriations] with the recommendation: To Consent Calendar",7,0,0,0,7
1978801,1559417,2025-04-28,Senate,"Placed on suspense file",7,0,0,0,7
1978802,1554505,2025-04-22,Senate,"Do pass, but first be re-referred to the Committee on [Appropriations]",15,0,0,0,15
1978802,1565267,2025-05-05,Senate,"Placed on suspense file",7,0,0,0,7
1978804,1554545,2025-04-22,Senate,"Do pass, but first be re-referred to the Committee on [Appropriations]",6,0,0,0,6
1978804,1565305,2025-05-05,Senate,"Placed on suspense file",7,0,0,0,7
1978805,1554487,2025-04-22,Senate,"Do pass, but first be re-referred to the Committee on [Judiciary]",11,1,0,3,15
1978805,1562781,2025-04-29,Senate,"Do pass as amended, but first amend, and re-refer to the Committee on [Appropriations]",12,0,0,1,13
1978809,1559461,2025-04-28,Senate,"Do pass",11,0,0,0,11
1978810,1556162,2025-04-22,Senate,"Do pass as amended, but first amend, and re-refer to the Committee on [Appropriations]",13,0,0,0,13
1978811,1528266,2025-03-26,Senate,"Do pass, but first be re-referred to the Committee on [Appropriations]",4,1,0,0,5
1978811,1538930,2025-04-07,Senate,"Placed on suspense file",7,0,0,0,7
1978812,1527011,2025-03-25,Senate,"Do pass as amended, but first amend, and re-refer to the Committee on [Appropriations]",12,0,0,3,15
1978812,1552822,2025-04-21,Senate,"Placed on suspense file",6,0,0,1,7
1978813,1556063,2025-04-22,Senate,"Do pass, but first be re-referred to the Committee on [Local Government]",11,1,0,1,13
1978813,1562744,2025-04-30,Senate,"Do pass, but first be re-referred to the Committee on [Appropriations]",5,2,0,0,7
1978814,1562858,2025-04-30,Senate,"Do pass, but first be re-referred to the Committee on [Appropriations] with the recommendation: To Consent Calendar",5,0,0,0,5
1978815,1552926,2025-04-21,Senate,"Do pass, but first be re-referred to the Committee on [Health] with the recommendation: To Consent Calendar",5,0,0,0,5
1978815,1564266,2025-04-30,Senate,"Do pass as amended, but first amend, and re-refer to the Committee on [Appropriations] with the recommendation: To Consent Calendar",11,0,0,0,11
1978816,1542881,2025-04-09,Senate,"Do pass, but first be re-referred to the Committee on [Appropriations] with the recommendation: To Consent Calendar",7,0,0,0,7
1978816,1557514,2025-04-24,Senate,"Consent Calendar 2nd SB583 Rubio",37,0,0,3,40
1978817,1562878,2025-04-30,Senate,"Do pass, but first be re-referred to the Committee on [Appropriations]",6,0,0,1,7
1978819,1542909,2025-04-08,Senate,"Do pass, but first be re-referred to the Committee on [Natural Resources and Water]",14,0,0,1,15
1978819,1554534,2025-04-22,Senate,"Do pass as amended, but first amend, and re-refer to the Committee on [Appropriations]",6,0,0,1,7
1978823,1542923,2025-04-09,Senate,"Do pass, but first be re-referred to the Committee on [Appropriations]",5,0,0,0,5
1978823,1552852,2025-04-21,Senate,"Placed on suspense file",6,0,0,1,7
1978824,1556114,2025-04-23,Senate,"Do pass, but first be re-referred to the Committee on [Appropriations]",5,0,0,0,5
1978824,1565277,2025-05-05,Senate,"Placed on suspense file",7,0,0,0,7
1978825,1555994,2025-04-23,Senate,"Do pass, but first be re-referred to the Committee on [Judiciary]",4,0,0,1,5
1978825,1565303,2025-05-05,Senate,"Placed on suspense file",7,0,0,0,7
1978826,1538888,2025-04-07,Senate,"Do pass as amended, but first amend, and re-refer to the Committee on [Judiciary]",13,3,0,1,17
1978827,1536794,2025-04-02,Senate,"Do pass, but first be re-referred to the Committee on [Appropriations]",5,0,0,3,8
1978828,1562865,2025-04-30,Senate,"Do pass, but first be re-referred to the Committee on [Appropriations] with the recommendation: To Consent Calendar",7,0,0,0,7
1978829,1557508,2025-04-23,Senate,"Do pass as amended, but first amend, and re-refer to the Committee on [Appropriations]",8,2,0,1,11
1978830,1542782,2025-04-09,Senate,"Do pass, but first be re-referred to the Committee on [Judiciary]",5,0,0,0,5
1978830,1555918,2025-04-22,Senate,"Do pass, but first be re-referred to the Committee on [Appropriations] with the recommendation: To Consent Calendar",13,0,0,0,13
1978830,1565270,2025-05-05,Senate,"Placed on suspense file",7,0,0,0,7
1978831,1555895,2025-04-23,Senate,"Do pass, but first be re-referred to the Committee on [Appropriations] with the recommendation: To Consent Calendar",7,0,0,0,7
1978831,1568603,2025-05-08,Senate,"Consent Calendar 2nd SB598 Durazo",36,0,0,4,40
1978832,1554465,2025-04-22,Senate,"Do pass as amended, but first amend, and re-refer to the Committee on [Appropriations] with the recommendation: To Consent Calendar",6,0,0,1,7
1978832,1565285,2025-05-05,Senate,"Placed on suspense file",7,0,0,0,7
1978833,1542845,2025-04-09,Senate,"Do pass, but first be re-referred to the Committee on [Appropriations]",4,1,0,0,5
1978833,1552953,2025-04-21,Senate,"Placed on suspense file",6,0,0,1,7
1978834,1536774,2025-04-02,Senate,"Do pass as amended, but first amend, and re-refer to the Committee on [Judiciary]",5,3,0,0,8
1978834,1562780,2025-04-29,Senate,"Do pass as amended, but first amend, and re-refer to the Committee on [Appropriations]",10,3,0,0,13
1978835,1552965,2025-04-21,Senate,"Do pass, but first be re-referred to the Committee on [Appropriations] with the recommendation: To Consent Calendar",11,0,0,0,11
1978835,1568677,2025-05-08,Senate,"Consent Calendar 2nd SB602 Cortese",36,0,0,4,40
1978838,1528301,2025-03-26,Senate,"Do pass, but first be re-referred to the Committee on [Appropriations]",4,1,0,0,5
1978838,1538958,2025-04-07,Senate,"Placed on suspense file",7,0,0,0,7
1978839,1552892,2025-04-21,Senate,"Do pass as amended, but first amend, and re-refer to the Committee on [Housing]",5,0,0,0,5
1978839,1562818,2025-04-29,Senate,"Do pass, but first be re-referred to the Committee on [Appropriations]",11,0,0,0,11
1978840,1555897,2025-04-23,Senate,"Do pass, but first be re-referred to the Committee on [Local Government]",6,0,0,2,8
1978840,1562924,2025-04-30,Senate,"Do pass as amended, but first amend, and re-refer to the Committee on [Appropriations]",5,1,0,1,7
1978841,1535035,2025-04-02,Senate,"Do pass, but first be re-referred to the Committee on [Health]",5,2,0,0,7
1978841,1545028,2025-04-09,Senate,"Do pass, but first be re-referred to the Committee on [Appropriations]",8,0,0,3,11
1978841,1559437,2025-04-28,Senate,"Placed on suspense file",7,0,0,0,7
1978842,1526885,2025-03-25,Senate,"Do pass as amended, but first amend, and re-refer to the Committee on [Judiciary] with the recommendation: To Consent Calendar",7,0,0,0,7
1978842,1542935,2025-04-08,Senate,"Do pass, but first be re-referred to the Committee on [Appropriations] with the recommendation: To Consent Calendar",13,0,0,0,13
1978842,1552828,2025-04-21,Senate,"Placed on suspense file",6,0,0,1,7
1978843,1562767,2025-04-29,Senate,"Do pass, but first be re-referred to the Committee on [Appropriations]",11,1,0,1,13
1978844,1536764,2025-04-02,Senate,"Do pass as amended, but first amend, and re-refer to the Committee on [Judiciary]",7,0,0,0,7
1978844,1567899,2025-05-06,Senate,"Do pass",12,0,0,1,13
1978845,1562812,2025-04-30,Senate,"Do pass, but first be re-referred to the Committee on [Appropriations]",2,5,0,0,7
1978845,1562813,2025-04-30,Senate,"[First] hearing set for [04-30-2025]: Failed passage in Committee. Reconsideration granted",7,0,0,0,7
1978846,1536799,2025-04-02,Senate,"Do pass, but first be re-referred to the Committee on [Energy, Utilities and Communications]",6,1,0,1,8
1978846,1554557,2025-04-21,Senate,"Do pass as amended, but first amend, and re-refer to the Committee on [Appropriations]",13,3,0,1,17
1978846,1554558,2025-04-21,Senate,"[04-22-2025] set for [First] hearing: Reconsideration of favorable vote granted",17,0,0,0,17
1978846,1554559,2025-04-21,Senate,"Do pass as amended, but first amend, and re-refer to the Committee on [Appropriations]",15,0,0,2,17
1978847,1554446,2025-04-22,Senate,"Do pass as amended, but first amend, and re-refer to the Committee on [Environmental Quality]",11,2,0,2,15
1978847,1562957,2025-04-30,Senate,"Do pass as amended, but first amend, and re-refer to the Committee on [Appropriations]",7,0,0,1,8
1978848,1536770,2025-04-02,Senate,"Do pass as amended, but first amend, and re-refer to the Committee on [Transportation]",6,0,0,2,8
1978848,1554593,2025-04-22,Senate,"Do pass, but first be re-referred to the Committee on [Appropriations]",11,2,0,2,15
1978848,1565313,2025-05-05,Senate,"Placed on suspense file",7,0,0,0,7
1978849,1542902,2025-04-09,Senate,"Do pass, but first be re-referred to the Committee on [Judiciary]",7,0,0,0,7
1978849,1556069,2025-04-22,Senate,"Do pass, but first be re-referred to the Committee on [Appropriations] with the recommendation: To Consent Calendar",13,0,0,0,13
1978849,1565366,2025-05-05,Senate,"Placed on suspense file",7,0,0,0,7
1978850,1563013,2025-04-30,Senate,"Do pass, but first be re-referred to the Committee on [Appropriations]",5,0,0,0,5
1978851,1563036,2025-04-29,Senate,"Do pass as amended, but first amend, and re-refer to the Committee on [Appropriations]",14,2,0,1,17
1978852,1542874,2025-04-09,Senate,"Do pass, but first be re-referred to the Committee on [Appropriations] with the recommendation: To Consent Calendar",7,0,0,0,7
1978852,1557556,2025-04-24,Senate,"Consent Calendar 2nd SB619 ED. (Pérez)",37,0,0,3,40
1978854,1559432,2025-04-28,Senate,"Do pass, but first be re-referred to the Committee on [Elections and Constitutional Amendments] with the recommendation: To Consent Calendar",4,0,0,1,5
1978854,1561177,2025-04-29,Senate,"Do pass and be ordered to the Consent Calendar",5,0,0,0,5
1978854,1565328,2025-05-05,Senate,"Consent Calendar 2nd SB621 Grove",38,0,0,2,40
1978857,1540825,2025-04-07,Senate,"Do pass, but first be re-referred to the Committee on [Appropriations] with the recommendation: To Consent Calendar",5,0,0,0,5
1978857,1552908,2025-04-21,Senate,"Placed on suspense file",6,0,0,1,7
1978858,1556173,2025-04-22,Senate,"Do pass, but first be re-referred to the Committee on [Judiciary]",11,0,0,0,11
1978858,1562989,2025-04-29,Senate,"Do pass, but first be re-referred to the Committee on [Appropriations]",13,0,0,0,13
1978859,1564150,2025-04-30,Senate,"Do pass as amended, but first amend, and re-refer to the Committee on [Appropriations]",11,0,0,0,11
1978860,1536780,2025-04-02,Senate,"Do pass, but first be re-referred to the Committee on [Housing] with the recommendation: To Consent Calendar",7,0,0,0,7
1978860,1562935,2025-04-29,Senate,"Do pass and be ordered to the Consent Calendar",11,0,0,0,11
1978860,1568669,2025-05-08,Senate,"Consent Calendar 2nd SB627 McGuire",36,0,0,4,40
1978861,1556041,2025-04-23,Senate,"Do pass, but first be re-referred to the Committee on [Appropriations]",1,4,0,0,5
1978861,1556042,2025-04-23,Senate,"[First] hearing set for [04-23-2025]: Failed passage in Committee. Reconsideration granted",5,0,0,0,5
1978862,1554610,2025-04-22,Senate,"Do pass, but first be re-referred to the Committee on [Local Government]",11,1,0,3,15
1978862,1563045,2025-04-30,Senate,"Do pass as amended, but first amend, and re-refer to the Committee on [Appropriations]",5,0,0,2,7
1978863,1555966,2025-04-23,Senate,"Do pass, but first be re-referred to the Committee on [Appropriations]",5,0,0,0,5
1978863,1565247,2025-05-05,Senate,"Placed on suspense file",7,0,0,0,7
1978864,1562830,2025-04-30,Senate,"Do pass, but first be re-referred to the Committee on [Appropriations] with the recommendation: To Consent Calendar",7,0,0,0,7
1978865,1542857,2025-04-09,Senate,"Do pass as amended, but first amend, and re-refer to the Committee on [Appropriations]",4,1,0,0,5
1978865,1559456,2025-04-28,Senate,"Placed on suspense file",7,0,0,0,7
1978866,1536804,2025-04-02,Senate,"Do pass as amended, but first amend, and re-refer to the Committee on [Appropriations]",6,1,0,1,8
1978866,1552930,2025-04-21,Senate,"Placed on suspense file",6,0,0,1,7
1978867,1555945,2025-04-23,Senate,"Do pass, but first be re-referred to the Committee on [Judiciary]",4,2,0,1,7
1978868,1536834,2025-04-02,Senate,"Do pass as amended, but first amend, and re-refer to the Committee on [Public Safety]",5,2,0,0,7
1978868,1563107,2025-04-29,Senate,"Do pass as amended, but first amend, and re-refer to the Committee on [Appropriations]",5,1,0,0,6
1978869,1538879,2025-04-07,Senate,"Do pass as amended, but first amend, and re-refer to the Committee on [Appropriations]",13,3,0,1,17
1978869,1559463,2025-04-28,Senate,"Placed on suspense file",7,0,0,0,7
1978871,1562809,2025-04-30,Senate,"Do pass, but first be re-referred to the Committee on [Appropriations]",7,0,0,0,7
1978872,1540857,2025-04-08,Senate,"Do pass, but first be re-referred to the Committee on [Local Government]",6,0,0,1,7
1978872,1563006,2025-04-30,Senate,"Do pass, but first be re-referred to the Committee on [Appropriations] with the recommendation: To Consent Calendar",7,0,0,0,7
1978873,1563101,2025-04-30,Senate,"Do pass as amended, but first amend, and re-refer to the Committee on [Appropriations]",7,0,0,0,7
1978874,1538882,2025-04-07,Senate,"Do pass as amended, but first amend, and re-refer to the Committee on [Public Safety]",10,0,0,1,11
1978874,1562930,2025-04-29,Senate,"Do pass, but first be re-referred to the Committee on [Appropriations] with the recommendation: To Consent Calendar",6,0,0,0,6
1978875,1556095,2025-04-23,Senate,"Do pass, but first be re-referred to the Committee on [Judiciary]",4,1,0,0,5
1978875,1562852,2025-04-29,Senate,"Do pass as amended, but first amend, and re-refer to the Committee on [Appropriations]",11,2,0,0,13
1978876,1562847,2025-04-30,Senate,"Do pass as amended, but first amend, and re-refer to the Committee on [Appropriations]",7,0,0,1,8
1978877,1561087,2025-04-29,Senate,"Do pass, but first be re-referred to the Committee on [Education]",4,1,0,0,5
1978877,1562845,2025-04-30,Senate,"Do pass as amended, but first amend, and re-refer to the Committee on [Appropriations]",6,1,0,0,7
1978878,1542822,2025-04-08,Senate,"Do pass, but first be re-referred to the Committee on [Appropriations]",11,0,0,2,13
1978879,1535019,2025-04-02,Senate,"Do pass, but first be re-referred to the Committee on [Environmental Quality]",11,0,0,0,11
1978879,1562990,2025-04-30,Senate,"Do pass, but first be re-referred to the Committee on [Appropriations]",8,0,0,0,8
1978880,1562870,2025-04-29,Senate,"Do pass as amended, but first amend, and re-refer to the Committee on [Appropriations]",13,1,0,3,17
1978881,1542765,2025-04-09,Senate,"Do pass, but first be re-referred to the Committee on [Judiciary]",5,0,0,0,5
1978881,1556136,2025-04-22,Senate,"Do pass, but first be re-referred to the Committee on [Appropriations] with the recommendation: To Consent Calendar",13,0,0,0,13
1978881,1565248,2025-05-05,Senate,"Placed on suspense file",7,0,0,0,7
1978883,1540826,2025-04-08,Senate,"Do pass as amended, but first amend, and re-refer to the Committee on [Judiciary] with the recommendation: To Consent Calendar",6,0,0,1,7
1978883,1562925,2025-04-29,Senate,"Do pass, but first be re-referred to the Committee on [Appropriations] with the recommendation: To Consent Calendar",13,0,0,0,13
1978885,1552964,2025-04-21,Senate,"Do pass, but first be re-referred to the Committee on [Appropriations] with the recommendation: To Consent Calendar",11,0,0,0,11
1978885,1568623,2025-05-08,Senate,"Consent Calendar 2nd SB652 Richardson",36,0,0,4,40
1978886,1554535,2025-04-22,Senate,"Do pass, but first be re-referred to the Committee on [Appropriations]",5,0,0,2,7
1978886,1565350,2025-05-05,Senate,"Placed on suspense file",7,0,0,0,7
1978887,1536791,2025-04-02,Senate,"Do pass, but first be re-referred to the Committee on [Appropriations]",6,0,0,2,8
1978887,1552850,2025-04-21,Senate,"Placed on suspense file",6,0,0,1,7
1978888,1562939,2025-04-29,Senate,"Do pass, but first be re-referred to the Committee on [Appropriations]",10,0,0,1,11
1978889,1554637,2025-04-22,Senate,"Do pass, but first be re-referred to the Committee on [Business, Professions and Economic Development]",12,0,0,3,15
1978889,1559422,2025-04-28,Senate,"Do pass, but first be re-referred to the Committee on [Appropriations]",11,0,0,0,11
1978891,1556007,2025-04-22,Senate,"Do pass, but first be re-referred to the Committee on [Local Government]",13,0,0,0,13
1978891,1563081,2025-04-30,Senate,"Do pass, but first be re-referred to the Committee on [Appropriations] with the recommendation: To Consent Calendar",7,0,0,0,7
1978892,1556193,2025-04-22,Senate,"Do pass, but first be re-referred to the Committee on [Appropriations]",12,1,0,0,13
1978892,1565354,2025-05-05,Senate,"Placed on suspense file",7,0,0,0,7
1978893,1564280,2025-04-30,Senate,"Do pass, but first be re-referred to the Committee on [Appropriations]",7,0,0,4,11
1978894,1554478,2025-04-22,Senate,"Do pass, but first be re-referred to the Committee on [Revenue and Taxation]",14,0,0,1,15
1978894,1556119,2025-04-23,Senate,"Do pass, but first be re-referred to the Committee on [Appropriations]",5,0,0,0,5
1978894,1565362,2025-05-05,Senate,"Placed on suspense file",7,0,0,0,7
1978895,1540873,2025-04-08,Senate,"Do pass, but first be re-referred to the Committee on [Appropriations] with the recommendation: To Consent Calendar",6,0,0,1,7
1978895,1552864,2025-04-21,Senate,"Placed on suspense file",6,0,0,1,7
1978896,1542865,2025-04-09,Senate,"Do pass, but first be re-referred to the Committee on [Appropriations]",5,0,0,0,5
1978896,1552914,2025-04-21,Senate,"Placed on suspense file",6,0,0,1,7
1978900,1554447,2025-04-21,Senate,"Do pass, but first be re-referred to the Committee on [Transportation]",12,4,0,1,17
1978901,1556191,2025-04-23,Senate,"Do pass as amended, but first amend, and re-refer to the Committee on [Appropriations]",4,0,0,1,5
1978901,1565249,2025-05-05,Senate,"Placed on suspense file",7,0,0,0,7
1978902,1545042,2025-04-09,Senate,"Do pass as amended, but first amend, and re-refer to the Committee on [Appropriations] with the recommendation: To Consent Calendar",11,0,0,0,11
1978902,1559384,2025-04-28,Senate,"Placed on suspense file",7,0,0,0,7
1978903,1556107,2025-04-23,Senate,"Do pass, but first be re-referred to the Committee on [Appropriations]",7,0,0,0,7
1978904,1542811,2025-04-08,Senate,"Do pass, but first be re-referred to the Committee on [Appropriations] with the recommendation: To Consent Calendar",15,0,0,0,15
1978904,1557511,2025-04-24,Senate,"Consent Calendar 2nd SB671 Cervantes",37,0,0,3,40
1978906,1508041,2025-03-06,Senate,"Senate 3rd Reading SCR26 Weber Pierson By Senator Becker",34,0,0,5,39
1978906,1552952,2025-04-21,Assembly,"Be adopted. To Consent Calendar",10,0,0,1,11
1978906,1557539,2025-04-24,Assembly,"SCR 26 Weber Pierson Consent Calendar Second Day Regular Session",75,0,0,4,79
1980060,1557587,2025-04-23,Assembly,"Do pass and be re-referred to the Committee on [Education]",5,0,0,2,7
1980060,1564147,2025-04-30,Assembly,"Do pass as amended and be re-referred to the Committee on [Appropriations]",9,0,0,0,9
1980061,1542798,2025-04-09,Assembly,"Do pass as amended and be re-referred to the Committee on [Appropriations]",7,0,0,0,7
1980062,1563040,2025-04-30,Assembly,"Do pass and be re-referred to the Committee on [Appropriations]",9,1,0,2,12
1980063,1565276,2025-05-05,Assembly,"Do pass",9,0,0,0,9
1980064,1564282,2025-04-30,Assembly,"Do pass as amended and be re-referred to the Committee on [Appropriations]",13,0,0,5,18
1980066,1540821,2025-04-08,Assembly,"Do pass and be re-referred to the Committee on [Appropriations] with recommendation: To Consent Calendar",13,0,0,0,13
1980067,1526936,2025-03-25,Assembly,"Do pass. To Consent Calendar",12,0,0,0,12
1980067,1533576,2025-04-01,Assembly,"AB 1170 Dixon Consent Calendar Second Day Regular Session",76,0,0,4,80
1980069,1540805,2025-04-08,Assembly,"Do pass as amended and be re-referred to the Committee on [Judiciary]",6,0,0,0,6
1980069,1554493,2025-04-22,Assembly,"Do pass as amended, and be re-referred to the Committee on [Appropriations] with recommendation: To Consent Calendar",12,0,0,0,12
1980070,1564270,2025-04-30,Assembly,"Do pass as amended and be re-referred to the Committee on [Appropriations]",18,0,0,0,18
1980072,1540788,2025-04-08,Assembly,"Do pass as amended and be re-referred to the Committee on [Appropriations]",17,0,0,1,18
1980072,1556091,2025-04-23,Assembly,"Do pass",15,0,0,0,15
1980072,1565349,2025-05-05,Assembly,"AB 1175 Irwin Assembly Third Reading",77,0,0,2,79
1980074,1555890,2025-04-23,Assembly,"Do pass and be re-referred to the Committee on [Appropriations] with recommendation: To Consent Calendar",22,0,0,0,22
1980074,1567865,2025-05-07,Assembly,"Do pass. To Consent Calendar",15,0,0,0,15
1980075,1554550,2025-04-22,Assembly,"Do pass as amended and be re-referred to the Committee on [Appropriations]",9,0,0,0,9
1980075,1568675,2025-05-08,Assembly,"AB 1178 Pacheco Assembly Third Reading",60,2,0,17,79
1980077,1552940,2025-04-21,Assembly,"Do pass as amended and be re-referred to the Committee on [Appropriations]",9,0,0,0,9
1980078,1536783,2025-04-02,Assembly,"Do pass and be re-referred to the Committee on [Appropriations]",7,0,0,0,7
1980079,1556132,2025-04-23,Assembly,"Do pass and be re-referred to the Committee on [Appropriations] with recommendation: To Consent Calendar",18,0,0,0,18
1980083,1540917,2025-04-08,Assembly,"Do pass and be re-referred to the Committee on [Appropriations] with recommendation: To Consent Calendar",12,0,0,0,12
1980084,1542722,2025-04-08,Assembly,"Do pass as amended and be re-referred to the Committee on [Appropriations]",6,2,0,1,9
1980085,1562994,2025-04-30,Assembly,"Do pass as amended and be re-referred to the Committee on [Appropriations]",4,1,0,2,7
1980087,1561048,2025-04-28,Assembly,"Do pass and be re-referred to the Committee on [Appropriations]",15,0,0,1,16
1980089,1540911,2025-04-08,Assembly,"Do pass and be re-referred to the Committee on [Public Safety] with recommendation: To Consent Calendar",6,0,0,0,6
1980089,1562912,2025-04-29,Assembly,"Do pass and be re-referred to the Committee on [Appropriations] with recommendation: To Consent Calendar",9,0,0,0,9
1980092,1542693,2025-04-08,Assembly,"Do pass and be re-referred to the Committee on [Human Services] with recommendation: To Consent Calendar",9,0,0,0,9
1980092,1562892,2025-04-29,Assembly,"Do pass as amended, and be re-referred to the Committee on [Appropriations] with recommendation: To Consent Calendar",7,0,0,0,7
1980093,1563119,2025-04-29,Assembly,"Do pass as amended and be re-referred to the Committee on [Appropriations]",16,0,0,0,16
1980094,1561030,2025-04-29,Assembly,"Do pass and be re-referred to the Committee on [Privacy and Consumer Protection]",11,0,0,1,12
1980094,1566693,2025-05-06,Assembly,"Do pass as amended",14,0,0,1,15
1980095,1536848,2025-04-02,Assembly,"Do pass and be re-referred to the Committee on [Appropriations]",7,0,0,0,7
1980096,1563052,2025-04-29,Assembly,"Do pass as amended, and be re-referred to the Committee on [Appropriations] with recommendation: To Consent Calendar",16,0,0,0,16
1980097,1561022,2025-04-28,Assembly,"Do pass and be re-referred to the Committee on [Appropriations]",7,0,0,0,7
1980098,1526974,2025-03-25,Assembly,"Do pass as amended and be re-referred to the Committee on [Human Services]",9,3,0,0,12
1980098,1563059,2025-04-29,Assembly,"Do pass and be re-referred to the Committee on [Appropriations]",6,1,0,0,7
1980101,1564217,2025-04-30,Assembly,"Do pass as amended and be re-referred to the Committee on [Appropriations]",8,0,0,1,9
1980103,1528254,2025-03-26,Assembly,"Do pass as amended and be re-referred to the Committee on [Local Government]",11,0,0,0,11
1980103,1542863,2025-04-09,Assembly,"Do pass and be re-referred to the Committee on [Appropriations]",10,0,0,0,10
1980103,1556115,2025-04-23,Assembly,"Do pass",12,0,0,3,15
1980103,1568673,2025-05-08,Assembly,"AB 1206 Harabedian Assembly Third Reading",66,1,0,12,79
1980104,1559393,2025-04-28,Assembly,"Do pass and be re-referred to the Committee on [Appropriations]",11,0,0,3,14
1980104,1567859,2025-05-07,Assembly,"Do pass",11,0,0,4,15
1980105,1562792,2025-04-29,Assembly,"Do pass as amended and be re-referred to the Committee on [Appropriations]",7,0,0,0,7
1980106,1535130,2025-04-02,Assembly,"Do pass and be re-referred to the Committee on [Business and Professions]",15,2,0,0,17
1980107,1542853,2025-04-08,Assembly,"Do pass and be re-referred to the Committee on [Appropriations] with recommendation: To Consent Calendar",9,0,0,0,9
1980108,1540964,2025-04-08,Assembly,"Do pass and be re-referred to the Committee on [Appropriations]",5,1,0,0,6
1980109,1542908,2025-04-08,Assembly,"Do pass and be re-referred to the Committee on [Housing and Community Development]",8,1,0,1,10
1980110,1542887,2025-04-08,Assembly,"Do pass and be re-referred to the Committee on [Appropriations] with recommendation: To Consent Calendar",9,0,0,0,9
1980110,1555978,2025-04-23,Assembly,"Do pass. To Consent Calendar",15,0,0,0,15
1980110,1564276,2025-05-01,Assembly,"AB 1213 Stefani Consent Calendar Second Day Regular Session",76,0,0,3,79
1980111,1542891,2025-04-09,Assembly,"Do pass and be re-referred to the Committee on [Appropriations]",2,4,0,1,7
1980111,1542892,2025-04-09,Assembly,Reconsideration,7,0,0,0,7
1980111,1563130,2025-04-30,Assembly,"Do pass and be re-referred to the Committee on [Appropriations] with recommendation: To Consent Calendar",7,0,0,0,7
1980113,1529528,2025-03-26,Assembly,"Do pass and be re-referred to the Committee on [Appropriations] with recommendation: To Consent Calendar",9,0,0,0,9
1980113,1542871,2025-04-09,Assembly,"Do pass. To Consent Calendar",14,0,0,1,15
1980113,1557584,2025-04-24,Assembly,"AB 1216 Education Consent Calendar Second Day Regular Session",75,0,0,4,79
1980114,1542912,2025-04-08,Assembly,"Do pass as amended and be re-referred to the Committee on [Education]",8,0,0,2,10
1980114,1564284,2025-04-30,Assembly,"Do pass and be re-referred to the Committee on [Appropriations]",9,0,0,0,9
1980117,1563000,2025-04-29,Assembly,"Do pass and be re-referred to the Committee on [Appropriations]",7,0,0,0,7
1980118,1536781,2025-04-02,Assembly,"Do pass and be re-referred to the Committee on [Privacy and Consumer Protection]",5,0,0,2,7
1980118,1564281,2025-05-01,Assembly,"Do pass as amended and be re-referred to the Committee on [Appropriations]",10,1,0,4,15
1980119,1556151,2025-04-23,Assembly,"Do pass and be re-referred to the Committee on [Judiciary]",12,3,0,3,18
1980119,1561011,2025-04-29,Assembly,"Do pass and be re-referred to the Committee on [Appropriations]",9,3,0,0,12
1980120,1556113,2025-04-23,Assembly,"Do pass as amended and be re-referred to the Committee on [Transportation]",7,1,0,2,10
1980120,1561184,2025-04-28,Assembly,"Do pass as amended and be re-referred to the Committee on [Appropriations]",12,4,0,0,16
1980121,1529551,2025-03-26,Assembly,"Do pass and be re-referred to the Committee on [Appropriations]",9,0,0,0,9
1980121,1542793,2025-04-09,Assembly,"Do pass",14,0,0,1,15
1980121,1565293,2025-05-05,Assembly,"AB 1224 Valencia Assembly Third Reading",77,0,0,2,79
1980122,1562893,2025-04-29,Assembly,"Do pass as amended and be re-referred to the Committee on [Appropriations]",13,0,0,0,13
1980124,1559372,2025-04-28,Assembly,"Do pass as amended and be re-referred to the Committee on [Appropriations]",14,0,0,0,14
1980126,1528285,2025-03-26,Assembly,"Do pass and be re-referred to the Committee on [Public Safety]",8,0,0,3,11
1980126,1554488,2025-04-22,Assembly,"Do pass and be re-referred to the Committee on [Appropriations]",8,0,0,1,9
1980127,1544994,2025-04-09,Assembly,"Do pass as amended and be re-referred to the Committee on [Appropriations]",9,0,0,0,9
1980128,1542767,2025-04-08,Assembly,"Do pass as amended and be re-referred to the Committee on [Appropriations]",5,2,0,2,9
1980129,1554575,2025-04-22,Assembly,"Do pass and be re-referred to the Committee on [Judiciary] with recommendation: To Consent Calendar",8,0,0,0,8
1980129,1561073,2025-04-29,Assembly,"Do pass and be re-referred to the Committee on [Appropriations] with recommendation: To Consent Calendar",12,0,0,0,12
1980130,1555961,2025-04-23,Assembly,"Do pass and be re-referred to the Committee on [Education]",7,0,0,0,7
1980130,1564232,2025-04-30,Assembly,"Do pass as amended, and be re-referred to the Committee on [Appropriations] with recommendation: To Consent Calendar",9,0,0,0,9
1980131,1536756,2025-04-02,Assembly,"Do pass and be re-referred to the Committee on [Judiciary]",4,0,0,3,7
1980131,1554600,2025-04-22,Assembly,"Do pass as amended and be re-referred to the Committee on [Appropriations]",8,2,0,2,12
1980132,1536845,2025-04-02,Assembly,"Do pass and be re-referred to the Committee on [Higher Education]",7,0,0,0,7
1980132,1561067,2025-04-29,Assembly,"Do pass and be re-referred to the Committee on [Appropriations]",8,0,0,2,10
1980133,1556062,2025-04-23,Assembly,"Do pass and be re-referred to the Committee on [Appropriations]",17,0,0,0,17
1980134,1538978,2025-04-07,Assembly,"Do pass and be re-referred to the Committee on [Arts, Entertainment, Sports, and Tourism]",12,3,0,1,16
1980134,1554462,2025-04-22,Assembly,"Do pass as amended",6,1,0,2,9
1980136,1562749,2025-04-29,Assembly,"Do pass and be re-referred to the Committee on [Appropriations] with recommendation: To Consent Calendar",9,0,0,0,9
1980137,1526952,2025-03-25,Assembly,"Do pass and be re-referred to the Committee on [Appropriations]",9,1,0,2,12
1980139,1555948,2025-04-22,Assembly,"Do pass and be re-referred to the Committee on [Human Services]",16,0,0,0,16
1980139,1563055,2025-04-29,Assembly,"Do pass and be re-referred to the Committee on [Appropriations]",6,0,0,1,7
1980140,1558717,2025-04-21,Assembly,"Do pass and be re-referred to the Committee on [Judiciary]",9,4,0,1,14
1980141,1558707,2025-04-21,Assembly,"Do pass as amended and be re-referred to the Committee on [Housing and Community Development]",14,0,0,0,14
1980141,1562891,2025-04-30,Assembly,"Do pass and be re-referred to the Committee on [Appropriations]",9,0,0,3,12
1980143,1555920,2025-04-23,Assembly,"Do pass and be re-referred to the Committee on [Appropriations]",22,0,0,0,22
1980143,1567869,2025-05-07,Assembly,"Do pass",15,0,0,0,15
1980144,1535039,2025-04-02,Assembly,"Do pass and be re-referred to the Committee on [Higher Education]",5,0,0,2,7
1980144,1561072,2025-04-29,Assembly,"Do pass and be re-referred to the Committee on [Appropriations]",7,2,0,1,10
1980145,1554440,2025-04-22,Assembly,"Do pass",8,3,0,1,12
1980146,1542784,2025-04-09,Assembly,"Do pass as amended and be re-referred to the Committee on [Appropriations]",5,2,0,0,7
1980147,1561026,2025-04-28,Assembly,"Do pass and be re-referred to the Committee on [Appropriations] with recommendation: To Consent Calendar",16,0,0,0,16
1980148,1536801,2025-04-02,Assembly,"Do pass and be re-referred to the Committee on [Privacy and Consumer Protection]",7,0,0,0,7
1980150,1561144,2025-04-28,Assembly,"Do pass as amended and be re-referred to the Committee on [Appropriations]",7,0,0,0,7
1980151,1554432,2025-04-22,Assembly,"Do pass and be re-referred to the Committee on [Appropriations] with recommendation: To Consent Calendar",8,0,0,0,8
1980152,1564263,2025-04-30,Assembly,"Do pass as amended, and be re-referred to the Committee on [Appropriations] with recommendation: To Consent Calendar",9,0,0,0,9
1980155,1542714,2025-04-08,Assembly,"Do pass and be re-referred to the Committee on [Appropriations]",7,0,0,2,9
1980157,1556037,2025-04-23,Assembly,"Do pass as amended and be re-referred to the Committee on [Appropriations]",13,1,0,4,18
1980158,1554648,2025-04-22,Assembly,"Do pass as amended and be re-referred to the Committee on [Appropriations]",9,2,0,1,12
1980160,1542684,2025-04-08,Assembly,"Do pass and be re-referred to the Committee on [Judiciary]",7,0,0,2,9
1980160,1554524,2025-04-22,Assembly,"Do pass and be re-referred to the Committee on [Appropriations]",10,1,0,1,12
1980161,1545031,2025-04-09,Assembly,"Do pass as amended and be re-referred to the Committee on [Environmental Safety and Toxic Materials]",8,0,0,1,9
1980161,1561059,2025-04-29,Assembly,"Do pass and be re-referred to the Committee on [Appropriations]",6,0,0,1,7
1980162,1542700,2025-04-09,Assembly,"Do pass and be re-referred to the Committee on [Revenue and Taxation] with recommendation: To Consent Calendar",12,0,0,0,12
1980164,1555942,2025-04-22,Assembly,"Do pass as amended and be re-referred to the Committee on [Appropriations]",13,1,0,2,16
1980166,1542875,2025-04-08,Assembly,"Do pass and be re-referred to the Committee on [Appropriations]",7,0,0,2,9
1980168,1542831,2025-04-09,Assembly,"Do pass as amended and be re-referred to the Committee on [Business and Professions]",9,0,0,1,10
1980168,1561179,2025-04-29,Assembly,"Do pass as amended and be re-referred to the Committee on [Appropriations]",13,2,0,3,18
1980169,1538985,2025-04-07,Assembly,"Do pass and be re-referred to the Committee on [Appropriations] with recommendation: To Consent Calendar",16,0,0,0,16
1980170,1535106,2025-04-02,Assembly,"Do pass as amended, and be re-referred to the Committee on [Appropriations] with recommendation: To Consent Calendar",18,0,0,0,18
1980170,1562985,2025-04-30,Assembly,"Do pass. To Consent Calendar",14,0,0,1,15
1980170,1568634,2025-05-08,Assembly,"AB 1273 Patterson Consent Calendar Second Day Regular Session",69,0,0,10,79
1980172,1558365,2025-04-24,Assembly,"Do pass and be re-referred to the Committee on [Local Government] with recommendation: To Consent Calendar",11,0,0,1,12
1980172,1564305,2025-04-30,Assembly,"Do pass and be re-referred to the Committee on [Appropriations] with recommendation: To Consent Calendar",10,0,0,0,10
1980173,1542704,2025-04-09,Assembly,"Do pass and be re-referred to the Committee on [Local Government] with recommendation: To Consent Calendar",12,0,0,0,12
1980173,1564289,2025-04-30,Assembly,"Do pass and be re-referred to the Committee on [Appropriations] with recommendation: To Consent Calendar",10,0,0,0,10
1980176,1542794,2025-04-08,Assembly,"Do pass as amended and be re-referred to the Committee on [Appropriations]",5,1,0,3,9
1980177,1535120,2025-04-02,Assembly,"Do pass and be re-referred to the Committee on [Natural Resources]",17,0,0,1,18
1980177,1559424,2025-04-28,Assembly,"Do pass and be re-referred to the Committee on [Appropriations]",13,0,0,1,14
1980181,1540879,2025-04-07,Assembly,"Do pass and be re-referred to the Committee on [Appropriations]",7,0,0,0,7
1980182,1540802,2025-04-07,Assembly,"Do pass and be re-referred to the Committee on [Appropriations]",7,0,0,0,7
1980183,1542888,2025-04-09,Assembly,"Do pass as amended and be re-referred to the Committee on [Appropriations]",7,0,0,0,7
1980183,1562762,2025-04-30,Assembly,"Do pass",14,0,0,1,15
1980183,1565251,2025-05-05,Assembly,"AB 1286 Boerner Assembly Third Reading",77,0,0,2,79
1980184,1535005,2025-04-02,Assembly,"Do pass and be re-referred to the Committee on [Appropriations] with recommendation: To Consent Calendar",21,0,0,1,22
1980184,1555990,2025-04-23,Assembly,"Do pass. To Consent Calendar",15,0,0,0,15
1980184,1564288,2025-05-01,Assembly,"AB 1287 Fong Consent Calendar Second Day Regular Session",76,0,0,3,79
1980185,1556103,2025-04-22,Assembly,"Do pass and be re-referred to the Committee on [Appropriations] with recommendation: To Consent Calendar",16,0,0,0,16
1980188,1554644,2025-04-22,Assembly,"Do pass as amended and be re-referred to the Committee on [Privacy and Consumer Protection]",6,1,0,2,9
1980188,1564303,2025-05-01,Assembly,"Do pass and be re-referred to the Committee on [Appropriations]",8,3,0,4,15
1980190,1556196,2025-04-23,Assembly,"Do pass and be re-referred to the Committee on [Appropriations] with recommendation: To Consent Calendar",17,0,0,0,17
1980191,1542922,2025-04-09,Assembly,"Do pass and be re-referred to the Committee on [Local Government] with recommendation: To Consent Calendar",12,0,0,0,12
1980191,1564153,2025-04-30,Assembly,"Do pass and be re-referred to the Committee on [Appropriations]",10,0,0,0,10
1980192,1564176,2025-04-30,Assembly,"Do pass and be re-referred to the Committee on [Appropriations] with recommendation: To Consent Calendar",18,0,0,0,18
1980193,1558364,2025-04-24,Assembly,"Do pass and be re-referred to the Committee on [Education]",10,0,0,2,12
1980193,1564196,2025-04-30,Assembly,"Do pass and be re-referred to the Committee on [Appropriations]",9,0,0,0,9
1980194,1527000,2025-03-25,Assembly,"Do pass. To Consent Calendar",12,0,0,0,12
1980194,1533463,2025-04-01,Assembly,"AB 1297 Stefani Consent Calendar Second Day Regular Session",76,0,0,4,80
1980196,1538974,2025-04-07,Assembly,"Do pass and be re-referred to the Committee on [Appropriations] with recommendation: To Consent Calendar",16,0,0,0,16
1980198,1567888,2025-05-07,Assembly,"Do pass. To Consent Calendar",15,0,0,3,18
1980200,1542820,2025-04-09,Assembly,"Do pass and be re-referred to the Committee on [Judiciary]",8,2,0,0,10
1980200,1561154,2025-04-29,Assembly,"Do pass as amended and be re-referred to the Committee on [Appropriations]",8,3,0,1,12
1980201,1558732,2025-04-21,Assembly,"Do pass and be re-referred to the Committee on [Appropriations]",13,1,0,0,14
1980202,1558724,2025-04-21,Assembly,"Do pass as amended and be re-referred to the Committee on [Appropriations]",9,4,0,1,14
1980203,1545013,2025-04-09,Assembly,"Do pass as amended, and be re-referred to the Committee on [Appropriations] with recommendation: To Consent Calendar",9,0,0,0,9
1980203,1563078,2025-04-30,Assembly,"Do pass. To Consent Calendar",14,0,0,1,15
1980203,1568652,2025-05-08,Assembly,"AB 1306 Muratsuchi Consent Calendar Second Day Regular Session",69,0,0,10,79
1980204,1533522,2025-04-01,Assembly,"Do pass as amended and be re-referred to the Committee on [Appropriations]",17,0,0,1,18
1980205,1556194,2025-04-23,Assembly,"Do pass as amended and be re-referred to the Committee on [Housing and Community Development]",10,0,0,0,10
1980205,1562962,2025-04-30,Assembly,"Do pass and be re-referred to the Committee on [Appropriations] with recommendation: To Consent Calendar",10,0,0,2,12
1980206,1535146,2025-04-02,Assembly,"Do pass and be re-referred to the Committee on [Appropriations]",7,0,0,0,7
1980208,1559370,2025-04-28,Assembly,"Do pass and be re-referred to the Committee on [Appropriations] with recommendation: To Consent Calendar",14,0,0,0,14
1980209,1563038,2025-04-29,Assembly,"Do pass as amended and be re-referred to the Committee on [Appropriations]",12,3,0,1,16
1980210,1561064,2025-04-29,Assembly,"Do pass and be re-referred to the Committee on [Appropriations]",5,2,0,0,7
1980211,1540792,2025-04-08,Assembly,"Do pass and be re-referred to the Committee on [Appropriations] with recommendation: To Consent Calendar",6,0,0,0,6
1980213,1563037,2025-04-29,Assembly,"Do pass and be re-referred to the Committee on [Appropriations]",8,3,0,2,13
1980215,1563127,2025-04-29,Assembly,"Do pass as amended and be re-referred to the Committee on [Appropriations]",5,2,0,0,7
1980216,1562932,2025-04-29,Assembly,"Do pass as amended and be re-referred to the Committee on [Appropriations]",8,3,0,2,13
1980217,1562758,2025-04-29,Assembly,"Do pass and be re-referred to the Committee on [Appropriations]",4,3,0,9,16
1980217,1562759,2025-04-29,Assembly,Reconsideration,16,0,0,0,16
1980219,1562948,2025-04-30,Assembly,"Do pass and be re-referred to the Committee on [Appropriations] with recommendation: To Consent Calendar",8,0,0,0,8
1980221,1562752,2025-04-29,Assembly,"Do pass and be re-referred to the Committee on [Appropriations]",5,2,0,0,7
1980223,1563053,2025-04-29,Assembly,"Do pass",14,2,0,0,16
1980223,1568604,2025-05-08,Assembly,"AB 1326 Ahrens Assembly Third Reading",58,2,0,19,79
1980224,1535041,2025-04-01,Assembly,"Do pass as amended and be re-referred to the Committee on [Judiciary]",14,0,0,1,15
1980224,1554647,2025-04-22,Assembly,"Do pass and be re-referred to the Committee on [Appropriations] with recommendation: To Consent Calendar",12,0,0,0,12
1980224,1562899,2025-04-30,Assembly,"Do pass. To Consent Calendar",14,0,0,1,15
1980224,1568624,2025-05-08,Assembly,"AB 1327 Aguiar-Curry Consent Calendar Second Day Regular Session",69,0,0,10,79
1980225,1555893,2025-04-22,Assembly,"Do pass as amended and be re-referred to the Committee on [Appropriations]",16,0,0,0,16
1980226,1555928,2025-04-23,Assembly,"Do pass and be re-referred to the Committee on [Appropriations]",14,0,0,3,17
1980228,1536761,2025-04-02,Assembly,"Do pass and be re-referred to the Committee on [Privacy and Consumer Protection]",5,0,0,2,7
1980228,1555999,2025-04-22,Assembly,"Do pass as amended and be re-referred to the Committee on [Judiciary]",10,3,0,2,15
1980229,1561017,2025-04-29,Assembly,"Do pass and be re-referred to the Committee on [Appropriations]",17,0,0,1,18
1980231,1567900,2025-05-07,Assembly,"Do pass as amended. To Consent Calendar",15,0,0,3,18
1980232,1564267,2025-05-01,Assembly,"Do pass and be re-referred to the Committee on [Appropriations]",2,1,0,4,7
1980232,1564268,2025-05-01,Assembly,Reconsideration,0,2,0,5,7
1980233,1556036,2025-04-23,Assembly,"Do pass and be re-referred to the Committee on [Appropriations]",12,4,0,1,17
1980234,1534997,2025-04-01,Assembly,"Do pass as amended and be re-referred to the Committee on [Appropriations]",12,0,0,3,15
1980235,1542744,2025-04-08,Assembly,"Do pass and be re-referred to the Committee on [Appropriations]",7,0,0,0,7
1980235,1555923,2025-04-23,Assembly,"Do pass",15,0,0,0,15
1980236,1562788,2025-04-30,Assembly,"Do pass as amended and be re-referred to the Committee on [Appropriations]",16,0,0,1,17
1980237,1557585,2025-04-23,Assembly,"Do pass and be re-referred to the Committee on [Appropriations]",5,0,0,2,7
1980238,1554602,2025-04-22,Assembly,"Do pass as amended and be re-referred to the Committee on [Appropriations]",18,0,0,0,18
1980238,1562936,2025-04-30,Assembly,"Do pass",14,0,0,1,15
1980239,1564151,2025-04-30,Assembly,"Do pass and be re-referred to the Committee on [Appropriations] with recommendation: To Consent Calendar",18,0,0,0,18
1980240,1561156,2025-04-28,Assembly,"Do pass and be re-referred to the Committee on [Appropriations] with recommendation: To Consent Calendar",16,0,0,0,16
1980241,1542810,2025-04-08,Assembly,"Do pass and be re-referred to the Committee on [Appropriations]",8,0,0,1,9
1980243,1542903,2025-04-08,Assembly,"Do pass and be re-referred to the Committee on [Military and Veterans Affairs]",9,0,0,1,10
1980243,1561151,2025-04-29,Assembly,"Do pass and be re-referred to the Committee on [Appropriations]",8,0,0,0,8
1980243,1563043,2025-04-29,Assembly,"Do pass and be re-referred to the Committee on [Appropriations] with recommendation: To Consent Calendar",8,0,0,0,8
1980244,1554532,2025-04-22,Assembly,"Do pass and be re-referred to the Committee on [Utilities and Energy]",7,0,0,1,8
1980245,1564256,2025-04-30,Assembly,"Do pass as amended and be re-referred to the Committee on [Appropriations]",7,2,0,0,9
1980246,1540844,2025-04-08,Assembly,"Do pass as amended and be re-referred to the Committee on [Privacy and Consumer Protection]",7,0,0,2,9
1980246,1556008,2025-04-22,Assembly,"Do pass as amended and be re-referred to the Committee on [Judiciary]",11,1,0,3,15
1980246,1564200,2025-05-01,Assembly,"Do pass as amended and be re-referred to the Committee on [Appropriations]",10,0,0,2,12
1980252,1555986,2025-04-22,Assembly,"Do pass and be re-referred to the Committee on [Judiciary]",9,3,0,3,15
1980252,1561126,2025-04-29,Assembly,"Do pass as amended and be re-referred to the Committee on [Appropriations]",7,3,0,2,12
1980253,1556044,2025-04-22,Assembly,"Do pass as amended and be re-referred to the Committee on [Appropriations]",16,0,0,0,16
1980254,1562963,2025-04-29,Assembly,"Do pass as amended and be re-referred to the Committee on [Appropriations]",5,2,0,0,7
1980255,1538984,2025-04-07,Assembly,"Do pass and be re-referred to the Committee on [Appropriations]",9,4,0,1,14
1980258,1542730,2025-04-08,Assembly,"Do pass as amended, and be re-referred to the Committee on [Appropriations] with recommendation: To Consent Calendar",10,0,0,0,10
1980259,1557543,2025-04-23,Assembly,"Do pass and be re-referred to the Committee on [Appropriations]",5,0,0,2,7
1980260,1554503,2025-04-22,Assembly,"Do pass as amended, and be re-referred to the Committee on [Appropriations] with recommendation: To Consent Calendar",12,0,0,0,12
1980262,1552874,2025-04-21,Assembly,"Do pass and be re-referred to the Committee on [Labor and Employment]",7,2,0,0,9
1980262,1557579,2025-04-23,Assembly,"Do pass as amended and be re-referred to the Committee on [Appropriations]",5,1,0,1,7
1980266,1545019,2025-04-09,Assembly,"Do pass and be re-referred to the Committee on [Judiciary] with recommendation: To Consent Calendar",9,0,0,0,9
1980266,1566687,2025-05-06,Assembly,"Do pass. To Consent Calendar",12,0,0,0,12
1980267,1542824,2025-04-09,Assembly,"Do pass as amended and be re-referred to the Committee on [Judiciary]",7,0,0,0,7
1980267,1554436,2025-04-22,Assembly,"Do pass and be re-referred to the Committee on [Appropriations] with recommendation: To Consent Calendar",12,0,0,0,12
1980270,1561085,2025-04-29,Assembly,"Do pass and be re-referred to the Committee on [Appropriations]",7,0,0,0,7
1980271,1566696,2025-05-06,Assembly,"Do pass as amended",13,0,0,2,15
1980272,1561054,2025-04-29,Assembly,"Do pass as amended",11,0,0,1,12
1980273,1563126,2025-04-29,Assembly,"Do pass as amended",5,1,0,3,9
1980274,1554499,2025-04-22,Assembly,"Do pass and be re-referred to the Committee on [Revenue and Taxation]",7,0,0,2,9
1980274,1566736,2025-05-05,Assembly,"Do pass and be re-referred to the Committee on [Appropriations]",5,1,0,1,7
1980275,1540877,2025-04-08,Assembly,"Do pass and be re-referred to the Committee on [Judiciary] with recommendation: To Consent Calendar",6,0,0,0,6
1980275,1554470,2025-04-22,Assembly,"Do pass and be re-referred to the Committee on [Appropriations] with recommendation: To Consent Calendar",12,0,0,0,12
1980277,1558719,2025-04-21,Assembly,"Do pass and be re-referred to the Committee on [Public Safety]",9,4,0,1,14
1980277,1562883,2025-04-29,Assembly,"Do pass and be re-referred to the Committee on [Appropriations]",8,0,0,1,9
1980278,1564249,2025-04-30,Assembly,"Do pass as amended, and be re-referred to the Committee on [Appropriations] with recommendation: To Consent Calendar",9,0,0,0,9
1980280,1555892,2025-04-23,Assembly,"Do pass and be re-referred to the Committee on [Appropriations]",7,0,0,0,7
1980281,1540935,2025-04-08,Assembly,"Do pass. To Consent Calendar",12,0,0,0,12
1980281,1552920,2025-04-21,Assembly,"AB 1384 Nguyen Consent Calendar Second Day Regular Session",73,0,0,6,79
1980282,1540830,2025-04-08,Assembly,"Do pass as amended and be re-referred to the Committee on [Appropriations]",10,2,0,0,12
1980283,1562843,2025-04-29,Assembly,"Do pass and be re-referred to the Committee on [Appropriations]",13,1,0,2,16
1980284,1542724,2025-04-08,Assembly,"Do pass and be re-referred to the Committee on [Privacy and Consumer Protection] with recommendation: To Consent Calendar",9,0,0,0,9
1980284,1564202,2025-05-01,Assembly,"Do pass and be re-referred to the Committee on [Appropriations] with recommendation: To Consent Calendar",13,0,0,2,15
1980285,1562895,2025-04-29,Assembly,"Do pass and be re-referred to the Committee on [Appropriations]",7,1,0,1,9
1980286,1535077,2025-04-02,Assembly,"Do pass. To Consent Calendar",21,0,0,1,22
1980286,1544988,2025-04-10,Assembly,"AB 1389 Blanca Rubio Consent Calendar Second Day",67,0,0,12,79
1980287,1529520,2025-03-26,Assembly,"Do pass",7,0,0,2,9
1980288,1564274,2025-04-30,Assembly,"Do pass and be re-referred to the Committee on [Appropriations]",8,0,0,1,9
1980289,1536819,2025-04-02,Assembly,"Do pass. To Consent Calendar",7,0,0,0,7
1980289,1544954,2025-04-10,Assembly,"AB 1392 Flora Consent Calendar Second Day Regular Session",67,0,0,12,79
1980290,1535044,2025-04-02,Assembly,"Do pass. To Consent Calendar",21,0,0,1,22
1980290,1544979,2025-04-10,Assembly,"AB 1393 Blanca Rubio Consent Calendar Second Day Regular Session",67,0,0,12,79
1980292,1559488,2025-04-28,Assembly,"Do pass and be re-referred to the Committee on [Appropriations] with recommendation: To Consent Calendar",14,0,0,0,14
1980293,1554513,2025-04-22,Assembly,"Do pass as amended and be re-referred to the Committee on [Appropriations]",9,0,0,0,9
1980295,1556040,2025-04-23,Assembly,"Do pass as amended, and be re-referred to the Committee on [Appropriations] with recommendation: To Consent Calendar",17,0,0,0,17
1980297,1561122,2025-04-29,Assembly,"Do pass and be re-referred to the Committee on [Appropriations]",10,0,0,0,10
1980298,1545047,2025-04-09,Assembly,"Do pass and be re-referred to the Committee on [Privacy and Consumer Protection]",2,5,0,2,9
1980302,1534994,2025-04-01,Assembly,"Do pass as amended and be re-referred to the Committee on [Appropriations]",11,1,0,3,15
1980305,1564287,2025-04-30,Assembly,"Do pass as amended, and be re-referred to the Committee on [Appropriations] with recommendation: To Consent Calendar",18,0,0,0,18
1980307,1556160,2025-04-23,Assembly,"Do pass and be re-referred to the Committee on [Appropriations]",18,0,0,0,18
1980308,1542848,2025-04-09,Assembly,"Do pass and be re-referred to the Committee on [Appropriations]",5,0,0,2,7
1980309,1545036,2025-04-09,Assembly,"Do pass as amended and be re-referred to the Committee on [Military and Veterans Affairs]",9,0,0,0,9
1980309,1561007,2025-04-29,Assembly,"Do pass and be re-referred to the Committee on [Appropriations]",8,0,0,0,8
1980310,1540991,2025-04-08,Assembly,"Do pass as amended and be re-referred to the Committee on [Judiciary]",9,4,0,0,13
1980310,1561138,2025-04-29,Assembly,"Do pass and be re-referred to the Committee on [Appropriations]",8,3,0,1,12
1980311,1540949,2025-04-08,Assembly,"Do pass",12,0,0,0,12
1980311,1552855,2025-04-21,Assembly,"AB 1414 Ransom Assembly Third Reading",75,0,0,4,79
1980312,1556079,2025-04-22,Assembly,"Do pass as amended and be re-referred to the Committee on [Appropriations]",11,3,0,2,16
1980312,1567864,2025-05-07,Assembly,"Do pass",11,4,0,0,15
1980313,1566715,2025-05-05,Assembly,"Do pass",7,0,0,0,7
1980314,1558728,2025-04-21,Assembly,"Do pass as amended and be re-referred to the Committee on [Utilities and Energy]",10,4,0,0,14
1980314,1564191,2025-04-30,Assembly,"Do pass as amended and be re-referred to the Committee on [Appropriations]",17,0,0,1,18
1980315,1540952,2025-04-08,Assembly,"Do pass and be re-referred to the Committee on [Appropriations]",14,0,0,1,15
1980316,1556170,2025-04-22,Assembly,"Do pass as amended, and be re-referred to the Committee on [Appropriations] with recommendation: To Consent Calendar",16,0,0,0,16
1980317,1556031,2025-04-23,Assembly,"Do pass and be re-referred to the Committee on [Appropriations]",21,0,0,1,22
1980320,1554438,2025-04-21,Assembly,"Do pass and be re-referred to the Committee on [Utilities and Energy]",14,1,0,1,16
1980320,1564304,2025-04-30,Assembly,"Do pass and be re-referred to the Committee on [Appropriations]",18,0,0,0,18
1980321,1542738,2025-04-08,Assembly,"Do pass and be re-referred to the Committee on [Labor and Employment]",6,2,0,1,9
1980321,1557496,2025-04-23,Assembly,"Do pass and be re-referred to the Committee on [Appropriations]",5,1,0,1,7
1980322,1559375,2025-04-28,Assembly,"Do pass and be re-referred to the Committee on [Appropriations]",1,4,0,9,14
1980323,1540893,2025-04-08,Assembly,"Do pass as amended and be re-referred to the Committee on [Natural Resources]",10,2,0,1,13
1980323,1559411,2025-04-28,Assembly,"Do pass and be re-referred to the Committee on [Appropriations]",12,1,0,1,14
1980324,1566689,2025-05-06,Assembly,"Do pass as amended and be re-referred to the Committee on [Appropriations]",11,0,0,1,12
1980326,1563125,2025-04-29,Assembly,"Do pass as amended and be re-referred to the Committee on [Appropriations]",12,1,0,3,16
1980327,1564292,2025-04-30,Assembly,"Do pass and be re-referred to the Committee on [Appropriations]",8,0,0,2,10
1980330,1542918,2025-04-08,Assembly,"Do pass and be re-referred to the Committee on [Military and Veterans Affairs]",9,0,0,1,10
1980330,1561062,2025-04-29,Assembly,"Do pass and be re-referred to the Committee on [Appropriations]",8,0,0,0,8
1980333,1567921,2025-05-07,Assembly,"Do pass. To Consent Calendar",15,0,0,3,18
1980335,1529536,2025-03-26,Assembly,"Do pass as amended and be re-referred to the Committee on [Appropriations]",9,0,0,0,9
1980335,1555912,2025-04-23,Assembly,"Do pass",15,0,0,0,15
1980335,1565323,2025-05-05,Assembly,"AB 1438 Gallagher Third Reading Urgency",72,0,0,7,79
1980337,1528306,2025-03-25,Assembly,"Do pass and be re-referred to the Committee on [Appropriations] with recommendation: To Consent Calendar",7,0,0,0,7
1980338,1542728,2025-04-09,Assembly,"Do pass as amended and be re-referred to the Committee on [Local Government]",5,2,0,0,7
1980338,1564184,2025-04-30,Assembly,"Do pass and be re-referred to the Committee on [Appropriations]",7,2,0,1,10
1980341,1527007,2025-03-25,Assembly,"Do pass",12,0,0,0,12
1980342,1556152,2025-04-23,Assembly,"Do pass as amended and be re-referred to the Committee on [Housing and Community Development]",9,0,0,1,10
1980342,1567906,2025-05-07,Assembly,"Do pass",11,0,0,1,12
1980344,1540811,2025-04-08,Assembly,"Do pass as amended, and be re-referred to the Committee on [Appropriations] with recommendation: To Consent Calendar",12,0,0,0,12
1980344,1563016,2025-04-30,Assembly,"Do pass. To Consent Calendar",14,0,0,1,15
1980344,1568602,2025-05-08,Assembly,"AB 1447 Gipson Consent Calendar Second Day Regular Session",69,0,0,10,79
1980345,1559489,2025-04-28,Assembly,"Do pass as amended and be re-referred to the Committee on [Appropriations]",10,4,0,0,14
1980350,1555989,2025-04-22,Assembly,"Do pass as amended and be re-referred to the Committee on [Appropriations]",4,1,0,5,10
1980351,1564260,2025-04-30,Assembly,"Do pass as amended and be re-referred to the Committee on [Appropriations]",9,0,0,0,9
1980352,1538916,2025-04-07,Assembly,"Do pass and be re-referred to the Committee on [Appropriations]",12,0,0,2,14
1980353,1559410,2025-04-28,Assembly,"Do pass and be re-referred to the Committee on [Appropriations] with recommendation: To Consent Calendar",14,0,0,0,14
1980354,1538928,2025-04-07,Assembly,"Do pass and be re-referred to the Committee on [Emergency Management] with recommendation: To Consent Calendar",14,0,0,0,14
1980354,1561180,2025-04-28,Assembly,"Do pass and be re-referred to the Committee on [Appropriations] with recommendation: To Consent Calendar",7,0,0,0,7
1980356,1528277,2025-03-25,Assembly,"Do pass and be re-referred to the Committee on [Appropriations] with recommendation: To Consent Calendar",7,0,0,0,7
1980356,1542778,2025-04-09,Assembly,"Do pass. To Consent Calendar",14,0,0,1,15
1980356,1557517,2025-04-24,Assembly,"AB 1459 Environmental Safety and Toxic Materials Consent Calendar Second Day Regular Session",75,0,0,4,79
1980357,1555924,2025-04-22,Assembly,"Do pass as amended",9,4,0,3,16
1980363,1540809,2025-04-08,Assembly,"Do pass and be re-referred to the Committee on [Judiciary]",9,4,0,0,13
1980363,1554635,2025-04-22,Assembly,"Do pass and be re-referred to the Committee on [Appropriations]",9,3,0,0,12
1980363,1567919,2025-05-07,Assembly,"Do pass",11,4,0,0,15
1980367,1561101,2025-04-29,Assembly,"Do pass as amended and be re-referred to the Committee on [Appropriations]",8,0,0,2,10
1980368,1562747,2025-04-29,Assembly,"Do pass and be re-referred to the Committee on [Appropriations] with recommendation: To Consent Calendar",7,0,0,0,7
1980373,1554620,2025-04-22,Assembly,"Do pass and be re-referred to the Committee on [Appropriations]",6,0,0,1,7
1980374,1554569,2025-04-22,Assembly,"Do pass and be re-referred to the Committee on [Appropriations] with recommendation: To Consent Calendar",8,0,0,0,8
1980375,1558708,2025-04-21,Assembly,"Do pass as amended, and be re-referred to the Committee on [Appropriations] with recommendation: To Consent Calendar",14,0,0,0,14
1980375,1567873,2025-05-07,Assembly,"Do pass. To Consent Calendar",15,0,0,0,15
1980376,1542864,2025-04-09,Assembly,"Do pass. To Consent Calendar",10,0,0,0,10
1980376,1557558,2025-04-24,Assembly,"AB 1479 Tangipa Consent Calendar Second Day Regular Session",75,0,0,4,79
1980379,1561051,2025-04-29,Assembly,"Do pass as amended and be re-referred to the Committee on [Appropriations]",17,0,0,1,18
1980380,1554509,2025-04-22,Assembly,"Do pass as amended and be re-referred to the Committee on [Appropriations]",6,2,0,1,9
1980382,1566731,2025-05-05,Assembly,"Do pass and be re-referred to the Committee on [Appropriations]",7,0,0,0,7
1980383,1528276,2025-03-26,Assembly,"Do pass as amended and be re-referred to the Committee on [Natural Resources]",8,0,0,0,8
1980383,1558715,2025-04-21,Assembly,"Do pass and be re-referred to the Committee on [Appropriations] with recommendation: To Consent Calendar",14,0,0,0,14
1980384,1556019,2025-04-22,Assembly,"Do pass and be re-referred to the Committee on [Appropriations]",12,3,0,1,16
1980386,1563114,2025-04-29,Assembly,"Do pass and be re-referred to the Committee on [Appropriations]",5,1,0,3,9
1980390,1564187,2025-04-30,Assembly,"Do pass as amended and be re-referred to the Committee on [Appropriations]",4,1,0,4,9
1980390,1564188,2025-04-30,Assembly,Reconsideration,9,0,0,0,9
1980392,1562887,2025-04-29,Assembly,"Do pass and be re-referred to the Committee on [Appropriations] with recommendation: To Consent Calendar",16,0,0,0,16
1980393,1540850,2025-04-08,Assembly,"Do pass and be re-referred to the Committee on [Appropriations] with recommendation: To Consent Calendar",17,0,0,1,18
1980393,1556066,2025-04-23,Assembly,"Do pass. To Consent Calendar",15,0,0,0,15
1980393,1564164,2025-05-01,Assembly,"AB 1496 Blanca Rubio Consent Calendar Second Day Regular Session",76,0,0,3,79
1980397,1540974,2025-04-08,Assembly,"Do pass and be re-referred to the Committee on [Appropriations]",12,1,0,2,15
1980399,1525444,2025-03-24,Assembly,"Be adopted. To Consent Calendar",11,0,0,0,11
1980399,1530397,2025-03-28,Assembly,"ACR 39 Ramos Consent Calendar Second Day",62,0,0,18,80
1980399,1557531,2025-04-24,Senate,"Special Consent ACR39 Ramos et al",37,0,0,3,40
1980399,1568593,2025-05-08,Assembly,"ACR 39 Ramos Concurrence in Senate Amendments",73,0,0,6,79
1980400,1521951,2025-03-18,Assembly,"Be adopted. To third reading",6,1,0,3,10
1980401,1511418,2025-03-10,Assembly,"Be adopted. To third reading",9,0,0,2,11
1980402,1554605,2025-04-22,Senate,"Do pass, but first be re-referred to the Committee on [Appropriations]",5,1,0,0,6
1980402,1565291,2025-05-05,Senate,"Placed on suspense file",7,0,0,0,7
1980403,1556098,2025-04-22,Senate,"Do pass, but first be re-referred to the Committee on [Appropriations] with the recommendation: To Consent Calendar",13,0,0,0,13
1980403,1568606,2025-05-08,Senate,"Consent Calendar 2nd SB673 Ochoa Bogh et al",36,0,0,4,40
1980404,1556096,2025-04-23,Senate,"Do pass, but first be re-referred to the Committee on [Appropriations]",8,0,0,0,8
1980404,1565363,2025-05-05,Senate,"Placed on suspense file",7,0,0,0,7
1980405,1556138,2025-04-23,Senate,"Do pass, but first be re-referred to the Committee on [Rules]",8,0,0,0,8
1980405,1562913,2025-04-30,Senate,"Do pass as amended, but first amend, and re-refer to the Committee on [Appropriations]",7,0,0,0,7
1980406,1536777,2025-04-02,Senate,"Do pass, but first be re-referred to the Committee on [Rules]",8,0,0,0,8
1980406,1556145,2025-04-22,Senate,"Do pass, but first be re-referred to the Committee on [Appropriations] with the recommendation: To Consent Calendar",13,0,0,0,13
1980406,1565257,2025-05-05,Senate,"Placed on suspense file",7,0,0,0,7
1980407,1556139,2025-04-22,Senate,"Do pass, but first be re-referred to the Committee on [Local Government]",4,3,0,4,11
1980407,1556140,2025-04-22,Senate,"[First] hearing set for [04-23-2025]: Failed passage in Committee. Reconsideration granted",11,0,0,0,11
1980408,1555899,2025-04-22,Senate,"Do pass, but first be re-referred to the Committee on [Appropriations] with the recommendation: To Consent Calendar",13,0,0,0,13
1980408,1565360,2025-05-05,Senate,"Placed on suspense file",7,0,0,0,7
1980409,1552959,2025-04-21,Senate,"Do pass as amended, but first amend, and re-refer to the Committee on [Judiciary]",8,0,0,3,11
1980409,1563015,2025-04-29,Senate,"Do pass, but first be re-referred to the Committee on [Appropriations]",12,0,0,1,13
1980410,1540855,2025-04-08,Senate,"Do pass, but first be re-referred to the Committee on [Appropriations]",4,1,0,1,6
1980410,1552840,2025-04-21,Senate,"Placed on suspense file",6,0,0,1,7
1980411,1556055,2025-04-22,Senate,"Do pass, but first be re-referred to the Committee on [Rules]",8,2,0,1,11
1980411,1562911,2025-04-29,Senate,"Do pass, but first be re-referred to the Committee on [Appropriations]",11,2,0,0,13
1980412,1536817,2025-04-02,Senate,"Do pass as amended, but first amend, and re-refer to the Committee on [Health]",5,3,0,0,8
1980412,1564297,2025-04-30,Senate,"Do pass as amended, but first amend, and re-refer to the Committee on [Appropriations]",7,2,0,2,11
1980413,1542758,2025-04-08,Senate,"Do pass as amended, but first amend, and re-refer to the Committee on [Appropriations]",13,0,0,0,13
1980413,1559379,2025-04-28,Senate,"Placed on suspense file",7,0,0,0,7
1980414,1536802,2025-04-02,Senate,"Do pass, but first be re-referred to the Committee on [Judiciary]",5,3,0,0,8
1980415,1542779,2025-04-09,Senate,"Do pass as amended, but first amend, and re-refer to the Committee on [Appropriations]",6,0,0,1,7
1980415,1559395,2025-04-28,Senate,"Placed on suspense file",7,0,0,0,7
1980416,1533511,2025-04-01,Senate,"Do pass, but first be re-referred to the Committee on [Appropriations] with the recommendation: To Consent Calendar",11,0,0,0,11
1980416,1552884,2025-04-21,Senate,"Placed on suspense file",6,0,0,1,7
1980418,1526994,2025-03-25,Senate,"Do pass, but first be re-referred to the Committee on [Appropriations]",13,0,0,2,15
1980418,1538898,2025-04-07,Senate,"Placed on suspense file",7,0,0,0,7
1980420,1562868,2025-04-29,Senate,"Do pass, but first be re-referred to the Committee on [Appropriations]",6,0,0,0,6
1980421,1562879,2025-04-29,Senate,"Do pass, but first be re-referred to the Committee on [Appropriations]",6,0,0,0,6
1980422,1554573,2025-04-22,Senate,"Do pass, but first be re-referred to the Committee on [Housing]",6,0,0,0,6
1980422,1565272,2025-05-05,Senate,"Placed on suspense file",7,0,0,0,7
1980423,1563090,2025-04-30,Senate,"Do pass, but first be re-referred to the Committee on [Appropriations] with the recommendation: To Consent Calendar",5,0,0,0,5
1980424,1559406,2025-04-28,Senate,"Do pass, but first be re-referred to the Committee on [Appropriations] with the recommendation: To Consent Calendar",4,0,0,1,5
1980425,1561066,2025-04-28,Senate,"Do pass, but first be re-referred to the Committee on [Appropriations] with the recommendation: To Consent Calendar",15,0,0,0,15
1980427,1527006,2025-03-25,Senate,"Do pass, but first be re-referred to the Committee on [Judiciary]",5,0,0,2,7
1980427,1555886,2025-04-22,Senate,"Do pass, but first be re-referred to the Committee on [Appropriations]",11,0,0,2,13
1980428,1538867,2025-04-07,Senate,"Do pass as amended, but first amend, and re-refer to the Committee on [Appropriations]",13,3,0,1,17
1980428,1559392,2025-04-28,Senate,"Placed on suspense file",7,0,0,0,7
1980431,1540834,2025-04-08,Senate,"Do pass as amended, but first amend, and re-refer to the Committee on [Appropriations]",6,0,0,0,6
1980431,1559497,2025-04-28,Senate,"Placed on suspense file",7,0,0,0,7
1980432,1527005,2025-03-25,Senate,"Do pass as amended, but first amend, and re-refer to the Committee on [Judiciary]",13,0,0,2,15
1980432,1556011,2025-04-22,Senate,"Do pass, but first be re-referred to the Committee on [Appropriations]",13,0,0,0,13
1980432,1565320,2025-05-05,Senate,"Placed on suspense file",7,0,0,0,7
1980433,1542854,2025-04-08,Senate,"Do pass, but first be re-referred to the Committee on [Labor, Public Employment and Retirement ]",11,3,0,1,15
1980433,1563054,2025-04-30,Senate,"Do pass as amended, but first amend, and re-refer to the Committee on [Appropriations]",4,1,0,0,5
1980434,1563111,2025-04-29,Senate,"Do pass, but first be re-referred to the Committee on [Appropriations]",5,1,0,0,6
1980436,1555905,2025-04-22,Senate,"Do pass, but first be re-referred to the Committee on [Banking and Financial Institutions]",1,2,0,10,13
1980436,1555906,2025-04-22,Senate,"[First] hearing set for [04-22-2025]: Failed passage in Committee. Reconsideration granted",13,0,0,0,13
1980437,1536808,2025-04-02,Senate,"Do pass as amended, but first amend, and re-refer to the Committee on [Judiciary]",5,0,0,2,7
1980437,1555891,2025-04-22,Senate,"Do pass, but first be re-referred to the Committee on [Appropriations]",9,0,0,4,13
1980439,1567909,2025-05-06,Senate,"Do pass as amended",11,0,0,2,13
1980441,1555944,2025-04-23,Senate,"Do pass as amended, but first amend, and re-refer to the Committee on [Appropriations]",4,0,0,1,5
1980442,1542898,2025-04-08,Senate,"Do pass, but first be re-referred to the Committee on [Appropriations]",12,2,0,1,15
1980442,1559412,2025-04-28,Senate,"Placed on suspense file",7,0,0,0,7
1980443,1552921,2025-04-21,Senate,"Do pass, but first be re-referred to the Committee on [Rules]",11,0,0,0,11
1980443,1561027,2025-04-28,Senate,"Do pass, but first be re-referred to the Committee on [Appropriations]",15,0,0,0,15
1980445,1562999,2025-04-29,Senate,"Do pass as amended, but first amend, and re-refer to the Committee on [Appropriations]",9,1,0,1,11
1980446,1563044,2025-04-29,Senate,"Do pass as amended, but first amend, and re-refer to the Committee on [Appropriations]",13,3,0,1,17
1980447,1528280,2025-03-26,Senate,"Do pass, but first be re-referred to the Committee on [Appropriations] with the recommendation: To Consent Calendar",10,0,0,1,11
1980447,1552961,2025-04-21,Senate,"Placed on suspense file",6,0,0,1,7
1980448,1554601,2025-04-22,Senate,"Do pass as amended, but first amend, and re-refer to the Committee on [Appropriations] with the recommendation: To Consent Calendar",6,0,0,1,7
1980450,1542743,2025-04-08,Senate,"Do pass, but first be re-referred to the Committee on [Judiciary]",12,0,0,3,15
1980450,1562986,2025-04-29,Senate,"Do pass as amended, but first amend, and re-refer to the Committee on [Appropriations]",13,0,0,0,13
1980452,1563029,2025-04-29,Senate,"Do pass, but first be re-referred to the Committee on [Appropriations]",3,3,0,7,13
1980452,1563030,2025-04-29,Senate,"[First] hearing set for [04-30-2025]: Failed passage in Committee. Reconsideration granted",13,0,0,0,13
1980454,1562785,2025-04-30,Senate,"Do pass as amended, but first amend, and re-refer to the Committee on [Appropriations] with the recommendation: To Consent Calendar",8,0,0,0,8
1980457,1554583,2025-04-22,Senate,"Do pass, but first be re-referred to the Committee on [Appropriations] with the recommendation: To Consent Calendar",6,0,0,1,7
1980458,1538981,2025-04-07,Senate,"Do pass, but first be re-referred to the Committee on [Judiciary]",5,0,0,2,7
1980458,1556192,2025-04-22,Senate,"Do pass as amended, but first amend, and re-refer to the Committee on [Appropriations]",12,0,0,1,13
1980458,1565237,2025-05-05,Senate,"Placed on suspense file",7,0,0,0,7
1980459,1540915,2025-04-08,Senate,"Do pass, but first be re-referred to the Committee on [Appropriations] with the recommendation: To Consent Calendar",15,0,0,0,15
1980459,1552839,2025-04-21,Senate,"Placed on suspense file",6,0,0,1,7
1980461,1526951,2025-03-25,Senate,"Do pass, but first be re-referred to the Committee on [Appropriations]",14,0,0,1,15
1980463,1533488,2025-04-01,Senate,"Do pass, but first be re-referred to the Committee on [Appropriations] with the recommendation: To Consent Calendar",11,0,0,0,11
1980463,1557541,2025-04-24,Senate,"Consent Calendar 2nd SB733 Wahab",37,0,0,3,40
1980464,1533557,2025-04-01,Senate,"Do pass as amended, but first amend, and re-refer to the Committee on [Appropriations]",6,0,0,0,6
1980465,1536798,2025-04-02,Senate,"Do pass and be ordered to the Consent Calendar",7,0,0,0,7
1980465,1545008,2025-04-10,Senate,"Consent Calendar 2nd SB735 L. GOV. (Durazo) Urgency Clause",35,0,0,5,40
1980466,1536849,2025-04-02,Senate,"Do pass and be ordered to the Consent Calendar",7,0,0,0,7
1980466,1544940,2025-04-10,Senate,"Consent Calendar 2nd SB736 L. GOV. (Durazo) Urgency Clause",35,0,0,5,40
1980467,1536839,2025-04-02,Senate,"Do pass and be ordered to the Consent Calendar",7,0,0,0,7
1980467,1545023,2025-04-10,Senate,"Consent Calendar 2nd SB737 L. GOV. (Durazo)",35,0,0,5,40
1980468,1562801,2025-04-29,Senate,"Do pass as amended, but first amend, and re-refer to the Committee on [Appropriations] with the recommendation: To Consent Calendar",13,0,0,0,13
1980469,1540832,2025-04-07,Senate,"Do pass, but first be re-referred to the Committee on [Appropriations] with the recommendation: To Consent Calendar",5,0,0,0,5
1980469,1552880,2025-04-21,Senate,"Placed on suspense file",6,0,0,1,7
1980470,1536789,2025-04-02,Senate,"Do pass, but first be re-referred to the Committee on [Environmental Quality] with the recommendation: To Consent Calendar",7,0,0,0,7
1980471,1554454,2025-04-22,Senate,"Do pass, but first be re-referred to the Committee on [Appropriations]",6,0,0,1,7
1980473,1542761,2025-04-09,Senate,"Do pass, but first be re-referred to the Committee on [Appropriations]",4,0,0,3,7
1980473,1552826,2025-04-21,Senate,"Placed on suspense file",6,0,0,1,7
1980474,1542721,2025-04-09,Senate,"Do pass, but first be re-referred to the Committee on [Appropriations]",7,0,0,0,7
1980474,1552869,2025-04-21,Senate,"Placed on suspense file",6,0,0,1,7
1980475,1562877,2025-04-30,Senate,"Do pass as amended, but first amend, and re-refer to the Committee on [Appropriations]",7,0,0,0,7
1980476,1554508,2025-04-22,Senate,"Do pass, but first be re-referred to the Committee on [Appropriations]",6,0,0,1,7
1980476,1565334,2025-05-05,Senate,"Placed on suspense file",7,0,0,0,7
1980477,1555926,2025-04-23,Senate,"Do pass, but first be re-referred to the Committee on [Judiciary]",4,0,0,1,5
1980477,1562909,2025-04-29,Senate,"Do pass as amended, but first amend, and re-refer to the Committee on [Appropriations]",9,2,0,2,13
1980478,1540928,2025-04-07,Senate,"Do pass as amended, but first amend, and re-refer to the Committee on [Housing]",5,0,0,0,5
1980478,1563027,2025-04-29,Senate,"Do pass as amended, but first amend, and re-refer to the Committee on [Appropriations]",11,0,0,0,11
1980479,1556090,2025-04-22,Senate,"Do pass, but first be re-referred to the Committee on [Judiciary]",8,2,0,1,11
1980479,1563113,2025-04-29,Senate,"Do pass, but first be re-referred to the Committee on [Appropriations]",11,2,0,0,13
1980480,1556084,2025-04-22,Senate,"Do pass, but first be re-referred to the Committee on [Judiciary]",11,0,0,0,11
1980480,1562944,2025-04-29,Senate,"Do pass as amended, but first amend, and re-refer to the Committee on [Appropriations] with the recommendation: To Consent Calendar",13,0,0,0,13
1980481,1557601,2025-04-23,Senate,"Do pass as amended, but first amend, and re-refer to the Committee on [Education]",7,0,0,4,11
1980481,1562829,2025-04-30,Senate,"Do pass, but first be re-referred to the Committee on [Appropriations]",6,0,0,1,7
1980483,1567912,2025-05-07,Senate,"Do pass",6,0,0,1,7
1980484,1562950,2025-04-30,Senate,"Do pass as amended, but first amend, and re-refer to the Committee on [Appropriations]",8,0,0,0,8
1980485,1562795,2025-04-30,Senate,"Do pass as amended, but first amend, and re-refer to the Committee on [Appropriations]",5,2,0,1,8
1980486,1559382,2025-04-28,Senate,"Do pass, but first be re-referred to the Committee on [Appropriations]",10,0,0,1,11
1980487,1536787,2025-04-02,Senate,"Do pass as amended, but first amend, and re-refer to the Committee on [Judiciary]",7,0,0,0,7
1980487,1567908,2025-05-06,Senate,"Do pass as amended",12,0,0,1,13
1980489,1554565,2025-04-22,Senate,"Do pass, but first be re-referred to the Committee on [Appropriations]",6,0,0,0,6
1980489,1565290,2025-05-05,Senate,"Placed on suspense file",7,0,0,0,7
1980490,1561031,2025-04-29,Senate,"Do pass",5,0,0,0,5
1980491,1542796,2025-04-09,Senate,"Do pass as amended, but first amend, and re-refer to the Committee on [Human Services]",7,0,0,0,7
1980491,1552823,2025-04-21,Senate,"Do pass, but first be re-referred to the Committee on [Appropriations] with the recommendation: To Consent Calendar",5,0,0,0,5
1980491,1565307,2025-05-05,Senate,"Placed on suspense file",7,0,0,0,7
1980493,1542699,2025-04-08,Senate,"Do pass, but first be re-referred to the Committee on [Public Safety]",11,2,0,0,13
1980493,1563092,2025-04-29,Senate,"Do pass, but first be re-referred to the Committee on [Appropriations]",5,1,0,0,6
1980494,1545015,2025-04-09,Senate,"Do pass, but first be re-referred to the Committee on [Appropriations] with the recommendation: To Consent Calendar",11,0,0,0,11
1980494,1559457,2025-04-28,Senate,"Placed on suspense file",7,0,0,0,7
1980495,1540862,2025-04-08,Senate,"Do pass",15,0,0,0,15
1980496,1542787,2025-04-08,Senate,"Do pass as amended, but first amend, and re-refer to the Committee on [Judiciary]",9,3,0,3,15
1980496,1562922,2025-04-29,Senate,"Do pass as amended, but first amend, and re-refer to the Committee on [Appropriations]",11,0,0,2,13
1980497,1554498,2025-04-21,Senate,"Do pass, but first be re-referred to the Committee on [Natural Resources and Water]",15,0,0,2,17
1980498,1555925,2025-04-22,Senate,"Do pass, but first be re-referred to the Committee on [Appropriations] with the recommendation: To Consent Calendar",13,0,0,0,13
1980498,1565254,2025-05-05,Senate,"Placed on suspense file",7,0,0,0,7
1980499,1552918,2025-04-21,Senate,"Do pass, but first be re-referred to the Committee on [Judiciary]",10,0,0,1,11
1980499,1562816,2025-04-29,Senate,"Do pass as amended, but first amend, and re-refer to the Committee on [Appropriations]",13,0,0,0,13
1980500,1556133,2025-04-22,Senate,"Do pass, but first be re-referred to the Committee on [Judiciary]",8,2,0,1,11
1980500,1567856,2025-05-06,Senate,"Do pass",11,1,0,1,13
1980501,1562768,2025-04-29,Senate,"Do pass, but first be re-referred to the Committee on [Appropriations]",10,0,0,3,13
1980502,1563115,2025-04-29,Senate,"Do pass, but first be re-referred to the Committee on [Appropriations] with the recommendation: To Consent Calendar",11,0,0,0,11
1980503,1559399,2025-04-28,Senate,"Do pass, but first be re-referred to the Committee on [Appropriations] with the recommendation: To Consent Calendar",11,0,0,0,11
1980504,1559387,2025-04-28,Senate,"Do pass as amended",11,0,0,0,11
1980505,1559473,2025-04-28,Senate,"Do pass as amended, but first amend, and re-refer to the Committee on [Appropriations]",11,0,0,0,11
1980506,1559380,2025-04-28,Senate,"Do pass as amended, but first amend, and re-refer to the Committee on [Appropriations]",11,0,0,0,11
1980507,1536769,2025-04-02,Senate,"Do pass, but first be re-referred to the Committee on [Appropriations]",6,1,0,0,7
1980507,1559366,2025-04-28,Senate,"Placed on suspense file",7,0,0,0,7
1980508,1540920,2025-04-07,Senate,"Do pass, but first be re-referred to the Committee on [Appropriations]",5,0,0,0,5
1980508,1552903,2025-04-21,Senate,"Placed on suspense file",6,0,0,1,7
1980509,1538881,2025-04-07,Senate,"Do pass, but first be re-referred to the Committee on [Judiciary]",10,0,0,1,11
1980509,1556104,2025-04-22,Senate,"Do pass, but first be re-referred to the Committee on [Appropriations]",13,0,0,0,13
1980511,1538863,2025-04-07,Senate,"Do pass, but first be re-referred to the Committee on [Local Government]",10,0,0,1,11
1980511,1562894,2025-04-30,Senate,"Do pass as amended, but first amend, and re-refer to the Committee on [Appropriations] with the recommendation: To Consent Calendar",7,0,0,0,7
1980512,1567918,2025-05-07,Senate,"Do pass as amended",7,0,0,0,7
1980513,1542748,2025-04-08,Senate,"Do pass, but first be re-referred to the Committee on [Appropriations]",14,0,0,1,15
1980514,1535101,2025-04-02,Senate,"Do pass as amended, but first amend, and re-refer to the Committee on [Judiciary]",5,0,0,2,7
1980514,1562776,2025-04-29,Senate,"Do pass as amended, but first amend, and re-refer to the Committee on [Appropriations]",10,0,0,3,13
1980516,1556199,2025-04-23,Senate,"Do pass, but first be re-referred to the Committee on [Judiciary]",5,2,0,0,7
1980516,1563086,2025-04-29,Senate,"Do pass as amended, but first amend, and re-refer to the Committee on [Appropriations]",11,2,0,0,13
1980517,1554654,2025-04-21,Senate,"Do pass as amended, but first amend, and re-refer to the Committee on [Appropriations]",14,2,0,1,17
1980518,1559486,2025-04-28,Senate,"Do pass as amended, but first amend, and re-refer to the Committee on [Appropriations]",11,0,0,0,11
1980519,1555967,2025-04-23,Senate,"Do pass as amended, but first amend, and re-refer to the Committee on [Appropriations]",3,1,0,1,5
1980520,1552911,2025-04-21,Senate,"Do pass, but first be re-referred to the Committee on [Education]",11,0,0,0,11
1980520,1562826,2025-04-30,Senate,"Do pass as amended, but first amend, and re-refer to the Committee on [Appropriations]",6,0,0,1,7
1980521,1554595,2025-04-22,Senate,"Do pass, but first be re-referred to the Committee on [Rules]",12,1,0,2,15
1980522,1540965,2025-04-07,Senate,"Do pass, but first be re-referred to the Committee on [Appropriations] with the recommendation: To Consent Calendar",5,0,0,0,5
1980522,1557572,2025-04-24,Senate,"Consent Calendar 2nd SB792 Arreguín",37,0,0,3,40
1980523,1540966,2025-04-08,Senate,"Do pass, but first be re-referred to the Committee on [Judiciary]",15,0,0,0,15
1980523,1563100,2025-04-29,Senate,"Do pass and be ordered to the Consent Calendar",13,0,0,0,13
1980523,1568658,2025-05-08,Senate,"Consent Calendar 2nd SB793 Archuleta",36,0,0,4,40
1980526,1557504,2025-04-23,Senate,"Do pass as amended, but first amend, and re-refer to the Committee on [Appropriations]",11,0,0,0,11
1980527,1555932,2025-04-23,Senate,"Do pass, but first be re-referred to the Committee on [Energy, Utilities and Communications]",8,0,0,0,8
1980527,1562965,2025-04-29,Senate,"Do pass as amended, but first amend, and re-refer to the Committee on [Appropriations]",13,1,0,3,17
1980528,1559483,2025-04-28,Senate,"Do pass, but first be re-referred to the Committee on [Appropriations] with the recommendation: To Consent Calendar",4,0,0,1,5
1980528,1561084,2025-04-28,Senate,"Do pass and be ordered to the Consent Calendar",4,0,0,1,5
1980528,1565310,2025-05-05,Senate,"Consent Calendar 2nd SB798 Rubio",38,0,0,2,40
1980529,1542809,2025-04-08,Senate,"Do pass as amended, but first amend, and re-refer to the Committee on [Revenue and Taxation]",10,2,0,1,13
1980529,1555887,2025-04-23,Senate,"Do pass as amended, but first amend, and re-refer to the Committee on [Appropriations]",2,1,0,2,5
1980529,1555888,2025-04-23,Senate,"[First] hearing set for [04-23-2025]: Failed passage in Committee. Reconsideration granted",5,0,0,0,5
1980530,1561113,2025-04-28,Senate,"Do pass, but first be re-referred to the Committee on [Appropriations]",15,0,0,0,15
1980532,1552832,2025-04-21,Senate,"Do pass, but first be re-referred to the Committee on [Housing]",5,0,0,0,5
1980532,1562886,2025-04-29,Senate,"Do pass as amended, but first amend, and re-refer to the Committee on [Appropriations] with the recommendation: To Consent Calendar",11,0,0,0,11
1980533,1540823,2025-04-08,Senate,"Do pass as amended, but first amend, and re-refer to the Committee on [Appropriations]",6,0,0,1,7
1980533,1559490,2025-04-28,Senate,"Placed on suspense file",7,0,0,0,7
1980534,1563061,2025-04-29,Senate,"Do pass as amended, but first amend, and re-refer to the Committee on [Appropriations]",16,0,0,1,17
1980535,1556122,2025-04-23,Senate,"Do pass, but first be re-referred to the Committee on [Appropriations] with the recommendation: To Consent Calendar",7,0,0,0,7
1980535,1568674,2025-05-08,Senate,"Consent Calendar 2nd SB805 Pérez",36,0,0,4,40
1980538,1542763,2025-04-08,Senate,"Do pass, but first be re-referred to the Committee on [Appropriations] with the recommendation: To Consent Calendar",13,0,0,0,13
1980538,1552922,2025-04-21,Senate,"Placed on suspense file",6,0,0,1,7
1980539,1542785,2025-04-09,Senate,"Do pass, but first be re-referred to the Committee on [Judiciary]",4,1,0,0,5
1980539,1556163,2025-04-22,Senate,"Do pass as amended, but first amend, and re-refer to the Committee on [Appropriations]",12,1,0,0,13
1980542,1564158,2025-04-30,Senate,"Do pass as amended, but first amend, and re-refer to the Committee on [Appropriations]",9,0,0,2,11
1980543,1562769,2025-04-29,Senate,"Do pass as amended, but first amend, and re-refer to the Committee on [Appropriations]",10,0,0,3,13
1980544,1540829,2025-04-07,Senate,"Do pass, but first be re-referred to the Committee on [Housing] with the recommendation: To Consent Calendar",5,0,0,0,5
1980544,1563067,2025-04-29,Senate,"Do pass, but first be re-referred to the Committee on [Appropriations] with the recommendation: To Consent Calendar",11,0,0,0,11
1980545,1562900,2025-04-30,Senate,"Do pass, but first be re-referred to the Committee on [Appropriations]",5,1,0,1,7
1980548,1554566,2025-04-22,Senate,"Do pass as amended, but first amend, and re-refer to the Committee on [Appropriations]",4,1,0,2,7
1980548,1554567,2025-04-22,Senate,"[04-22-2025] set for [First] hearing: Reconsideration of favorable vote granted",2,4,0,1,7
1980549,1555953,2025-04-23,Senate,"Do pass, but first be re-referred to the Committee on [Appropriations]",8,0,0,0,8
1980549,1565286,2025-05-05,Senate,"Placed on suspense file",7,0,0,0,7
1980550,1562851,2025-04-29,Senate,"Do pass",6,0,0,0,6
1980551,1540865,2025-04-08,Senate,"Do pass, but first be re-referred to the Committee on [Appropriations]",5,0,0,1,6
1980551,1552858,2025-04-21,Senate,"Placed on suspense file",6,0,0,1,7
1980552,1556130,2025-04-22,Senate,"Do pass, but first be re-referred to the Committee on [Appropriations] with the recommendation: To Consent Calendar",13,0,0,0,13
1980552,1565258,2025-05-05,Senate,"Placed on suspense file",7,0,0,0,7
1980553,1545017,2025-04-09,Senate,"Do pass, but first be re-referred to the Committee on [Appropriations]",11,0,0,0,11
1980553,1559369,2025-04-28,Senate,"Placed on suspense file",7,0,0,0,7
1980554,1554553,2025-04-22,Senate,"Do pass as amended, but first amend, and re-refer to the Committee on [Appropriations]",5,0,0,1,6
1980554,1565355,2025-05-05,Senate,"Placed on suspense file",7,0,0,0,7
1980555,1535024,2025-04-02,Senate,"Do pass, but first be re-referred to the Committee on [Judiciary]",5,2,0,0,7
1980555,1556038,2025-04-22,Senate,"Do pass, but first be re-referred to the Committee on [Appropriations]",11,2,0,0,13
1980556,1562929,2025-04-30,Senate,"Do pass, but first be re-referred to the Committee on [Appropriations]",4,0,0,1,5
1980557,1562942,2025-04-30,Senate,"Do pass as amended, but first amend, and re-refer to the Committee on [Appropriations]",5,2,0,0,7
1980559,1544965,2025-04-09,Senate,"Do pass, but first be re-referred to the Committee on [Natural Resources and Water]",8,2,0,1,11
1980559,1554582,2025-04-22,Senate,"Do pass as amended, but first amend, and re-refer to the Committee on [Appropriations]",4,2,0,1,7
1980559,1565352,2025-05-05,Senate,"Placed on suspense file",7,0,0,0,7
1980560,1540808,2025-04-08,Senate,"Do pass, but first be re-referred to the Committee on [Judiciary] with the recommendation: To Consent Calendar",6,0,0,0,6
1980560,1557559,2025-04-24,Senate,"Consent Calendar 2nd SB830 Arreguín",37,0,0,3,40
1980561,1540799,2025-04-08,Senate,"Do pass, but first be re-referred to the Committee on [Appropriations]",5,0,0,2,7
1980563,1554538,2025-04-22,Senate,"Do pass, but first be re-referred to the Committee on [Appropriations]",12,0,0,3,15
1980563,1565262,2025-05-05,Senate,"Placed on suspense file",7,0,0,0,7
1980564,1554451,2025-04-22,Senate,"Do pass, but first be re-referred to the Committee on [Appropriations]",5,1,0,0,6
1980564,1565331,2025-05-05,Senate,"Placed on suspense file",7,0,0,0,7
1980565,1542736,2025-04-09,Senate,"Do pass",6,0,0,1,7
1980566,1554626,2025-04-21,Senate,"Do pass, but first be re-referred to the Committee on [Appropriations]",14,2,0,1,17
1980566,1565351,2025-05-05,Senate,"Placed on suspense file",7,0,0,0,7
1980568,1555980,2025-04-22,Senate,"Do pass, but first be re-referred to the Committee on [Local Government]",9,2,0,0,11
1980568,1567903,2025-05-07,Senate,"Do pass",5,1,0,1,7
1980569,1540977,2025-04-08,Senate,"Do pass, but first be re-referred to the Committee on [Environmental Quality]",5,0,0,2,7
1980569,1562958,2025-04-30,Senate,"Do pass, but first be re-referred to the Committee on [Appropriations]",8,0,0,0,8
1980570,1562770,2025-04-30,Senate,"Do pass, but first be re-referred to the Committee on [Appropriations]",8,0,0,0,8
1980571,1556049,2025-04-22,Senate,"Do pass, but first be re-referred to the Committee on [Public Safety]",11,0,0,2,13
1980571,1562790,2025-04-29,Senate,"Do pass, but first be re-referred to the Committee on [Appropriations]",5,0,0,1,6
1980572,1562927,2025-04-29,Senate,"Do pass as amended, but first amend, and re-refer to the Committee on [Appropriations]",13,3,0,1,17
1980574,1526920,2025-03-25,Senate,"Do pass, but first be re-referred to the Committee on [Appropriations]",12,0,0,3,15
1980575,1542698,2025-04-09,Senate,"Do pass as amended, but first amend, and re-refer to the Committee on [Labor, Public Employment and Retirement ]",7,0,0,0,7
1980575,1562910,2025-04-30,Senate,"Do pass, but first be re-referred to the Committee on [Appropriations]",5,0,0,0,5
1980576,1567910,2025-05-06,Senate,"Do pass and be ordered to the Consent Calendar",12,0,0,1,13
1980577,1542726,2025-04-09,Senate,"Do pass, but first be re-referred to the Committee on [Judiciary]",5,0,0,0,5
1980577,1562765,2025-04-29,Senate,"Do pass, but first be re-referred to the Committee on [Appropriations]",13,0,0,0,13
1980578,1556006,2025-04-23,Senate,"Do pass, but first be re-referred to the Committee on [Public Safety]",7,0,0,0,7
1980578,1563004,2025-04-29,Senate,"Do pass as amended, but first amend, and re-refer to the Committee on [Appropriations]",6,0,0,0,6
1980580,1561120,2025-04-29,Senate,"Do pass, but first be re-referred to the Committee on [Labor, Public Employment and Retirement ]",6,0,0,0,6
1980580,1562849,2025-04-30,Senate,"Do pass as amended, but first amend, and re-refer to the Committee on [Appropriations]",4,0,0,1,5
1980581,1503912,2025-03-03,Senate,"Senate 3rd Reading SCR27 Choi",37,0,0,2,39
1980581,1552847,2025-04-21,Assembly,"Be adopted. To Consent Calendar",10,0,0,1,11
1980581,1557489,2025-04-24,Assembly,"SCR 27 Choi Consent Calendar Second Day Regular Session",75,0,0,4,79
1980582,1508042,2025-03-06,Senate,"Senate 3rd Reading SR19 Wahab et al",34,0,0,5,39
1980583,1568611,2025-05-08,Senate,"Senate 3rd Reading SR20 Cortese et al",36,0,0,4,40
1980585,1525437,2025-03-24,Senate,"Senate 3rd Reading SR22 Wiener et al",26,1,0,13,40
1982217,1561099,2025-04-29,Assembly,"Do pass as amended and be re-referred to the Committee on [Appropriations]",17,0,0,1,18
1982218,1561052,2025-04-29,Assembly,"Do pass as amended and be re-referred to the Committee on [Appropriations]",17,0,0,1,18
1982219,1561041,2025-04-29,Assembly,"Do pass as amended and be re-referred to the Committee on [Appropriations]",13,1,0,4,18
1982220,1561158,2025-04-29,Assembly,"Do pass as amended and be re-referred to the Committee on [Appropriations]",16,0,0,2,18
1982221,1503915,2025-03-03,Assembly,"Be adopted. To third reading",6,0,0,5,11
1982221,1557491,2025-04-24,Senate,"Special Consent ACR41 Patterson et al",37,0,0,3,40
1982222,1511500,2025-03-10,Assembly,"Be adopted. To third reading",9,0,0,2,11
1983852,1562838,2025-04-30,Assembly,"Do pass and be re-referred to the Committee on [Appropriations] with recommendation: To Consent Calendar",8,0,0,0,8
1983853,1511455,2025-03-10,Assembly,"Be adopted. To third reading",9,0,0,2,11
1983854,1519129,2025-03-17,Senate,"Senate 3rd Reading SCR29 McNerney",37,0,0,3,40
1983854,1552917,2025-04-21,Assembly,"Be adopted. To Consent Calendar",10,0,0,1,11
1983854,1557523,2025-04-24,Assembly,"SCR 29 McNerney Consent Calendar Second Day Regular Session",75,0,0,4,79
1983855,1508044,2025-03-06,Senate,"Senate 3rd Reading SCR30 Smallwood-Cuevas",34,0,0,5,39
1983855,1519116,2025-03-17,Assembly,"Be adopted. To Consent Calendar",10,0,0,1,11
1983855,1523556,2025-03-20,Assembly,"SCR 30 Smallwood-Cuevas Consent Calendar Second Day Regular Session",67,0,0,13,80
1983856,1517829,2025-03-13,Senate,"Senate 3rd Reading SR23 Rubio et al",28,2,0,10,40
1983857,1523506,2025-03-20,Senate,"Senate 3rd Reading SR24 Wahab et al",38,0,0,2,40
1983858,1511456,2025-03-10,Senate,"Senate 3rd Reading SR25 Limón",38,0,0,1,39
1983859,1523551,2025-03-20,Senate,"Senate 3rd Reading SR26 Padilla et al",38,0,0,2,40
1986151,1542732,2025-04-09,Assembly,"Do pass and be re-referred to the Committee on [Appropriations] with recommendation: To Consent Calendar",8,0,0,0,8
1986152,1530381,2025-03-28,Assembly,"Be adopted. To Consent Calendar",7,0,0,4,11
1986152,1536814,2025-04-03,Assembly,"ACR 42 Pacheco Consent Calendar Second Day Regular Session",74,0,0,5,79
1986153,1503918,2025-03-03,Assembly,"Be adopted. To Consent Calendar",6,0,0,5,11
1986153,1508048,2025-03-06,Assembly,"ACR 43 Pacheco Consent Calendar Second Day",76,0,0,4,80
1986153,1536793,2025-04-03,Senate,"Special Consent ACR43 Pacheco et al",39,0,0,1,40
1986154,1503928,2025-03-03,Assembly,"Be adopted. To Consent Calendar",6,0,0,5,11
1986154,1508045,2025-03-06,Assembly,"HR 20 Ransom Consent Calendar Second Day Regular Session",76,0,0,4,80
1987922,1565306,2025-05-05,Assembly,"Do pass. To Consent Calendar",9,0,0,0,9
1987923,1530378,2025-03-28,Assembly,"Be adopted. To third reading",7,0,0,4,11
1987924,1561021,2025-04-29,Senate,"Do pass and be ordered to the Consent Calendar",5,0,0,0,5
1987924,1565288,2025-05-05,Senate,"Consent Calendar 2nd SB851 E. & C.A. (Cervantes)",38,0,0,2,40
1987925,1561129,2025-04-29,Senate,"Do pass, but first be re-referred to the Committee on [Appropriations] with the recommendation: To Consent Calendar",5,0,0,0,5
1987926,1519126,2025-03-17,Senate,"Senate 3rd Reading SCR31 Allen",37,0,0,3,40
1987926,1552859,2025-04-21,Assembly,"Be adopted. To Consent Calendar",10,0,0,1,11
1987926,1557533,2025-04-24,Assembly,"SCR 31 Allen Consent Calendar Second Day Regular Session",75,0,0,4,79
1987927,1525432,2025-03-24,Senate,"Senate 3rd Reading SCR32 Allen",35,0,0,5,40
1987927,1552882,2025-04-21,Assembly,"Be adopted. To Consent Calendar",10,0,0,1,11
1987927,1557525,2025-04-24,Assembly,"SCR 32 Allen Consent Calendar Second Day Regular Session",75,0,0,4,79
1990391,1544975,2025-04-08,Assembly,"Do pass and be re-referred to the Committee on [Appropriations]",7,0,0,1,8
1990392,1545016,2025-04-08,Assembly,"Do pass and be re-referred to the Committee on [Appropriations]",7,0,0,1,8
1990392,1556124,2025-04-23,Assembly,"Do pass",15,0,0,0,15
1990392,1568601,2025-05-08,Assembly,"AB 1509 M. & V. A. Assembly Third Reading By SCHIAVO",72,0,0,7,79
1990393,1565278,2025-05-05,Assembly,"Be adopted. To Consent Calendar",9,0,0,2,11
1990393,1568657,2025-05-08,Assembly,"ACR 45 Quirk-Silva Consent Calendar Second Day Regular Session",69,0,0,10,79
1990394,1555992,2025-04-23,Assembly,"Be adopted. To third reading",7,0,0,0,7
1990395,1519117,2025-03-17,Assembly,"Be adopted. To third reading",10,0,0,1,11
1990396,1528309,2025-03-26,Senate,"Be adopted as amended",4,1,0,0,5
1990396,1538955,2025-04-07,Senate,"Senate 3rd Reading SJR2 Cortese et al",29,7,0,4,40
1990397,1565359,2025-05-05,Senate,"Senate 3rd Reading SR27 Gonzalez et al",38,0,0,2,40
1991546,1556128,2025-04-23,Assembly,"Do pass and be re-referred to the Committee on [Appropriations]",7,0,0,0,7
1991546,1567861,2025-05-07,Assembly,"Do pass",15,0,0,0,15
1991548,1511484,2025-03-10,Assembly,"Be adopted. To Consent Calendar",9,0,0,2,11
1991548,1517621,2025-03-13,Assembly,"ACR 46 Soria Consent Calendar Second Day",68,0,0,12,80
1991548,1536820,2025-04-03,Senate,"Special Consent ACR46 Soria et al",39,0,0,1,40
1991549,1511462,2025-03-10,Assembly,"Be adopted. To third reading",9,0,0,2,11
1991549,1536816,2025-04-03,Senate,"Special Consent ACR47 Chen et al",39,0,0,1,40
1991550,1511493,2025-03-10,Assembly,"Be adopted. To third reading",9,0,0,2,11
1991550,1557479,2025-04-24,Senate,"Special Consent ACR48 DeMaio et al",37,0,0,3,40
1991551,1511419,2025-03-10,Assembly,"Be adopted. To Consent Calendar",9,0,0,2,11
1991551,1517614,2025-03-13,Assembly,"HR 22 Soria Consent Calendar Second Day Regular Session",68,0,0,12,80
1991552,1525425,2025-03-24,Assembly,"Be adopted. To third reading",11,0,0,0,11
1991553,1542791,2025-04-09,Senate,"Do pass as amended, but first amend, and re-refer to the Committee on [Judiciary] with the recommendation: To Consent Calendar",5,0,0,0,5
1991553,1564302,2025-05-01,Senate,"Consent Calendar 2nd SB853 L., P.E. & R. (Smallwood-Cuevas)",37,0,0,3,40
1991554,1542790,2025-04-09,Senate,"Do pass as amended, but first amend, and re-refer to the Committee on [Appropriations] with the recommendation: To Consent Calendar",5,0,0,0,5
1991554,1564190,2025-05-01,Senate,"Consent Calendar 2nd SB854 L., P.E. & R. (Smallwood-Cuevas)",37,0,0,3,40
1991556,1517830,2025-03-13,Senate,"Senate 3rd Reading SR28 Hurtado et al",36,0,0,4,40
1992995,1519115,2025-03-17,Assembly,"Be adopted. To third reading",10,0,0,1,11
1992995,1557502,2025-04-24,Senate,"Special Consent ACR49 DeMaio et al",37,0,0,3,40
1992996,1519128,2025-03-17,Assembly,"Be adopted. To third reading",10,0,0,1,11
1992996,1557505,2025-04-24,Senate,"Special Consent ACR50 Ahrens et al",37,0,0,3,40
1994335,1517616,2025-03-13,Assembly,"Be adopted. To third reading",9,0,0,2,11
1994336,1540958,2025-04-08,Senate,"Do pass, but first be re-referred to the Committee on [Military and Veterans Affairs] with the recommendation: To Consent Calendar",15,0,0,0,15
1994336,1559500,2025-04-28,Senate,"Do pass, but first be re-referred to the Committee on [Appropriations] with the recommendation: To Consent Calendar",4,0,0,1,5
1994337,1557547,2025-04-24,Senate,"Senate 3rd Reading SCR34 Grove et al",38,0,0,2,40
1994338,1523642,2025-03-20,Senate,"Senate 3rd Reading SCR35 Grayson",38,0,0,2,40
1994338,1552825,2025-04-21,Assembly,"Be adopted. To Consent Calendar",10,0,0,1,11
1994338,1557503,2025-04-24,Assembly,"SCR 35 Grayson Consent Calendar Second Day Regular Session",75,0,0,4,79
1994339,1530379,2025-03-28,Senate,"Senate 3rd Reading SR29 Arreguín et al",34,0,0,6,40
1997024,1563062,2025-04-30,Assembly,"Do pass as amended. To Consent Calendar",7,0,0,0,7
1997026,1562825,2025-04-30,Assembly,"Do pass as amended. To Consent Calendar",7,0,0,0,7
1997026,1568628,2025-05-08,Assembly,"AB 1512 Elections Consent Calendar Second Day Regular Session",69,0,0,10,79
1997027,1562857,2025-04-30,Assembly,"Do pass. To Consent Calendar",7,0,0,0,7
1997027,1568612,2025-05-08,Assembly,"AB 1513 Elections Consent Calendar Second Day Regular Session",69,0,0,10,79
1997028,1557529,2025-04-23,Assembly,"Do pass. To Consent Calendar",7,0,0,0,7
1997028,1564169,2025-05-01,Assembly,"AB 1514 Labor and Employment Consent Calendar Second Day Regular Session",76,0,0,3,79
1997029,1557571,2025-04-23,Assembly,"Do pass and be re-referred to the Committee on [Appropriations] with recommendation: To Consent Calendar",7,0,0,0,7
1997029,1567891,2025-05-07,Assembly,"Do pass. To Consent Calendar",15,0,0,0,15
1997030,1536785,2025-04-03,Senate,"Senate 3rd Reading SCR36 Seyarto et al",39,0,0,1,40
1997030,1552881,2025-04-21,Assembly,"Be adopted. To Consent Calendar",10,0,0,1,11
1997030,1557530,2025-04-24,Assembly,"SCR 36 Seyarto Consent Calendar Second Day Regular Session",75,0,0,4,79
1997031,1519125,2025-03-17,Senate,"Senate 3rd Reading SCR37 Wiener",37,0,0,3,40
1997031,1552844,2025-04-21,Assembly,"Be adopted. To Consent Calendar",10,0,0,1,11
1997031,1557487,2025-04-24,Assembly,"SCR 37 Wiener Consent Calendar Second Day Regular Session",75,0,0,4,79
1997032,1523691,2025-03-20,Senate,"Senate 3rd Reading SCR38 Grove et al",38,0,0,2,40
1997032,1552860,2025-04-21,Assembly,"Be adopted. To Consent Calendar",10,0,0,1,11
1997032,1557520,2025-04-24,Assembly,"SCR 38 Grove Consent Calendar Second Day Regular Session",75,0,0,4,79
2000329,1517607,2025-03-13,Assembly,"Be adopted. To third reading",9,0,0,2,11
2000329,1536797,2025-04-03,Senate,"Special Consent ACR51 Haney et al",39,0,0,1,40
2000330,1554618,2025-04-22,Senate,"Do pass, but first be re-referred to the Committee on [Appropriations] with the recommendation: To Consent Calendar",6,0,0,1,7
2000330,1568598,2025-05-08,Senate,"Consent Calendar 2nd SB856 N.R. & W. (Limón)",36,0,0,4,40
2005483,1562783,2025-04-29,Senate,"Do pass, but first be re-referred to the Committee on [Appropriations] with the recommendation: To Consent Calendar",6,0,0,0,6
2005484,1556026,2025-04-23,Senate,"Do pass, but first be re-referred to the Committee on [Judiciary] with the recommendation: To Consent Calendar",7,0,0,0,7
2005484,1567884,2025-05-06,Senate,"Do pass and be ordered to the Consent Calendar",12,0,0,1,13
2007014,1554592,2025-04-21,Assembly,"Do pass and be re-referred to the Committee on [Appropriations] with recommendation: To Consent Calendar",7,0,0,0,7
2007014,1567928,2025-05-07,Assembly,"Do pass. To Consent Calendar",15,0,0,0,15
2007015,1554619,2025-04-21,Assembly,"Do pass and be re-referred to the Committee on [Appropriations] with recommendation: To Consent Calendar",7,0,0,0,7
2007016,1554599,2025-04-21,Assembly,"Do pass and be re-referred to the Committee on [Appropriations] with recommendation: To Consent Calendar",7,0,0,0,7
2007016,1562779,2025-04-30,Assembly,"Do pass. To Consent Calendar",14,0,0,1,15
2007016,1568644,2025-05-08,Assembly,"AB 1518 REV. & TAX. Consent Calendar Second Day Regular Session",69,0,0,10,79
2007017,1554453,2025-04-21,Assembly,"Do pass. To Consent Calendar",7,0,0,0,7
2007017,1559367,2025-04-28,Assembly,"AB 1519 Revenue and Taxation Consent Calendar Second Day",76,0,0,3,79
2007018,1562763,2025-04-29,Assembly,"Do pass and be re-referred to the Committee on [Appropriations] with recommendation: To Consent Calendar",13,0,0,0,13
2007019,1554504,2025-04-22,Senate,"Do pass, but first be re-referred to the Committee on [Appropriations] with the recommendation: To Consent Calendar",14,0,0,1,15
2007019,1568649,2025-05-08,Senate,"Consent Calendar 2nd SB859 G.O. (Padilla)",36,0,0,4,40
2007020,1554437,2025-04-22,Senate,"Do pass, but first be re-referred to the Committee on [Appropriations] with the recommendation: To Consent Calendar",14,0,0,1,15
2007020,1568632,2025-05-08,Senate,"Consent Calendar 2nd SB860 G.O. (Padilla)",36,0,0,4,40
2007021,1552936,2025-04-21,Senate,"Do pass, but first be re-referred to the Committee on [Judiciary] with the recommendation: To Consent Calendar",11,0,0,0,11
2007021,1562869,2025-04-29,Senate,"Do pass, but first be re-referred to the Committee on [Appropriations] with the recommendation: To Consent Calendar",13,0,0,0,13
2009611,1525413,2025-03-24,Assembly,"Be adopted. To Consent Calendar",11,0,0,0,11
2009611,1530396,2025-03-28,Assembly,"ACR 53 Bonta Consent Calendar Second Day Regular Session",61,0,0,19,80
2009611,1557526,2025-04-24,Senate,"Special Consent ACR53 Bonta et al",37,0,0,3,40
2009613,1564273,2025-04-30,Senate,"Do pass, but first be re-referred to the Committee on [Appropriations] with the recommendation: To Consent Calendar",11,0,0,0,11
2009614,1525424,2025-03-24,Senate,"Senate 3rd Reading SCR39 Durazo et al",35,0,0,5,40
2009614,1552905,2025-04-21,Assembly,"Be adopted. To third reading",9,1,0,1,11
2009614,1565316,2025-05-05,Assembly,"SCR 39 Durazo Senate Third Reading By Quirk-Silva",69,0,0,10,79
2009615,1536830,2025-04-03,Senate,"Senate 3rd Reading SCR40 Blakespear et al",39,0,0,1,40
2009615,1552824,2025-04-21,Assembly,"Be adopted. To Consent Calendar",10,0,0,1,11
2009615,1557568,2025-04-24,Assembly,"SCR 40 Blakespear Consent Calendar Second Day Regular Session",75,0,0,4,79
2009616,1525468,2025-03-24,Senate,"Senate 3rd Reading SCR41 Ashby et al",35,0,0,5,40
2009616,1552893,2025-04-21,Assembly,"Be adopted. To Consent Calendar",10,0,0,1,11
2009616,1557477,2025-04-24,Assembly,"SCR 41 Ashby Consent Calendar Second Day Regular Session",75,0,0,4,79
2010618,1554587,2025-04-22,Assembly,"Do pass and be re-referred to the Committee on [Appropriations]",9,0,0,3,12
2010619,1554622,2025-04-22,Assembly,"Do pass",9,3,0,0,12
2010619,1565336,2025-05-05,Assembly,"AB 1522 JUD. Third Reading Urgency By KALRA",60,17,0,2,79
2010620,1566714,2025-05-06,Assembly,"Do pass",12,0,0,0,12
2010621,1554510,2025-04-22,Assembly,"Do pass as amended, and be re-referred to the Committee on [Appropriations] with recommendation: To Consent Calendar",12,0,0,0,12
2010622,1554434,2025-04-22,Assembly,"Do pass. To Consent Calendar",12,0,0,0,12
2010622,1559398,2025-04-28,Assembly,"AB 1525 Judiciary Consent Calendar Second Day Regular Session",76,0,0,3,79
2010623,1556020,2025-04-23,Assembly,"Do pass. To Consent Calendar",22,0,0,0,22
2010623,1564197,2025-05-01,Assembly,"AB 1526 Governmental Organization Consent Calendar Second Day Regular Session",76,0,0,3,79
2010624,1556121,2025-04-23,Assembly,"Do pass. To Consent Calendar",22,0,0,0,22
2010624,1564167,2025-05-01,Assembly,"AB 1527 Governmental Organization Consent Calendar Second Day Regular Session",76,0,0,3,79
2011456,1525443,2025-03-24,Assembly,"Be adopted. To third reading",11,0,0,0,11
2011456,1557483,2025-04-24,Senate,"Special Consent ACR55 Jeff Gonzalez et al",37,0,0,3,40
2011457,1538908,2025-04-07,Assembly,"Be adopted. To third reading",7,0,0,4,11
2011458,1538902,2025-04-07,Assembly,"Be adopted. To Consent Calendar",7,0,0,4,11
2011458,1544996,2025-04-10,Assembly,"ACR 57 Patterson Consent Calendar Second Day Regular Session",67,0,0,12,79
2011459,1538869,2025-04-07,Assembly,"Be adopted. To third reading",7,0,0,4,11
2011460,1559403,2025-04-28,Assembly,"Be adopted. To third reading",9,0,0,2,11
2011461,1556190,2025-04-23,Senate,"Do pass and be ordered to the Consent Calendar",5,0,0,0,5
2011461,1564199,2025-05-01,Senate,"Consent Calendar 2nd SB863 REV. & TAX. (McNerney)",37,0,0,3,40
2011462,1552929,2025-04-21,Senate,"Senate 3rd Reading SCR42 Umberg",36,0,0,4,40
2012250,1566684,2025-05-06,Assembly,"Be adopted. To third reading",9,0,0,3,12
2012251,1554482,2025-04-22,Assembly,"Be adopted. To Consent Calendar",8,0,0,0,8
2012251,1557501,2025-04-24,Assembly,"HR 27 Gipson Consent Calendar Second Day Regular Session",75,0,0,4,79
2012252,1525427,2025-03-24,Assembly,"Be adopted. To third reading",11,0,0,0,11
2012253,1554479,2025-04-22,Senate,"Do pass, but first be re-referred to the Committee on [Appropriations] with the recommendation: To Consent Calendar",14,0,0,1,15
2012253,1568621,2025-05-08,Senate,"Consent Calendar 2nd SB864 G.O. (Padilla)",36,0,0,4,40
2013761,1552889,2025-04-21,Senate,"Senate 3rd Reading SCR43 Archuleta",36,0,0,4,40
2013762,1533484,2025-04-01,Senate,"Senate 3rd Reading SCR44 Valladares",39,0,0,1,40
2013762,1552924,2025-04-21,Assembly,"Be adopted. To Consent Calendar",10,0,0,1,11
2013762,1557555,2025-04-24,Assembly,"SCR 44 Valladares Consent Calendar Second Day Regular Session",75,0,0,4,79
2013763,1557581,2025-04-24,Senate,"Senate 3rd Reading SCR45 Wahab et al",37,0,0,3,40
2013764,1559470,2025-04-28,Senate,"Senate 3rd Reading SCR46 Wiener et al",37,0,0,3,40
2013765,1564240,2025-05-01,Senate,"Senate 3rd Reading SR31 Wahab et al",37,0,0,3,40
2014760,1562773,2025-04-29,Assembly,"Do pass and be re-referred to the Committee on [Appropriations] with recommendation: To Consent Calendar",7,0,0,0,7
2014760,1567887,2025-05-07,Assembly,"Do pass. To Consent Calendar",15,0,0,0,15
2014761,1562864,2025-04-30,Assembly,"Do pass and be re-referred to the Committee on [Appropriations] with recommendation: To Consent Calendar",10,0,0,2,12
2014761,1567867,2025-05-07,Assembly,"Do pass. To Consent Calendar",15,0,0,0,15
2014762,1552866,2025-04-21,Senate,"Senate 3rd Reading SCR47 Niello",36,0,0,4,40
2014762,1565309,2025-05-05,Assembly,"Be adopted. To Consent Calendar",9,0,0,2,11
2014762,1568620,2025-05-08,Assembly,"SCR 47 Niello Consent Calendar Second Day Regular Session",69,0,0,10,79
2015520,1561044,2025-04-28,Assembly,"Do pass and be re-referred to the Committee on [Appropriations] with recommendation: To Consent Calendar",7,0,0,0,7
2015521,1561112,2025-04-28,Assembly,"Do pass and be re-referred to the Committee on [Insurance]",7,0,0,0,7
2015521,1562837,2025-04-30,Assembly,"Do pass and be re-referred to the Committee on [Appropriations] with recommendation: To Consent Calendar",16,0,0,1,17
2015523,1542897,2025-04-09,Assembly,"Be adopted. To third reading",8,0,0,0,8
2015523,1565263,2025-05-05,Assembly,"AJR 6 Aguiar-Curry Assembly Third Reading",77,0,0,2,79
2015524,1545029,2025-04-09,Assembly,"Be adopted. To third reading",9,0,0,0,9
2015525,1557532,2025-04-24,Senate,"Senate 3rd Reading SCR48 Cervantes et al",37,0,0,3,40
2015526,1538925,2025-04-07,Senate,"Senate 3rd Reading SCR49 Wahab",36,0,0,4,40
2015527,1554475,2025-04-22,Senate,"Be adopted. Ordered to third reading",4,0,0,3,7
2015528,1556111,2025-04-22,Senate,"Be adopted as amended",11,0,0,2,13
2016196,1535045,2025-04-02,Assembly,"Be adopted. To third reading",7,0,0,0,7
2016197,1565245,2025-05-05,Senate,"Senate 3rd Reading SCR51 Laird",38,0,0,2,40
2016198,1552890,2025-04-21,Senate,"Be adopted and be ordered to the Consent Calendar",5,0,0,0,5
2016198,1565289,2025-05-05,Senate,"Senate 3rd Reading SJR3 Arreguín et al",38,0,0,2,40
2016652,1562839,2025-04-30,Assembly,"Do pass and be re-referred to the Committee on [Utilities and Energy]",8,0,0,2,10
2016652,1564157,2025-04-30,Assembly,"Do pass as amended and be re-referred to the Committee on [Appropriations]",17,0,0,1,18
2016653,1552942,2025-04-21,Assembly,"Be adopted. To third reading",10,0,0,1,11
2016654,1562993,2025-04-29,Assembly,"Be adopted. To third reading",9,0,0,0,9
2016655,1538989,2025-04-07,Assembly,"Be adopted. To Consent Calendar",7,0,0,4,11
2016655,1544982,2025-04-10,Assembly,"HR 29 Gabriel Consent Calendar Second Day Regular Session",67,0,0,12,79
2016656,1557562,2025-04-24,Senate,"Senate 3rd Reading SCR52 Ochoa Bogh et al",38,0,0,2,40
2016658,1552935,2025-04-21,Senate,"Senate 3rd Reading SR33 Pérez et al",36,0,0,4,40
2016659,1538903,2025-04-07,Senate,"Senate 3rd Reading SR34 Choi et al",36,0,0,4,40
2016660,1552849,2025-04-21,Senate,"Senate 3rd Reading SR35 Gonzalez et al",36,0,0,4,40
2018617,1538887,2025-04-07,Assembly,"Be adopted. To Consent Calendar",7,0,0,4,11
2018617,1545009,2025-04-10,Assembly,"ACR 61 Stefani Consent Calendar Second Day Regular Session",67,0,0,12,79
2018618,1565232,2025-05-05,Assembly,"Be adopted. To third reading",9,0,0,2,11
2018619,1538886,2025-04-07,Assembly,"Be adopted. To third reading",7,0,0,4,11
2018620,1552853,2025-04-21,Senate,"Senate 3rd Reading SCR54 Grayson et al",36,0,0,4,40
2018621,1559364,2025-04-28,Senate,"Senate 3rd Reading SCR55 Niello",39,0,0,1,40
2018622,1563129,2025-04-30,Senate,"Be adopted as amended",6,2,0,0,8
2019484,1544958,2025-04-10,Senate,"Senate 3rd Reading SCR57 Reyes et al. By Limón",33,0,0,7,40
2019484,1552836,2025-04-21,Assembly,"Be adopted. To third reading",10,0,0,1,11
2019484,1559414,2025-04-28,Assembly,"SCR 57 Reyes Senate Third Reading By Carrillo",73,0,0,6,79
2020168,1557554,2025-04-24,Senate,"Senate 3rd Reading SR37 Gonzalez et al",38,0,0,2,40
2021331,1552939,2025-04-21,Senate,"Senate 3rd Reading SCR59 Allen et al",36,0,0,4,40
2021825,1565236,2025-05-05,Assembly,"Be adopted. To third reading",9,0,0,2,11
2021826,1552906,2025-04-21,Assembly,"Be adopted. To Consent Calendar",10,0,0,1,11
2021826,1557545,2025-04-24,Assembly,"ACR 64 Macedo Consent Calendar Second Day Regular Session",75,0,0,4,79
2022411,1552821,2025-04-21,Assembly,"Be adopted. To third reading",10,0,0,1,11
2022412,1552886,2025-04-21,Assembly,"Be adopted. To third reading",10,0,0,1,11
2022413,1557538,2025-04-24,Senate,"Senate 3rd Reading SCR60 Cortese",38,0,0,2,40
2023028,1559408,2025-04-28,Assembly,"Be adopted. To third reading",9,0,0,2,11
2023030,1562959,2025-04-30,Senate,"Be adopted. Ordered to third reading",5,1,0,1,7
2025384,1559430,2025-04-28,Assembly,"Be adopted. To Consent Calendar",9,0,0,2,11
2025384,1568659,2025-05-08,Assembly,"ACR 67 Sharp-Collins Consent Calendar Second Day",69,0,0,10,79
2025385,1564173,2025-05-01,Assembly,"Be adopted. To third reading",14,0,0,0,14
2025385,1568605,2025-05-08,Assembly,"AJR 10 Rogers Assembly Third Reading",69,0,0,10,79
2025386,1559405,2025-04-28,Assembly,"Be adopted. To third reading",9,0,0,2,11
2025387,1565347,2025-05-05,Senate,"Senate 3rd Reading SCR62 Becker",38,0,0,2,40
2025388,1559390,2025-04-28,Senate,"Senate 3rd Reading SCR63 Wahab",39,0,0,1,40
2025877,1559413,2025-04-28,Assembly,"Be adopted. To third reading",9,0,0,2,11
2025878,1568671,2025-05-08,Senate,"Senate 3rd Reading SCR64 Rubio et al",36,0,0,4,40
2026248,1565356,2025-05-05,Assembly,"Be adopted. To third reading",9,0,0,2,11
2026520,1567882,2025-05-06,Senate,"Be adopted. Ordered to third reading",11,0,0,2,13
2026981,1568667,2025-05-08,Senate,"Senate 3rd Reading SCR68 Blakespear et al",36,0,0,4,40
2027350,1568622,2025-05-08,Senate,"Senate 3rd Reading SCR70 Blakespear et al",36,0,0,4,40
2027661,1565299,2025-05-05,Assembly,"Be adopted. To Consent Calendar",9,0,0,2,11
2027661,1568654,2025-05-08,Assembly,"ACR 75 Alanis Consent Calendar Second Day Regular Session",69,0,0,10,79
2027663,1565281,2025-05-05,Assembly,"Be adopted. To third reading",9,0,0,2,11
